Mack teve a impressão de que Sarayu se virou para ele.	'mE.ki 'te.vi a i~.pre'sa~w~ Di ki sa.ra'ju si vi'row 'pa.ra 'e.li
Mackenzie, o mal é uma palavra que usamos para descrever a ausência de Deus, assim como usamos a palavra escuridão para descrever a ausência de Luz, ou morte para descrever a ausência de Vida.	ma'ke~.zi, u 'maw E u~.ma pa'la.vra ki u'za~.mus 'pa.ra des.kre'ver a aw'ze~.sja Di 'dews, a'si~ 'ko~.mu u'za~.muz a pa'la.vra es.ku.ri'da~w~ 'pa.ra des.kre'ver a aw'ze~.sja Di 'lujs, ow 'mOX.Ti 'pa.ra des.kre'ver a aw'ze~.sja Di 'vi.da
Tanto o mal quanto a escuridão só podem ser entendidos em relação à Luz e ao Bem.	'ta~.tu u 'maw 'kwa~.tu a es.ku.ri'da~w~ 'sO 'pO.de~j~ ser e~.te~.Di'duz e~j~ Re.la'sa~w~ a 'lujz i aw 'be~j~
Eles não têm existência real.	'e.lis 'na~w~ 'te~j~ e.zis'te~.sja Re'aw
Eu sou a Luz e eu sou o Bem.	ew 'sow a 'lujz i ew 'sow u 'be~j~
Sou Amor e não há escuridão em mim.	'sow a~'mor i 'na~w~ 'a es.ku.ri'da~w~ e~j~ 'mi~
A Luz e o Bem existem realmente.	a 'lujz i u 'be~j~ e'zis.te~j~ Re.aw'me~.Ti
Assim, afastar-se de mim irá mergulhar você na escuridão.	a'si~, a.fas'taX si Di 'mi~ i'ra meR.gu'LaR vo'se na es.ku.ri'da~w~
Declarar independência resultará no mal, porque, separado de mim, você só pode contar consigo mesmo.	de.kla'rar i~.de.pe~'de~.sja Re.zuw.ta'ra nu 'maw, puX'ke, se.pa'ra.du Di 'mi~, vo'se 'sO 'pO.Di ko~'taX ko~'si.gu 'mez.mu
Isso é morte, porque você se separou de mim, que sou a Vida.	'i.su E 'mOX.Ti, puX'ke vo'se si se.pa'row Di 'mi~, ki 'sow a 'vi.da
Uau! exclamou Mack, sentando-se por um momento.	u'aw, es.kla~'mow 'mE.ki, se~'ta~.du si pur u~ mo~'me~.tu
Isso realmente ajuda.	'i.su Re.aw'me~.Ti a'Zu.da
Mas também posso ver que abrir mão dos meus direitos de independência não será um processo fácil.	majs ta~'be~j~ 'pO.su 'veX ki a'briR 'ma~w~ dus 'mews Di'rej.tus Di i~.de.pe~'de~.sja 'na~w~ se'ra u~ pro'sE.su 'fa.siw
Poderia significar que...	po.de'ri.a si.gi~.ni.fi'kaX ki
Sarayu interrompeu a frase dele outra vez.	sa.ra'ju i~.te.Ro~'pew a 'fra.zi 'de.li 'ow.tra 'vejs
É, mas diga isso à pessoa com câncer ou ao pai cuja filha morreu, reagiu Mack, um pouco mais sarcasticamente do que havia pretendido.	E, majs 'Di.ga 'i.su a pe'so.a ko~ 'ka~.ser ow aw 'paj 'ku.Za 'fi.La mo'Rew, Re.a'Ziw 'mE.ki, u~ 'pow.ku 'majs saX.kas.Ti.ka~'me~.Ti du ki a'vi.a pre.te~'Di.du
Ah, Mackenzie.	'a, ma'ke~.zi
Você acha que nós não pensamos neles?	vo'se 'a.Sa ki 'nOjs 'na~w~ pe~'sa~.mus 'ne.lis
Cada um deles era o centro de outra história que não é contada.	'ka.da 'u~ 'de.liz 'E.ra u 'se~.tru Di 'ow.tra is'tO.rja ki 'na~w~ E ko~'ta.da
Mas, Mack podia sentir seu controle se esvaindo enquanto cravava a pá com força, Missy não tinha o direito de ser protegida?	majs, 'mE.ki po'Di.a se~'TiX 'sew ko~'tro.li si ez.va'i~.du e~'kwa~.tu kra'va.va a 'pa ko~ 'foX.sa, 'mi.si 'na~w~ 'Ti~.Ja u Di'rej.tu Di 'seX pro.te'Zi.da
Não, Mack. Uma criança é protegida porque é amada e não porque tem o direito de ser protegida.	'na~w~, 'mE.ki, u~.ma kri'a~.sa E pro.te'Zi.da puX'ke E a~'ma.da i 'na~w~ puX'ke te~j~ u Di'rej.tu Di 'seX pro.te'Zi.da
Isso o fez parar.	'i.su u 'fejs pa'raX
De algum modo, o que Sarayu acabara de dizer pareceu virar o mundo de cabeça para baixo e ele lutou para encontrar um ponto de apoio.	Di aw'gu~ 'mO.du, u ki sa.ra'ju a.ka'ba.ra Di Di'zeX pa.re'sew vi'rar u 'mu~.du Di ka'be.sa 'pa.ra 'baj.Su i 'e.li lu'tow 'pa.ra e~.ko~'trar u~ 'po~.tu Di a'poj.u
Sem dúvida devia haver alguns direitos aos quais ele poderia legitimamente se agarrar.	se~j~ 'du.vi.da de'vi.a a'ver aw'gu~s Di'rej.tuz aws 'kwajz 'e.li po.de'ri.a le.Zi.Ti~.ma~'me~.Ti si a.ga'RaX
Mas e...	majz i
Os direitos são os que os sobreviventes procuram para não terem de trabalhar os relacionamentos, interveio ela.	us Di'rej.tus 'sa~w~ us ki us so.bre.vi've~.Tis pro'ku.ra~w~ 'pa.ra 'na~w~ 'te.re~j~ Di tra.ba'Lar us Re.la.si.o~.na~'me~.tus, i~.teR'vej.u 'E.la
Mas, se eu abrir mão...	majs, si ew a'briR 'ma~w~
Então começará a entender a maravilha e a aventura de viver em mim, interrompeu ela de novo.	e~'ta~w~ ko~.me'sa.ra a e~.te~'der a ma.ra'vi.La i a a.ve~'tu.ra Di vi'ver e~j~ 'mi~, i~.te.Ro~'pew 'E.la Di 'no.vu
Mack estava ficando frustrado.	'mE.ki es'ta.va fi'ka~.du frus'tra.du
Falou mais alto: Mas eu não tenho o direito de...	fa'low 'majz 'aw.tu, majz ew 'na~w~ 'te~.Ju u Di'rej.tu Di
De terminar uma frase sem ser interrompido?	Di teR.mi~'nar u~.ma 'fra.zi se~j~ 'ser i~.te.Ro~'pi.du
Não, não tem.	'na~w~, 'na~w~ te~j~
Na realidade, não.	na Re.a.li'da.Di, 'na~w~
Mas, enquanto você achar que tem, certamente ficará irritado quando alguém o interromper, mesmo que seja Deus.	majs, e~'kwa~.tu vo'se a'SaX ki te~j~, sEX.ta~'me~.Ti fi.ka'ra i.Ri'ta.du 'kwa~.du aw'ge~j~ u i~.te.Ro~'peX, 'mez.mu ki 'se.Za 'dews
Ele ficou perplexo e se levantou, encarando-a, sem saber se tinha um ataque de fúria ou se ria.	'e.li fi'kow peX'plEk.su i si le.va~'tow, e~.ka'ra~.du a, se~j~ sa'beX si 'Ti~.Ja u~ a'ta.ki Di 'fu.rja ow si 'Ri.a
Sarayu sorriu para ele.	sa.ra'ju so'Riw 'pa.ra 'e.li
Mackenzie, Jesus não se agarrou a nenhum direito.	ma'ke~.zi, Ze'zujs 'na~w~ si a.ga'Row a ne~'Ju~ Di'rej.tu
Tornou-se um servo por livre arbítrio e vive seu relacionamento com Papai.	toR'now si u~ 'sER.vu puR 'li.vri aR'bi.trju i 'vi.vi 'sew Re.la.si.o~.na~'me~.tu ko~ pa'paj
Abriu mão de tudo, de modo que ao longo de sua vida independente deixou uma porta aberta que permitiria a você viver suficientemente livre para abdicar de seus direitos.	a'briw 'ma~w~ Di 'tu.du, Di 'mO.du ki aw 'lo~.gu Di 'su.a 'vi.da i~.de.pe~'de~.Ti dej'Sow u~.ma 'pOX.ta a'bEX.ta ki peR.mi.Ti'ri.a a vo'se vi'veX su.fi.si.e~.Ti~'me~.Ti 'li.vri 'pa.ra ab.Di'kaR Di 'sews Di'rej.tus
Nesse momento, Papai desceu pelo caminho carregando duas sacolas de papel.	'ne.si mo~'me~.tu, pa'paj de'sew 'pe.lu ka~'mi~.Ju ka.Re'ga~.du 'du.as sa'kO.las Di pa'pEw
Sorria enquanto se aproximava.	so'Ri.a e~'kwa~.tu si a.pro.si~'ma.va
Bem, pelo que vejo, vocês dois estão tendo uma conversa.	'be~j~, 'pe.lu ki 've.Zu, vo'sejs 'dojz es'ta~w~ 'te~.du u~.ma ko~'vEX.sa
Ela piscou para Mack.	'E.la pis'kow 'pa.ra 'mE.ki
A melhor! exclamou Sarayu.	a me'LOX, es.kla~'mow sa.ra'ju
E adivinhe só!	i a.Di'vi~.Ji 'sO
Ele disse que nosso jardim era uma confusão.	'e.li 'Di.si ki 'nO.su ZaR'Di~ 'E.ra u~.ma ko~.fu'za~w~
Não é perfeito?	'na~w~ E peX'fej.tu
As duas deram um largo sorriso para Mack, que ainda não tinha certeza absoluta de que não estavam brincando com ele.	as 'du.as 'dE.ra~w~ u~ 'laR.gu so'Ri.zu 'pa.ra 'mE.ki, ki a'i~.da 'na~w~ 'Ti~.Ja seX'te.za ab.so'lu.ta Di ki 'na~w~ es'ta.va~w~ bri~'ka~.du ko~ 'e.li
Sua raiva começou a diminuir, mas ainda podia sentir o rosto ardendo.	'su.a 'Raj.va ko~.me'sow a Di~.mi~.nu'iX, majz a'i~.da po'Di.a se~'Tir u 'Ros.tu aR'de~.du
As duas pareceram não notar.	as 'du.as pa.re'se.ra~w~ 'na~w~ no'taX
Sarayu estendeu a mão e deu um beijo no rosto de Papai.	sa.ra'ju es.te~'dew a 'ma~w~ i 'dew u~ 'bej.Zu nu 'Ros.tu Di pa'paj
Como sempre, sua noção de tempo é perfeita.	'ko~.mu 'se~.pri, 'su.a no'sa~w~ Di 'te~.pu E peX'fej.ta
Tudo que eu precisava que Mack fizesse aqui está terminado. Virou-se para ele.	'tu.du ki ew pre.si'za.va ki 'mE.ki fi'zE.si a'ki es'ta teR.mi~'na.du, vi'row si 'pa.ra 'e.li
Mackenzie, você é um deleite!	ma'ke~.zi, vo'se E u~ de'lej.Ti
Obrigada por seu trabalho duro.	o.bri'ga.da puX 'sew tra'ba.Lu 'du.ru
Na verdade, não fiz grande coisa, ele respondeu em tom de desculpa.	na veR'da.Di, 'na~w~ 'fiz 'gra~.Di 'koj.za, 'e.li Res.po~'dew e~j~ 'to~ Di des'kuw.pa
Quero dizer, olhe essa bagunça. Seu olhar passou pelo jardim que os rodeava.	'kE.ru Di'zeX, 'O.Li 'E.sa ba'gu~.sa, 'sew o'LaX pa'sow 'pe.lu ZaR'Di~ ki us Ro.de'a.va
Mas é realmente lindo e pleno de você, Sarayu.	majz E Re.aw'me~.Ti 'li~.du i 'ple~.nu Di vo'se, sa.ra'ju
Mesmo que pareça que ainda resta um monte de trabalho a ser feito, sinto-me estranhamente à vontade e tranquilo aqui.	'mez.mu ki pa're.sa ki a'i~.da 'REs.ta u~ 'mo~.Ti Di tra'ba.Lu a 'seX 'fej.tu, 'si~.tu mi es.tra~.Ja~'me~.Ti a vo~'ta.Di i tra~'kwi.lu a'ki
As duas se entreolharam e riram.	as 'du.as si e~.tre.o'La.ra~w~ i 'Ri.ra~w~
Sarayu foi na direção dele até invadir seu espaço pessoal.	sa.ra'ju 'foj na Di.re'sa~w~ 'de.li a'tE i~.va'DiX 'sew es'pa.su pe.so'aw
E não é de espantar, Mackenzie, porque este jardim é a sua alma.	i 'na~w~ E Di es.pa~'taX, ma'ke~.zi, puX'ke 'es.Ti ZaR'Di~ E a 'su.a 'aw.ma
Esta confusão é você!	'Es.ta ko~.fu'za~w~ E vo'se
Juntos, você e eu estivemos trabalhando com um propósito no seu coração.	'Zu~.tus, vo'se i ew es.Ti've~.mus tra.ba'La~.du ko~ u~ pro'pO.zi.tu nu 'sew ko.ra'sa~w~
E ele é selvagem, lindo e perfeitamente em evolução.	i 'e.li E sew'va.Ze~j~, 'li~.du i peX.fej.ta~'me~.Ti e~j~ e.vo.lu'sa~w~
Para você parece uma confusão, mas eu vejo um padrão perfeito emergindo, crescente e vivo.	'pa.ra vo'se pa'rE.si u~.ma ko~.fu'za~w~, majz ew 've.Zu u~ pa'dra~w~ peX'fej.tu e~.meR'Zi~.du, kre'se~.Ti i 'vi.vu
Ele olhou de novo o jardim das duas, seu jardim, e era mesmo uma confusão, mas ao mesmo tempo incrível e maravilhoso.	'e.li o'Low Di 'no.vu u ZaR'Di~ das 'du.as, 'sew ZaR'Di~, i 'E.ra 'mez.mu u~.ma ko~.fu'za~w~, majz aw 'mez.mu 'te~.pu i~'kri.vew i ma.ra.vi'Lo.zu
E, além disso, Papai estava aqui e Sarayu adorava a confusão.	i, a'le~j~ 'Di.su, pa'paj es'ta.va a'ki i sa.ra'ju a.do'ra.va a ko~.fu'za~w~
Era quase demais para compreender e de novo suas emoções cuidadosamente guardadas ameaçaram se derramar.	'E.ra 'kwa.zi de~'majs 'pa.ra ko~.pre.e~'der i Di 'no.vu 'su.az e~.mo'so~j~s kuj.da.dO.za~'me~.Ti gwaR'da.daz a~.me.a'sa.ra~w~ si de.Ra~'maX
Mackenzie, Jesus gostaria de levá-lo num passeio, se você quiser ir.	ma'ke~.zi, Ze'zujs gos.ta'ri.a Di le'va lu nu~ pa'sej.u, si vo'se ki'zEr 'iX
Preparei um lanche para o caso de ficarem com fome.	pre.pa'rej u~ 'la~.Si 'pa.ra u 'ka.zu Di fi'ka.re~j~ ko~ 'fo~.mi
Deixo-o livre até a hora do chá.	'dej.Su u 'li.vri a'tE a 'Or.a du 'Sa
Enquanto se virava para pegar as sacolas do lanche, Mack sentiu Sarayu passar, beijando seu rosto, mas não a viu ir embora.	e~'kwa~.tu si vi'ra.va 'pa.ra pe'gar as sa'kO.las du 'la~.Si, 'mE.ki se~'Tiw sa.ra'ju pa'saX, bej'Za~.du 'sew 'Ros.tu, majs 'na~w~ a 'viw 'ir e~'bO.ra
Sentiu que podia vê-la avançar, como se fosse o vento, as plantas se dobrando, uma de cada vez, parecendo cultuá-la.	se~'Tiw ki po'Di.a 've la a.va~'saX, 'ko~.mu si 'fo.si u 've~.tu, as 'pla~.tas si do'bra~.du, u~.ma Di 'ka.da 'vejs, pa.re'se~.du kuw.tu'a la
Quando se virou de volta, Papai também havia sumido e por isso foi na direção da carpintaria para ver se conseguia encontrar Jesus.	'kwa~.du si vi'row Di 'vOw.ta, pa'paj ta~'be~j~ a'vi.a su~'mi.du i pur 'i.su 'foj na Di.re'sa~w~ da kaX.pi~.ta'ri.a 'pa.ra 'veX si ko~.se'gi.a e~.ko~'traR Ze'zujs
Parecia que os dois tinham um compromisso.	pa.re'si.a ki us 'dojs 'Ti~.Ja~w~ u~ ko~.pro~'mi.su
Novo mundo, grande horizonte.	'no.vu 'mu~.du, 'gra~.Di o.ri'zo~.Ti
Abra os olhos e veja que é verdade.	'a.bra uz 'O.Luz i 've.Za ki E veR'da.Di
Novo mundo, do outro lado das assustadoras ondas azuis.	'no.vu 'mu~.du, du 'ow.tru 'la.du daz a.sus.ta'do.raz 'o~.daz a'zujs
Passou os dedos pela borda lisa, sorriu satisfeito e pousou a lixa.	pa'sow us 'de.dus 'pe.la 'bOR.da 'li.za, so'Riw sa.Tis'fej.tu i pow'zow a 'li.Sa
Saiu pela porta espanando o pó do jeans e da camiseta enquanto Mack se aproximava.	sa'iw 'pe.la 'pOX.ta es.pa~'na~.du u 'pO du 'Di~z i da ka~.mi'ze.ta e~'kwa~.tu 'mE.ki si a.pro.si~'ma.va
Olá, Mack! Eu estava dando os últimos retoques no meu projeto para amanhã.	o'la, 'mE.ki, ew es'ta.va 'da~.du uz 'uw.Ti~.mus Re'tO.kis nu 'mew pro'ZE.tu 'pa.ra a~.ma~'Ja~
Gostaria de dar uma volta?	gos.ta'ri.a Di 'dar u~.ma 'vOw.ta
Mack pensou no tempo que haviam passado juntos na véspera sob as estrelas.	'mE.ki pe~'sow nu 'te~.pu ki a'vi.a~w~ pa'sa.du 'Zu~.tus na 'vEs.pe.ra sob az es'tre.las
Se você vai, eu gostaria, sim, respondeu.	si vo'se 'vaj, ew gos.ta'ri.a, 'si~, Res.po~'dew
Por que vocês vivem falando sobre amanhã?	puX 'ke vo'sejs 'vi.ve~j~ fa'la~.du 'so.bri a~.ma~'Ja~
É um grande dia para você, um dos motivos pelos quais está aqui.	E u~ 'gra~.Di 'Di.a 'pa.ra vo'se, 'u~ dus mo'Ti.vus 'pe.lus 'kwajz es'ta a'ki
Vamos. Há um lugar especial que quero lhe mostrar, do outro lado do lago, e o panorama é indescritível.	'va~.mus, 'a u~ lu'gar es.pe.si'aw ki 'kE.ru Li mos'traX, du 'ow.tru 'la.du du 'la.gu, i u pa~.no'ra~.ma E i~.des.kri'Ti.vew
De lá se podem ver alguns dos picos mais altos.	Di 'la si 'pO.de~j~ 'ver aw'gu~s dus 'pi.kus 'majz 'aw.tus
Deve ser fantástico! respondeu Mack entusiasmado.	'dE.vi 'seX fa~'tas.Ti.ku, Res.po~'dew 'mE.ki e~.tu.zi.az'ma.du
Parece que você pegou o lanche, então podemos ir.	pa'rE.si ki vo'se pe'gow u 'la~.Si, e~'ta~w~ po'de~.muz 'iX
Em vez de se desviar para algum lado do lago, onde devia haver uma trilha, Jesus foi direto ao cais.	e~j~ 'vejz Di si dez.vi'aX 'pa.ra aw'gu~ 'la.du du 'la.gu, 'o~.Di de'vi.a a'ver u~.ma 'tri.La, Ze'zujs 'foj Di'rE.tu aw 'kajs
O dia estava luminoso e lindo.	u 'Di.a es'ta.va lu~.mi~'no.zu i 'li~.du
O sol esquentava a pele, mas não demais, e uma brisa fresca e perfumada acariciava o rosto dos dois, suave e amorosamente.	u 'sOw es.ke~'ta.va a 'pE.li, majs 'na~w~ de~'majs, i u~.ma 'bri.za 'fres.ka i peX.fu~'ma.da a.ka.ri.si'a.va u 'Ros.tu dus 'dojs, su'a.vi i a~.mo.rO.za~'me~.Ti
Mack imaginou que pegariam uma das canoas presas às estacas do cais e ficou surpreso quando Jesus não hesitou ao passar pela última, indo diretamente para o fim do píer.	'mE.ki i~.ma.Zi~'now ki pe.ga'ri.a~w~ u~.ma das ka~'no.as 'pre.zaz az es'ta.kas du 'kajz i fi'kow suX'pre.zu 'kwa~.du Ze'zujs 'na~w~ e.zi'tow aw pa'saX 'pe.la 'uw.Ti~.ma, 'i~.du Di.rE.ta~'me~.Ti 'pa.ra u 'fi~ du 'pi.eX
Ao chegar no final, ele se virou para Mack e riu.	aw Se'gaR nu fi~'naw, 'e.li si vi'row 'pa.ra 'mE.ki i 'Riw
Primeiro você, disse com um floreio e uma reverência.	pri~'mej.ru vo'se, 'Di.si ko~ u~ flo'rej.u i u~.ma Re.ve're~.sja
Está brincando, não é? reagiu Mack.	es'ta bri~'ka~.du, 'na~w~ E, Re.a'Ziw 'mE.ki
Achei que íamos andar e não nadar.	a'Sej ki 'i.a~.muz a~'dar i 'na~w~ na'daX
E vamos.	i 'va~.mus
Só pensei que atravessando o lago levaria menos tempo do que rodeando.	'sO pe~'sej ki a.tra.ve'sa~.du u 'la.gu le.va'ri.a 'me~.nus 'te~.pu du ki Ro.de'a~.du
Não sou um nadador fantástico e, além disso, a água parece muito fria, reclamou Mack.	'na~w~ 'sow u~ na.da'doX fa~'tas.Ti.ku i, a'le~j~ 'Di.su, a 'a.gwa pa'rE.si 'mu~j~.tu 'fri.a, Re.kla~'mow 'mE.ki
Bom, Jesus cruzou os braços, nós dois sabemos que você é um nadador muito capaz e que já foi salva-vidas.	'bo~, Ze'zujs kru'zow us 'bra.sus, 'nOjs 'dojs sa'be~.mus ki vo'se E u~ na.da'doR 'mu~j~.tu ka'pajz i ki 'Za 'foj 'saw.va 'vi.das
A água está fria e o lago é fundo.	a 'a.gwa es'ta 'fri.a i u 'la.gu E 'fu~.du
Mas não estou falando em nadar.	majs 'na~w~ es'tow fa'la~.du e~j~ na'daX
Quero atravessar andando com você.	'kE.ru a.tra.ve'sar a~'da~.du ko~ vo'se
Mack finalmente se deu conta do que Jesus estava sugerindo.	'mE.ki fi~.naw'me~.Ti si 'dew 'ko~.ta du ki Ze'zujz es'ta.va su.Ze'ri~.du
Tratava-se de andar sobre a água.	tra'ta.va si Di a~'daX 'so.bri a 'a.gwa
Antecipando sua hesitação, Jesus afirmou: Vamos, Mack. Se Pedro conseguiu...	a~.te.si'pa~.du 'su.a e.zi.ta'sa~w~, Ze'zujz a.fiR'mow, 'va~.mus, 'mE.ki, si 'pe.dru ko~.se'giw
Mack riu nervosamente.	'mE.ki 'Riw neR.vO.za~'me~.Ti
Para ter certeza, perguntou de novo: Você quer que eu ande sobre a água até o outro lado.	'pa.ra 'teX seX'te.za, peR.gu~'tow Di 'no.vu, vo'se 'kEX ki ew 'a~.Di 'so.bri a 'a.gwa a'tE u 'ow.tru 'la.du
É isso que está dizendo, não é?	E 'i.su ki es'ta Di'ze~.du, 'na~w~ E
Você entende rápido, Mack.	vo'se e~'te~.Di 'Ra.pi.du, 'mE.ki
Tenho certeza de que ninguém consegue enganá-lo.	'te~.Ju seX'te.za Di ki ni~'ge~j~ ko~'sE.gi e~.ga~'na lu
Venha, é divertido! Ele riu.	've~.Ja, E Di.veX'Ti.du, 'e.li 'Riw
Mack foi até a borda do cais e olhou para baixo.	'mE.ki 'foj a'tE a 'bOR.da du 'kajz i o'Low 'pa.ra 'baj.Su
A água batia suavemente apenas uns 30 centímetros abaixo de onde ele estava, mas era como se fossem 30 metros.	a 'a.gwa ba'Ti.a su.a.ve~'me~.Ti a'pe~.naz u~s 'tri~.ta se~'Ti~.me.truz a'baj.Su Di 'o~.Di 'e.li es'ta.va, majz 'E.ra 'ko~.mu si 'fo.se~j~ 'tri~.ta 'mE.trus
A distância parecia enorme.	a Dis'ta~.sja pa.re'si.a e~'nOR.mi
Mergulhar seria fácil, ele fizera isso mil vezes, mas como se desce de um cais para a superfície da água?	meR.gu'LaX se'ri.a 'fa.siw, 'e.li fi'zE.ra 'i.su 'miw 've.zis, majs 'ko~.mu si 'dE.si Di u~ 'kajs 'pa.ra a su.peX'fi.si da 'a.gwa
Olhou para Jesus, que ainda estava rindo.	o'Low 'pa.ra Ze'zujs, ki a'i~.da es'ta.va 'Ri~.du
Pedro teve o mesmo problema: como sair do barco?	'pe.dru 'te.vi u 'mez.mu pro'ble~.ma, 'ko~.mu sa'iR du 'baX.ku
É como descer de um degrau de escada. Nada de mais.	E 'ko~.mu de'seR Di u~ de'graw Di es'ka.da, 'na.da Di 'majs
De novo Mack olhou para a água e de volta para Jesus.	Di 'no.vu 'mE.ki o'Low 'pa.ra a 'a.gwa i Di 'vOw.ta 'pa.ra Ze'zujs
Então por que é tão difícil para mim?	e~'ta~w~ puX 'ke E 'ta~w~ Di'fi.siw 'pa.ra 'mi~
Diga do que você tem medo, Mack.	'Di.ga du ki vo'se te~j~ 'me.du, 'mE.ki
Bem, vejamos. Do que tenho medo?	'be~j~, ve'Za~.mus, du ki 'te~.Ju 'me.du
Bem, tenho medo de parecer idiota.	'be~j~, 'te~.Ju 'me.du Di pa.re'ser i.Di'O.ta
Tenho medo de você estar se divertindo à minha custa e de afundar como uma pedra.	'te~.Ju 'me.du Di vo'se es'taX si Di.veX'Ti~.du a 'mi~.Ja 'kus.ta i Di a.fu~'daX 'ko~.mu u~.ma 'pE.dra
Imagino que...	i~.ma'Zi~.nu ki
Exatamente, interrompeu Jesus. Você imagina.	e.za.ta~'me~.Ti, i~.te.Ro~'pew Ze'zujs, vo'se i~.ma'Zi~.na
A imaginação é uma capacidade poderosa!	a i~.ma.Zi~.na'sa~w~ E u~.ma ka.pa.si'da.Di po.de'rO.za
É um poder que o torna muito parecido conosco.	E u~ po'deX ki u 'tOR.na 'mu~j~.tu pa.re'si.du ko~'nos.ku
Mas, sem sabedoria, a imaginação é uma professora cruel.	majs, se~j~ sa.be.do'ri.a, a i~.ma.Zi~.na'sa~w~ E u~.ma pro.fe'so.ra kru'Ew
Quero lhe fazer uma pergunta: você acha que os humanos foram criados para viver no presente, no passado ou no futuro?	'kE.ru Li fa'zer u~.ma peR'gu~.ta, vo'se 'a.Sa ki uz u~'ma~.nus 'fo.ra~w~ kri'a.dus 'pa.ra vi'veR nu pre'ze~.Ti, nu pa'sa.du ow nu fu'tu.ru
Bom, disse Mack, hesitando. Acho que a resposta mais óbvia é que fomos criados para viver no presente.	'bo~, 'Di.si 'mE.ki, e.zi'ta~.du, 'a.Su ki a Res'pOs.ta 'majz 'Ob.vja E ki 'fo~.mus kri'a.dus 'pa.ra vi'veR nu pre'ze~.Ti
Estou errado?	es'tow e'Ra.du
Relaxe, Mack, isso não é um teste, é uma conversa.	Re'la.Si, 'mE.ki, 'i.su 'na~w~ E u~ 'tEs.Ti, E u~.ma ko~'vEX.sa
Você está corretíssimo, por sinal.	vo'se es'ta ko.Re'Ti.si~.mu, puX si~'naw
Mas agora me diga onde você passa a maior parte do tempo em sua imaginação: no presente, no passado ou no futuro?	majz a'gO.ra mi 'Di.ga 'o~.Di vo'se 'pa.sa a maj'OX 'paX.Ti du 'te~.pu e~j~ 'su.a i~.ma.Zi~.na'sa~w~, nu pre'ze~.Ti, nu pa'sa.du ow nu fu'tu.ru
Acho que eu passo muito pouco tempo no presente.	'a.Su ki ew 'pa.su 'mu~j~.tu 'pow.ku 'te~.pu nu pre'ze~.Ti
Passo grande parte dele no passado, mas na maior parte do tempo estou tentando adivinhar o futuro.	'pa.su 'gra~.Di 'paX.Ti 'de.li nu pa'sa.du, majs na maj'OX 'paX.Ti du 'te~.pu es'tow te~'ta~.du a.Di.vi~'Jar u fu'tu.ru
Você não é diferente da maioria das pessoas.	vo'se 'na~w~ E Di.fe're~.Ti da maj.o'ri.a das pe'so.as
Quando estou com vocês, vivo no presente.	'kwa~.du es'tow ko~ vo'sejs, 'vi.vu nu pre'ze~.Ti
Não no passado, se bem que muita coisa pode ser lembrada e aprendida ao se olhar para trás, mas somente para uma visita, não para uma estada demorada.	'na~w~ nu pa'sa.du, si 'be~j~ ki 'mu~j~.ta 'koj.za 'pO.Di 'seR le~'bra.da i a.pre~'Di.da aw si o'LaX 'pa.ra 'trajs, majs sO~'me~.Ti 'pa.ra u~.ma vi'zi.ta, 'na~w~ 'pa.ra u~.ma es'ta.da de~.mo'ra.da
E certamente não vivo no futuro que você visualiza ou imagina.	i sEX.ta~'me~.Ti 'na~w~ 'vi.vu nu fu'tu.ru ki vo'se vi.zu.a'li.za ow i~.ma'Zi~.na
Mack, você percebe que sua imaginação do futuro, que é quase sempre ditada por algum tipo de medo, raramente me coloca lá com você, se é que me coloca?	'mE.ki, vo'se peX'sE.bi ki 'su.a i~.ma.Zi~.na'sa~w~ du fu'tu.ru, ki E 'kwa.zi 'se~.pri Di'ta.da pur aw'gu~ 'Ti.pu Di 'me.du, Ra.ra~'me~.Ti mi ko'lO.ka 'la ko~ vo'se, si E ki mi ko'lO.ka
De novo Mack parou e pensou.	Di 'no.vu 'mE.ki pa'row i pe~'sow
Ele passava um bocado de tempo se aborrecendo e se preocupando com o futuro, e em sua imaginação o futuro geralmente era muito sombrio, deprimente e mesmo horrível.	'e.li pa'sa.va u~ bo'ka.du Di 'te~.pu si a.bo.Re'se~.du i si prew.ku'pa~.du ko~ u fu'tu.ru, i e~j~ 'su.a i~.ma.Zi~.na'sa~w~ u fu'tu.ru Ze.raw'me~.Ti 'E.ra 'mu~j~.tu so~'bri.u, de.pri~'me~.Ti i 'mez.mu o'Ri.vew
E Jesus também estava correto ao dizer que, do modo como Mack imaginava o futuro, Deus estava sempre ausente.	i Ze'zujs ta~'be~j~ es'ta.va ko'RE.tu aw Di'zeX ki, du 'mO.du 'ko~.mu 'mE.ki i~.ma.Zi~'na.va u fu'tu.ru, 'dewz es'ta.va 'se~.pri aw'ze~.Ti
Por que faço isso? perguntou Mack.	puX 'ke 'fa.su 'i.su, peR.gu~'tow 'mE.ki
É sua tentativa desesperada de conseguir algum controle sobre algo que você não pode controlar.	E 'su.a te~.ta'Ti.va de.zes.pe'ra.da Di ko~.se'gir aw'gu~ ko~'tro.li 'so.bri 'aw.gu ki vo'se 'na~w~ 'pO.Di ko~.tro'laX
É impossível ter poder sobre o futuro, porque ele não é real, e jamais será.	E i~.po'si.vew 'teX po'deX 'so.bri u fu'tu.ru, puX'ke 'e.li 'na~w~ E Re'aw, i Za~'majs se'ra
Você tenta brincar de Deus imaginando que o mal que teme pode se tornar realidade e depois tenta fazer planos para evitar aquilo que teme.	vo'se 'te~.ta bri~'kaR Di 'dewz i~.ma.Zi~'na~.du ki u 'maw ki 'te~.mi 'pO.Di si toR'na.Re.a.li'da.Di i de'pojs 'te~.ta fa'zeX 'pla~.nus 'pa.ra e.vi'tar a'ki.lu ki 'te~.mi
É basicamente o que Sarayu esteve dizendo.	E ba.zi.ka~'me~.Ti u ki sa.ra'ju es'te.vi Di'ze~.du
Então por que tenho tanto medo da vida?	e~'ta~w~ puX 'ke 'te~.Ju 'ta~.tu 'me.du da 'vi.da
Porque não acredita.	puX'ke 'na~w~ a.kre'Di.ta
Não sabe que nós o amamos.	'na~w~ 'sa.bi ki 'nOjz u a~'ma~.mus
A pessoa que vive dominada pelos medos não encontra liberdade no meu amor.	a pe'so.a ki 'vi.vi do~.mi~'na.da 'pe.lus 'me.dus 'na~w~ e~'ko~.tra li.beR'da.Di nu 'mew a~'moX
Não estou falando de medos racionais, ligados a perigos reais, e sim de medos imaginários, e especialmente da projeção desses medos no futuro.	'na~w~ es'tow fa'la~.du Di 'me.dus Ra.si.o~'najs, li'ga.duz a pe'ri.gus Re'ajs, i 'si~ Di 'me.duz i~.ma.Zi~'na.rjus, i es.pe.si.aw'me~.Ti da pro.Ze'sa~w~ 'de.sis 'me.dus nu fu'tu.ru
À medida que dá lugar a esses medos, você não acredita que eu sou bom, nem sabe, no fundo do seu coração, que eu o amo.	a me'Di.da ki 'da lu'gar a 'e.sis 'me.dus, vo'se 'na~w~ a.kre'Di.ta ki ew 'sow 'bo~, ne~j~ 'sa.bi, nu 'fu~.du du 'sew ko.ra'sa~w~, ki ew u 'a~.mu
Você pode até falar disso, mas não sabe.	vo'se 'pO.Di a'tE fa'laR 'Di.su, majs 'na~w~ 'sa.bi
Mack olhou de novo para a água e soltou um suspiro enorme, que saiu do fundo da alma.	'mE.ki o'Low Di 'no.vu 'pa.ra a 'a.gwa i sow'tow u~ sus'pi.ru e~'nOR.mi, ki sa'iw du 'fu~.du da 'aw.ma
Há um longo espaço para eu percorrer.	'a u~ 'lo~.gu es'pa.su 'pa.ra ew peX.ko'ReX
Ele só precisava disso para descer do cais.	'e.li 'sO pre.si'za.va 'Di.su 'pa.ra de'seR du 'kajs
Para tentar ver a água como sólida e não se atrapalhar com o movimento dela, olhou para a margem distante e levantou os sacos do lanche.	'pa.ra te~'taR 'ver a 'a.gwa 'ko~.mu 'sO.li.da i 'na~w~ si a.tra.pa'LaX ko~ u mo.vi~'me~.tu 'dE.la, o'Low 'pa.ra a 'maR.Ze~j~ Dis'ta~.Ti i le.va~'tow us 'sa.kus du 'la~.Si
O pouso foi mais suave do que ele havia pensado.	u 'pow.zu 'foj 'majs su'a.vi du ki 'e.li a'vi.a pe~'sa.du
Seus sapatos ficaram molhados no mesmo instante, mas a água não subiu nem mesmo até os tornozelos.	'sews sa'pa.tus fi'ka.ra~w~ mo'La.dus nu 'mez.mu i~s'ta~.Ti, majz a 'a.gwa 'na~w~ su'biw ne~j~ 'mez.mu a'tE us toR.no'ze.lus
O lago ainda se movia ao seu redor e ele quase perdeu o equilíbrio por causa disso.	u 'la.gu a'i~.da si mo'vi.a aw 'sew Re'dOr i 'e.li 'kwa.zi peR'dew u e.ki'li.brju puX 'kaw.za 'Di.su
Era estranho.	'E.ra es'tra~.Ju
Olhando para baixo, parecia que seus pés estavam sobre algo sólido, mas invisível.	o'La~.du 'pa.ra 'baj.Su, pa.re'si.a ki 'sews 'pEjz es'ta.va~w~ 'so.bri 'aw.gu 'sO.li.du, majz i~.vi'zi.vew
Virou-se e viu Jesus ao seu lado segurando os sapatos e as meias numa das mãos e sorrindo.	vi'row si i 'viw Ze'zujz aw 'sew 'la.du se.gu'ra~.du us sa'pa.tuz i as 'mej.as 'nu~.ma das 'ma~w~z i so'Ri~.du
Nós sempre tiramos os sapatos e as meias antes, disse ele rindo.	'nOjs 'se~.pri Ti'ra~.muz us sa'pa.tuz i as 'mej.az 'a~.Tis, 'Di.si 'e.li 'Ri~.du
Mack balançou a cabeça rindo também enquanto se sentava de novo na beira do cais.	'mE.ki ba.la~'sow a ka'be.sa 'Ri~.du ta~'be~j~ e~'kwa~.tu si se~'ta.va Di 'no.vu na 'bej.ra du 'kajs
Acho que vou fazer isso.	'a.Su ki 'vow fa'zer 'i.su
Tirou os sapatos, espremeu as meias e enrolou as pernas da calça.	Ti'row us sa'pa.tus, es.pre~'mew as 'mej.az i e~.Ro'low as 'pER.nas da 'kaw.sa
Partiram levando os calçados e as sacolas e caminharam para a margem oposta, a cerca de 800 metros de distância.	paX'Ti.ra~w~ le'va~.du us kaw'sa.duz i as sa'kO.laz i ka~.mi~'Ja.ra~w~ 'pa.ra a 'maR.Ze~j~ o'pOs.ta, a 'seX.ka Di oj.tu'se~.tus 'mE.trus Di Dis'ta~.sja
A água era fresca e revigorante e fazia subir arrepios pela coluna.	a 'a.gwa 'E.ra 'fres.ka i Re.vi.go'ra~.Ti i fa'zi.a su'bir a.Re'pi.us 'pe.la ko'lu~.na
Isso é absolutamente ridículo e impossível, você sabe, exclamou finalmente.	'i.su E ab.so.lu.ta~'me~.Ti Ri'Di.ku.lu i i~.po'si.vew, vo'se 'sa.bi, es.kla~'mow fi~.naw'me~.Ti
Claro, confirmou Jesus, rindo também.	'kla.ru, ko~.fiR'mow Ze'zujs, 'Ri~.du ta~'be~j~
Chegaram rapidamente à outra margem e Mack parou pouco antes de atingi-la.	Se'ga.ra~w~ Ra.pi.da~'me~.Ti a 'ow.tra 'maR.Ze~j~ i 'mE.ki pa'row 'pow.ku 'a~.Tis Di a.Ti~'Zi la
À esquerda viu uma linda cachoeira se derramando pela borda de um penhasco e caindo até o lago.	a es'keR.da 'viw u~.ma 'li~.da ka.So'ej.ra si de.Ra~'ma~.du 'pe.la 'bOR.da Di u~ pe~'Jas.ku i ka'i~.du a'tE u 'la.gu
Ao lado da cachoeira havia uma campina cheia de flores selvagens que se espalhavam ao acaso, semeadas pelo vento.	aw 'la.du da ka.So'ej.ra a'vi.a u~.ma ka~'pi~.na 'Sej.a Di 'flo.ris sew'va.Ze~s ki si es.pa'La.va~w~ aw a'ka.zu, se~.me'a.das 'pe.lu 've~.tu
Tudo era espantoso e Mack ficou um momento absorto.	'tu.du 'E.ra es.pa~'to.zu i 'mE.ki fi'kow u~ mo~'me~.tu ab'soX.tu
Uma imagem de Missy relampejou em sua mente, mas não se fixou.	u~.ma i~'ma.Ze~j~ Di 'mi.si Re.la~.pe'Zow e~j~ 'su.a 'me~.Ti, majs 'na~w~ si fik'sow
Uma praia de pedrinhas esperava-os e, atrás dela, uma floresta densa e rica erguia-se até a base de uma montanha encimada pela brancura da neve recém-caída.	u~.ma 'praj.a Di pE'dri~.Jaz es.pe'ra.va uz i, a'trajs 'dE.la, u~.ma flo'rEs.ta 'de~.sa i 'Ri.ka eR'gi.a si a'tE a 'ba.zi Di u~.ma mo~'ta~.Ja e~.si~'ma.da 'pe.la bra~'ku.ra da 'nE.vi Re'se~j~ ka'i.da
Mack saiu da água para as pedras pequenas, indo cautelosamente em direção a um tronco tombado.	'mE.ki sa'iw da 'a.gwa 'pa.ra as 'pE.dras pe'ke~.nas, 'i~.du kaw.te.lO.za~'me~.Ti e~j~ Di.re'sa~w~ a u~ 'tro~.ku to~'ba.du
Ali sentou-se, torceu as meias de novo e colocou-as ao lado dos sapatos para secar ao sol de quase meio-dia.	a'li se~'tow si, toX'sew as 'mej.as Di 'no.vu i ko.lo'kow az aw 'la.du dus sa'pa.tus 'pa.ra se'kar aw 'sOw Di 'kwa.zi 'mej.u 'Di.a
Só então olhou para o outro lado do lago.	'sO e~'ta~w~ o'Low 'pa.ra u 'ow.tru 'la.du du 'la.gu
A beleza era estonteante.	a be'le.za 'E.ra es.to~.te'a~.Ti
Podia ver a cabana, com a fumaça subindo preguiçosamente da chaminé de tijolos vermelhos delineada contra os verdes do pomar e da floresta.	po'Di.a 'ver a ka'ba~.na, ko~ a fu~'ma.sa su'bi~.du pre.gi.sO.za~'me~.Ti da Sa~.mi~'nE Di Ti'ZO.lus veR'me.Lus de.li~.ne'a.da 'ko~.tra us 'veR.Dis du po~'mar i da flo'rEs.ta
Fazendo tudo parecer minúsculo, uma enorme cordilheira pairava acima e atrás, como sentinela montando guarda.	fa'ze~.du 'tu.du pa.re'seR mi~'nus.ku.lu, u~.ma e~'nOR.mi koR.Di'Lej.ra paj'ra.va a'si~.ma i a'trajs, 'ko~.mu se~.Ti~'nE.la mo~'ta~.du 'gwaR.da
Mack sentou-se ao lado de Jesus e impregnou-se da sinfonia visual.	'mE.ki se~'tow si aw 'la.du Di Ze'zujz i i~.pre.gi~'now si da si~.fo~'ni.a vi.zu'aw
Você faz um grande trabalho! disse baixinho.	vo'se 'fajz u~ 'gra~.Di tra'ba.Lu, 'Di.si baj'Si~.Ju
Obrigado, Mack, e você viu muito pouco.	o.bri'ga.du, 'mE.ki, i vo'se 'viw 'mu~j~.tu 'pow.ku
Por enquanto, a maior parte das coisas que existem no universo só será vista e desfrutada por mim como telas especiais guardadas nos fundos do ateliê de um pintor.	pur e~'kwa~.tu, a maj'OX 'paX.Ti das 'koj.zas ki e'zis.te~j~ nu u~.ni'vEX.su 'sO se'ra 'vis.ta i des.fru'ta.da puR 'mi~ 'ko~.mu 'tE.laz es.pe.si'ajs gwaR'da.das nus 'fu~.dus du a.te.li'e Di u~ pi~'toX
Mas um dia...	majz u~ 'Di.a
E você pode imaginar o que seria se a Terra não estivesse em guerra, lutando tanto para simplesmente sobreviver?	i vo'se 'pO.Di i~.ma.Zi~'nar u ki se'ri.a si a 'tE.Ra 'na~w~ es.Ti'vE.si e~j~ 'gE.Ra, lu'ta~.du 'ta~.tu 'pa.ra si~.pliz'me~.Ti so.bre.vi'veX
O que você quer dizer exatamente?	u ki vo'se 'kER Di'zer e.za.ta~'me~.Ti
Nossa Terra é como uma criança que cresceu sem pais, não tendo ninguém para guiá-la e orientá-la.	'nO.sa 'tE.Ra E 'ko~.mu u~.ma kri'a~.sa ki kre'sew se~j~ 'pajs, 'na~w~ 'te~.du ni~'ge~j~ 'pa.ra gi'a la i o.ri.e~'ta la
Enquanto Jesus falava, sua voz se intensificava numa angústia contida.	e~'kwa~.tu Ze'zujs fa'la.va, 'su.a 'vOjs si i~.te~.si.fi'ka.va 'nu~.ma a~'gus.Tja ko~'Ti.da
Alguns tentaram ajudá-la, mas a maioria procurou apenas usá-la.	aw'gu~s te~'ta.ra~w~ a.Zu'da la, majz a maj.o'ri.a pro.ku'row a'pe~.nas u'za la
Os seres humanos, que receberam a tarefa de guiar amorosamente o mundo, em vez disso o saquearam sem qualquer consideração.	us 'se.riz u~'ma~.nus, ki Re.se'be.ra~w~ a ta'rE.fa Di gi'ar a~.mo.rO.za~'me~.Ti u 'mu~.du, e~j~ 'vejz 'Di.su u sa.ke'a.ra~w~ se~j~ kwaw'kEX ko~.si.de.ra'sa~w~
E pensaram pouco nos próprios filhos, que vão herdar sua falta de amor.	i pe~'sa.ra~w~ 'pow.ku nus 'prO.prjus 'fi.Lus, ki 'va~w~ eR'daX 'su.a 'faw.ta Di a~'moX
Por isso usam e abusam da Terra e, quando ela estremece ou reage, se ofendem e levantam os punhos contra Deus.	pur 'i.su 'u.za~w~ i a'bu.za~w~ da 'tE.Ra i, 'kwa~.du 'E.la es.tre~'mE.si ow Re'a.Zi, si o'fe~.de~j~ i le'va~.ta~w~ us 'pu~.Jus 'ko~.tra 'dews
Você é ecologista? perguntou Mack, com um certo tom de acusação.	vo'se E e.ko.lo'Zis.ta, peR.gu~'tow 'mE.ki, ko~ u~ 'sEX.tu 'to~ Di a.ku.za'sa~w~
Esta imensa bola verde-azulada no espaço negro, cheia de beleza mesmo agora, espancada, abusada e linda.	'Es.ta i~'me~.sa 'bO.la 'veR.Di a.zu'la.da nu es'pa.su 'ne.gru, 'Sej.a Di be'le.za 'mez.mu a'gO.ra, es.pa~'ka.da, a.bu'za.da i 'li~.da
Conheço esta música.	ko~'Je.su 'Es.ta 'mu.zi.ka
Você deve se importar muito com a Criação.	vo'se 'dE.vi si i~.poX'taR 'mu~j~.tu ko~ a kri.a'sa~w~
Bom, essa bola verde-azulada no espaço negro pertence a mim, declarou Jesus enfaticamente.	'bo~, 'E.sa 'bO.la 'veR.Di a.zu'la.da nu es'pa.su 'ne.gru peX'te~.si a 'mi~, de.kla'row Ze'zujz e~.fa.Ti.ka~'me~.Ti
Depois de um momento eles abriram as sacolas do lanche.	de'pojs Di u~ mo~'me~.tu 'e.liz a'bri.ra~w~ as sa'kO.las du 'la~.Si
Papai as enchera de sanduíches e guloseimas e os dois comeram com grande apetite.	pa'paj az e~'Se.ra Di sa~.du'i.Siz i gu.lo'zej.maz i us 'dojs ko~'me.ra~w~ ko~ 'gra~.Di a.pe'Ti.Ti
Então por que vocês não consertam? perguntou Mack, mastigando o sanduíche. Quero dizer, a Terra.	e~'ta~w~ puX 'ke vo'sejs 'na~w~ ko~'sEX.ta~w~, peR.gu~'tow 'mE.ki, mas.Ti'ga~.du u sa~.du'i.Si, 'kE.ru Di'zeX, a 'tE.Ra
Por que nós a demos para vocês.	puX 'ke 'nOjz a 'de~.mus 'pa.ra vo'sejs
Não podem pegá-la de volta?	'na~w~ 'pO.de~j~ pe'ga la Di 'vOw.ta
Claro que poderíamos, mas então a história acabaria antes de ser consumada.	'kla.ru ki po.de'ri.a~.mus, majz e~'ta~w~ a is'tO.rja a.ka.ba'ri.a 'a~.Tis Di 'seX ko~.su~'ma.da
Mack deu um olhar vazio para Jesus.	'mE.ki 'dew u~ o'LaR va'zi.u 'pa.ra Ze'zujs
Já notou que, mesmo que me chamem de Senhor e Rei, eu realmente nunca agi desse modo com vocês?	'Za no'tow ki, 'mez.mu ki mi 'Sa~.me~j~ Di se~'Jor i 'Rej, ew Re.aw'me~.Ti 'nu~.ka a'Zi 'de.si 'mO.du ko~ vo'sejs
Nunca assumi o controle de suas escolhas nem os obriguei a fazer nada, mesmo quando o que estavam fazendo era destrutivo para vocês mesmos e para os outros?	'nu~.ka a.su~'mi u ko~'tro.li Di 'su.az es'ko.Las ne~j~ uz o.bri'gej a fa'zeR 'na.da, 'mez.mu 'kwa~.du u ki es'ta.va~w~ fa'ze~.du 'E.ra des.tru'Ti.vu 'pa.ra vo'sejs 'mez.muz i 'pa.ra uz 'ow.trus
Mack olhou de volta para o lago antes de responder.	'mE.ki o'Low Di 'vOw.ta 'pa.ra u 'la.gu 'a~.Tis Di Res.po~'deX
Eu preferiria que às vezes você assumisse o controle.	ew pre.fe.ri'ri.a ki as 've.zis vo'se a.su~'mi.si u ko~'tro.li
Teria economizado um bocado de dor para mim e para as pessoas de quem eu gosto.	te'ri.a e.ko~.no~.mi'za.du u~ bo'ka.du Di 'doX 'pa.ra 'mi~ i 'pa.ra as pe'so.as Di 'ke~j~ ew 'gOs.tu
Forçar minha vontade sobre a de vocês é exatamente o que o amor não faz.	foX'saR 'mi~.Ja vo~'ta.Di 'so.bri a Di vo'sejz E e.za.ta~'me~.Ti u ki u a~'moR 'na~w~ 'fajs
Os relacionamentos verdadeiros são marcados pela aceitação, mesmo quando suas escolhas não são úteis nem saudáveis.	us Re.la.si.o~.na~'me~.tus veR.da'dej.rus 'sa~w~ maX'ka.dus 'pe.la a.sej.ta'sa~w~, 'mez.mu 'kwa~.du 'su.az es'ko.Las 'na~w~ 'sa~w~ 'u.tejs ne~j~ saw'da.vejs
Esta é a beleza que você vê no meu relacionamento com Abba e Sarayu.	'Es.ta E a be'le.za ki vo'se 've nu 'mew Re.la.si.o~.na~'me~.tu ko~ 'a.ba i sa.ra'ju
Nós somos de fato submetidos uns aos outros, sempre fomos e sempre seremos.	'nOjs 'so~.mus Di 'fa.tu sub.me'Ti.duz u~z awz 'ow.trus, 'se~.pri 'fo~.muz i 'se~.pri se're~.mus
Papai é tão submetida a mim quanto eu a ela, ou Sarayu a mim, ou Papai a ela.	pa'paj E 'ta~w~ sub.me'Ti.da a 'mi~ 'kwa~.tu ew a 'E.la, ow sa.ra'ju a 'mi~, ow pa'paj a 'E.la
Submissão não tem a ver com autoridade e não é obediência.	sub.mi'sa~w~ 'na~w~ te~j~ a 'veX ko~ aw.to.ri'da.Di i 'na~w~ E o.be.Di'e~.sja
Tem a ver com relacionamentos de amor e respeito.	te~j~ a 'veX ko~ Re.la.si.o~.na~'me~.tus Di a~'mor i Res'pej.tu
Na verdade somos igualmente submetidos a você.	na veR'da.Di 'so~.muz i.gwaw'me~.Ti sub.me'Ti.duz a vo'se
Como pode ser? Por que o Deus do universo quereria se submeter a mim?	'ko~.mu 'pO.Di 'seX, puX 'ke u 'dews du u~.ni'vEX.su ke.re'ri.a si sub.me'ter a 'mi~
Porque queremos que você se junte a nós em nosso círculo de relacionamento.	puX'ke ke're~.mus ki vo'se si 'Zu~.Ti a 'nOjz e~j~ 'nO.su 'siX.ku.lu Di Re.la.si.o~.na~'me~.tu
Não quero escravos, quero irmãos e irmãs que compartilhem a vida comigo.	'na~w~ 'kE.ru es'kra.vus, 'kE.ru iR'ma~w~z i iR'ma~j~s ki ko~.paX'Ti.Le~j~ a 'vi.da ko~'mi.gu
E é assim que você quer que nós amemos uns aos outros, não é?	i E a'si~ ki vo'se 'kEX ki 'nOjz a~'me~.muz u~z awz 'ow.trus, 'na~w~ E
Quero dizer, entre maridos e esposas, pais e filhos. Em qualquer relacionamento.	'kE.ru Di'zeX, 'e~.tri ma'ri.duz i es'po.zas, 'pajz i 'fi.Lus, e~j~ kwaw'kE.Re.la.si.o~.na~'me~.tu
Quando sou sua vida, a submissão é a expressão mais natural do meu caráter e da minha natureza, e será a expressão mais natural de sua nova natureza dentro dos relacionamentos.	'kwa~.du 'sow 'su.a 'vi.da, a sub.mi'sa~w~ E a es.pre'sa~w~ 'majs na.tu'raw du 'mew ka'ra.ter i da 'mi~.Ja na.tu're.za, i se'ra a es.pre'sa~w~ 'majs na.tu'raw Di 'su.a 'nO.va na.tu're.za 'de~.tru dus Re.la.si.o~.na~'me~.tus
E o que eu mais queria era um Deus que simplesmente consertasse tudo para que ninguém se ferisse. Mack balançou a cabeça ao se dar conta disso.	i u ki ew 'majs ke'ri.a 'E.ra u~ 'dews ki si~.pliz'me~.Ti ko~.seX'ta.si 'tu.du 'pa.ra ki ni~'ge~j~ si fe'ri.si, 'mE.ki ba.la~'sow a ka'be.sa aw si 'daX 'ko~.ta 'Di.su
Mas não sou bom no campo dos relacionamentos, não sou como Nan.	majs 'na~w~ 'sow 'bo~ nu 'ka~.pu dus Re.la.si.o~.na~'me~.tus, 'na~w~ 'sow 'ko~.mu 'na~
Jesus terminou de comer o sanduíche, fechou o saco do lanche e colocou-o ao lado, no tronco.	Ze'zujs teR.mi~'now Di ko~'mer u sa~.du'i.Si, fe'Sow u 'sa.ku du 'la~.Si i ko.lo'kow u aw 'la.du, nu 'tro~.ku
Limpou algumas migalhas presas ao bigode e à barba curta.	li~'pow aw'gu~.mas mi'ga.Las 'pre.zaz aw bi'gO.Di i a 'baR.ba 'kuX.ta
Depois, pegando um pedaço de pau ali perto, começou a desenhar na areia, enquanto continuava: Isso é porque, como a maioria dos seres humanos, você procura realizar-se pelos seus feitos, e Nan, como a maioria das mulheres, pelos relacionamentos.	de'pojs, pe'ga~.du u~ pe'da.su Di 'paw a'li 'pEX.tu, ko~.me'sow a de.ze~'JaR na a'rej.a, e~'kwa~.tu ko~.Ti~.nu'a.va, 'i.su E puX'ke, 'ko~.mu a maj.o'ri.a dus 'se.riz u~'ma~.nus, vo'se pro'ku.ra Re.a.li'zaX si 'pe.lus 'sews 'fej.tus, i 'na~, 'ko~.mu a maj.o'ri.a das mu'LE.ris, 'pe.lus Re.la.si.o~.na~'me~.tus
É mais naturalmente a linguagem dela.	E 'majs na.tu.raw'me~.Ti a li~'gwa.Ze~j~ 'dE.la
Jesus parou para contemplar uma águia-pescadora mergulhar no lago a menos de 20 metros deles e, a seguir, lentamente elevar-se com as garras segurando uma grande truta que ainda lutava para escapar.	Ze'zujs pa'row 'pa.ra ko~.te~'plar u~.ma 'a.gja pes.ka'do.ra meR.gu'LaR nu 'la.gu a 'me~.nus Di 'vi~.Ti 'mE.trus 'de.liz i, a se'giX, le~.ta~'me~.Ti e.le'vaX si ko~ as 'ga.Ras se.gu'ra~.du u~.ma 'gra~.Di 'tru.ta ki a'i~.da lu'ta.va 'pa.ra es.ka'paX
Isso significa que eu não tenho saída?	'i.su si.gi~.ni'fi.ka ki ew 'na~w~ 'te~.Ju sa'i.da
Realmente quero o que vocês três compartilham, mas não faço idéia de como chegar lá.	Re.aw'me~.Ti 'kE.ru u ki vo'sejs 'trejs ko~.paX'Ti.La~w~, majs 'na~w~ 'fa.su i'dEj.a Di 'ko~.mu Se'gaR 'la
Há muita coisa obstruindo o seu caminho agora, Mack, mas você não precisa continuar vivendo assim.	'a 'mu~j~.ta 'koj.za obs.tru'i~.du u 'sew ka~'mi~.Ju a'gO.ra, 'mE.ki, majs vo'se 'na~w~ pre'si.za ko~.Ti~.nu'aR vi've~.du a'si~
Sei que isso é mais verdadeiro agora que Missy se foi, mas nunca foi fácil para mim.	'sej ki 'i.su E 'majs veR.da'dej.ru a'gO.ra ki 'mi.si si 'foj, majs 'nu~.ka 'foj 'fa.siw 'pa.ra 'mi~
Você não está simplesmente lidando com o assassinato de Missy.	vo'se 'na~w~ es'ta si~.pliz'me~.Ti li'da~.du ko~ u a.sa.si~'na.tu Di 'mi.si
Há uma reviravolta maior que torna difícil compartilhar da nossa vida.	'a u~.ma Re.vi.ra'vOw.ta maj'OX ki 'tOR.na Di'fi.siw ko~.paX.Ti'LaR da 'nO.sa 'vi.da
O mundo está partido porque no Éden vocês abandonaram o relacionamento conosco para afirmar a própria independência.	u 'mu~.du es'ta paX'Ti.du puX'ke nu 'E.de~ vo'sejz a.ba~.do~'na.ra~w~ u Re.la.si.o~.na~'me~.tu ko~'nos.ku 'pa.ra a.fiR'mar a 'prO.prja i~.de.pe~'de~.sja
A maioria dos humanos expressou isso voltando-se para o trabalho das mãos e para o suor do rosto em busca da identidade, do valor e da segurança.	a maj.o'ri.a duz u~'ma~.nuz es.pre'sow 'i.su vow'ta~.du si 'pa.ra u tra'ba.Lu das 'ma~w~z i 'pa.ra u su'OR du 'Ros.tu e~j~ 'bus.ka da i.de~.Ti'da.Di, du va'lor i da se.gu'ra~.sa
Ao optar por definir o que é bom e o que é mau, vocês buscam determinar seu próprio destino.	aw op'taX puR de.fi~'nir u ki E 'bo~ i u ki E 'maw, vo'sejs 'bus.ka~w~ de.teR.mi~'naX 'sew 'prO.prju des'Ti~.nu
Foi essa reviravolta que causou tanta dor.	'foj 'E.sa Re.vi.ra'vOw.ta ki kaw'zow 'ta~.ta 'doX
Jesus se firmou no pedaço de madeira para se levantar e parou enquanto Mack terminava de comer o sanduíche e se levantava também.	Ze'zujs si fiR'mow nu pe'da.su Di ma'dej.ra 'pa.ra si le.va~'tar i pa'row e~'kwa~.tu 'mE.ki teR.mi~'na.va Di ko~'mer u sa~.du'i.Si i si le.va~'ta.va ta~'be~j~
Juntos, começaram a andar pela margem do lago.	'Zu~.tus, ko~.me'sa.ra~w~ a a~'daX 'pe.la 'maR.Ze~j~ du 'la.gu
Mas isso não é tudo.	majz 'i.su 'na~w~ E 'tu.du
Assim, a virada da mulher não foi para a obra de suas mãos e sim para o homem, e a reação dele foi dominá-la, assumir o poder sobre ela, tornar-se o governante.	a'si~, a vi'ra.da da mu'LER 'na~w~ 'foj 'pa.ra a 'O.bra Di 'su.as 'ma~w~z i 'si~ 'pa.ra u 'o~.me~j~, i a Re.a'sa~w~ 'de.li 'foj do~mi~'na la, a.su~'mir u po'deX 'so.bri 'E.la, toR'naX si u go.veR'na~.Ti
Antes dessa escolha, a mulher encontrava sua identidade, sua segurança e sua compreensão do bem e do mal apenas em mim, da mesma forma que o homem.	'a~.Tis 'dE.sa es'ko.La, a mu'LEr e~.ko~'tra.va 'su.a i.de~.Ti'da.Di, 'su.a se.gu'ra~.sa i 'su.a ko~.pre.e~'sa~w~ du 'be~j~ i du 'maw a'pe~.naz e~j~ 'mi~, da 'mez.ma 'fOR.ma ki u 'o~.me~j~
Não é de espantar que eu me sinta um fracasso tão grande com Nan.	'na~w~ E Di es.pa~'taX ki ew mi 'si~.ta u~ fra'ka.su 'ta~w~ 'gra~.Di ko~ 'na~
Não consigo ser isso para ela.	'na~w~ ko~'si.gu 'ser 'i.su 'pa.ra 'E.la
Você não foi feito para ser.	vo'se 'na~w~ 'foj 'fej.tu 'pa.ra 'seX
E, ao tentar, estará brincando de Deus.	i, aw te~'taX, es.ta'ra bri~'ka~.du Di 'dews
Mack se abaixou, pegou uma pedra chata e atirou-a ricocheteando sobre o lago.	'mE.ki si a.baj'Sow, pe'gow u~.ma 'pE.dra 'Sa.ta i a.Ti'row a Ri.ko.Se.te'a~.du 'so.bri u 'la.gu
Há alguma saída para isso?	'a aw'gu~.ma sa'i.da 'pa.ra 'i.su
É simples demais, mas nunca é fácil para vocês.	E 'si~.plis de~'majs, majs 'nu~.ka E 'fa.siw 'pa.ra vo'sejs
A saída é voltar-se para mim.	a sa'i.da E vow'taX si 'pa.ra 'mi~
Abrir mão de seus hábitos de poder e manipulação e simplesmente voltar-se para mim. Jesus parecia estar implorando.	a'briR 'ma~w~ Di 'sewz 'a.bi.tus Di po'der i ma~.ni.pu.la'sa~w~ i si~.pliz'me~.Ti vow'taX si 'pa.ra 'mi~, Ze'zujs pa.re'si.a es'tar i~.plo'ra~.du
As mulheres, em geral, acham difícil dar as costas para um homem e parar de exigir que ele atenda às suas necessidades, que proporcione segurança e proteja a identidade delas.	as mu'LE.ris, e~j~ Ze'raw, 'a.Sa~w~ Di'fi.siw 'dar as 'kOs.tas 'pa.ra u~ 'o~.me~j~ i pa'raR Di e.zi'ZiX ki 'e.li a'te~.da as 'su.as ne.se.si'da.Dis, ki pro.poX.si'o~.ni se.gu'ra~.sa i pro'te.Za a i.de~.Ti'da.Di 'dE.las
Acham difícil retornar para mim.	'a.Sa~w~ Di'fi.siw Re.toR'naX 'pa.ra 'mi~
Os homens, por sua vez, acham muito difícil dar as costas para as obras de suas mãos, para sua busca de poder, segurança e importância.	uz 'o~.me~s, puX 'su.a 'vejs, 'a.Sa~w~ 'mu~j~.tu Di'fi.siw 'dar as 'kOs.tas 'pa.ra az 'O.bras Di 'su.as 'ma~w~s, 'pa.ra 'su.a 'bus.ka Di po'deX, se.gu'ra~.sa i i~.poX'ta~.sja
Também acham difícil retornar para mim.	ta~'be~j~ 'a.Sa~w~ Di'fi.siw Re.toR'naX 'pa.ra 'mi~
Sempre me perguntei por que os homens estão no comando, ponderou Mack.	'se~.pri mi peR.gu~'tej puX 'ke uz 'o~.me~z es'ta~w~ nu ko~'ma~.du, po~.de'row 'mE.ki
Os homens parecem ser a causa de muita dor no mundo.	uz 'o~.me~s pa'rE.se~j~ 'ser a 'kaw.za Di 'mu~j~.ta 'doR nu 'mu~.du
Cometem a maior parte dos crimes e muitos são contra mulheres e, ele fez uma pausa, crianças.	ko~'mE.te~j~ a maj'OX 'paX.Ti dus 'kri~.miz i 'mu~j~.tus 'sa~w~ 'ko~.tra mu'LE.riz i, 'e.li 'fejz u~.ma 'paw.za, kri'a~.sas
As mulheres, continuou Jesus enquanto pegava uma pedra e também a fazia ricochetear na água, nos deram as costas em busca de outro relacionamento, ao passo que os homens viraram-se para eles mesmos e para o chão.	as mu'LE.ris, ko~.Ti~.nu'ow Ze'zujz e~'kwa~.tu pe'ga.va u~.ma 'pE.dra i ta~'be~j~ a fa'zi.a Ri.ko.Se.te'aR na 'a.gwa, nus 'dE.ra~w~ as 'kOs.taz e~j~ 'bus.ka Di 'ow.tru Re.la.si.o~.na~'me~.tu, aw 'pa.su ki uz 'o~.me~s vi'ra.ra~w~ si 'pa.ra 'e.lis 'mez.muz i 'pa.ra u 'Sa~w~
O mundo, em vários sentidos, seria um lugar muito mais tranquilo e gentil se as mulheres governassem.	u 'mu~.du, e~j~ 'va.rjus se~'Ti.dus, se'ri.a u~ lu'gaR 'mu~j~.tu 'majs tra~'kwi.lu i Ze~'Tiw si as mu'LE.ris go.veR'na.se~j~
Haveria muito menos crianças sacrificadas aos deuses da cobiça e do poder.	a.ve'ri.a 'mu~j~.tu 'me~.nus kri'a~.sas sa.kri.fi'ka.daz aws 'dew.zis da ko'bi.sa i du po'deX
Então elas teriam realizado melhor esse papel.	e~'ta~w~ 'E.las te'ri.a~w~ Re.a.li'za.du me'LOr 'e.si pa'pEw
Melhor, talvez, mas ainda assim não seria suficiente.	me'LOX, taw'vejs, majz a'i~.da a'si~ 'na~w~ se'ri.a su.fi.si'e~.Ti
O poder nas mãos dos seres humanos independentes, sejam homens ou mulheres, corrompe.	u po'deR nas 'ma~w~s dus 'se.riz u~'ma~.nuz i~.de.pe~'de~.Tis, 'se.Za~w~ 'o~.me~z ow mu'LE.ris, ko'Ro~.pi
Mack, você não vê que representar papéis é o contrário do relacionamento?	'mE.ki, vo'se 'na~w~ 've ki Re.pre.ze~'taX pa'pEjz E u ko~'tra.rju du Re.la.si.o~.na~'me~.tu
Queremos que homens e mulheres sejam parceiros, iguais face a face, cada qual único e diferente, distintos em gênero mas complementares, e cada um recebendo o poder unicamente de Sarayu, de quem se origina todo o poder e autoridade verdadeiros.	ke're~.mus ki 'o~.me~z i mu'LE.ris 'se.Za~w~ paX'sej.rus, i'gwajs 'fa.si a 'fa.si, 'ka.da 'kwaw 'u~.ni.ku i Di.fe're~.Ti, Dis'Ti~.tuz e~j~ 'Ze~.ne.ru majs ko~.ple~.me~'ta.ris, i 'ka.da 'u~ Re.se'be~.du u po'der u~.ni.ka~'me~.Ti Di sa.ra'ju, Di 'ke~j~ si o.ri'Zi~.na 'to.du u po'der i aw.to.ri'da.Di veR.da'dej.rus
Lembre-se, minha identidade não se baseia em desempenho e eu não preciso me encaixar nas estruturas feitas pelos humanos.	'le~.bri si, 'mi~.Ja i.de~.Ti'da.Di 'na~w~ si ba'zej.a e~j~ de.ze~'pe~.Ju i ew 'na~w~ pre'si.zu mi e~.kaj'SaR naz es.tru'tu.ras 'fej.tas 'pe.luz u~'ma~.nus
Eu tenho a ver com ser.	ew 'te~.Ju a 'veX ko~ 'seX
À medida que você cresce no relacionamento comigo, o que fizer simplesmente refletirá quem você realmente é.	a me'Di.da ki vo'se 'krE.si nu Re.la.si.o~.na~'me~.tu ko~'mi.gu, u ki fi'zEX si~.pliz'me~.Ti Re.fle.Ti'ra 'ke~j~ vo'se Re.aw'me~.Ti E
Mas você veio na forma de homem. Isso não significa alguma coisa?	majs vo'se 'vej.u na 'fOR.ma Di 'o~.me~j~, 'i.su 'na~w~ si.gi~.ni'fi.ka aw'gu~.ma 'koj.za
Sim, mas não o que muitos imaginam.	'si~, majs 'na~w~ u ki 'mu~j~.tuz i~.ma'Zi~.na~w~
Vim como homem para completar a imagem maravilhosa de como fizemos vocês.	'vi~ 'ko~.mu 'o~.me~j~ 'pa.ra ko~.ple'tar a i~'ma.Ze~j~ ma.ra.vi'LO.za Di 'ko~.mu fi'ze~.mus vo'sejs
Desde o primeiro dia escondemos a mulher no homem, de modo que na hora certa pudéssemos retirá-la de dentro dele.	'dez.Di u pri~'mej.ru 'Di.a es.ko~'de~.muz a mu'LER nu 'o~.me~j~, Di 'mO.du ki na 'O.ra 'sEX.ta pu'dE.se~.mus Re.Ti'ra la Di 'de~.tru 'de.li
Não criamos o homem para viver sozinho.	'na~w~ kri'a~.muz u 'o~.me~j~ 'pa.ra vi'veX sO'zi~.Ju
A mulher foi projetada desde o início.	a mu'LEX 'foj pro.Ze'ta.da 'dez.Di u i~'ni.sju
Ao tirá-la de dentro dele, de certa forma ele a deu à luz.	aw Ti'ra la Di 'de~.tru 'de.li, Di 'sEX.ta 'fOR.ma 'e.li a 'dew a 'lujs
Criamos um círculo de relacionamento como o nosso, mas para os humanos.	kri'a~.muz u~ 'siX.ku.lu Di Re.la.si.o~.na~'me~.tu 'ko~.mu u 'nO.su, majs 'pa.ra uz u~'ma~.nus
Ela saindo dele e agora todos os homens, inclusive eu, nascidos dela, e tudo se originando ou nascendo de Deus.	'E.la sa'i~.du 'de.li i a'gO.ra 'to.duz uz 'o~.me~s, i~.klu'zi.vi ew, na'si.dus 'dE.la, i 'tu.du si o.ri.Zi~'na~.du ow na'se~.du Di 'dews
Ah, entendi, exclamou Mack, interrompendo o gesto de atirar outra pedra.	'a, e~.te~'Di, es.kla~'mow 'mE.ki, i~.te.Ro~'pe~.du u 'ZEs.tu Di a.Ti'rar 'ow.tra 'pE.dra
Se a mulher fosse criada primeiro, não haveria um círculo de relacionamento e não se tornaria possível um relacionamento totalmente igual, cara a cara, entre o homem e a mulher. Certo?	si a mu'LEX 'fo.si kri'a.da pri~'mej.ru, 'na~w~ a.ve'ri.a u~ 'siX.ku.lu Di Re.la.si.o~.na~'me~.tu i 'na~w~ si toR.na'ri.a po'si.vew u~ Re.la.si.o~.na~'me~.tu to.taw'me~.Ti i'gwaw, 'ka.ra a 'ka.ra, 'e~.tri u 'o~.me~j~ i a mu'LEX, 'sEX.tu
Certíssimo, Mack. Jesus olhou-o e riu.	seX'Ti.si~.mu, 'mE.ki, Ze'zujz o'Low u i 'Riw
Nosso desejo foi criar um ser que tivesse uma contrapartida totalmente igual e poderosa: o homem e a mulher.	'nO.su de'ze.Zu 'foj kri'ar u~ 'seX ki Ti'vE.si u~.ma ko~.tra.paX'Ti.da to.taw'me~.Ti i'gwaw i po.de'rO.za, u 'o~.me~j~ i a mu'LEX
Mas sua independência, com a busca de poder e de realização, na verdade destrói o relacionamento que seu coração deseja.	majs 'su.a i~.de.pe~'de~.sja, ko~ a 'bus.ka Di po'der i Di Re.a.li.za'sa~w~, na veR'da.Di des'trOj u Re.la.si.o~.na~'me~.tu ki 'sew ko.ra'sa~w~ de'ze.Za
Aí está de novo, disse Mack, procurando uma pedra mais chata.	a'i es'ta Di 'no.vu, 'Di.si 'mE.ki, pro.ku'ra~.du u~.ma 'pE.dra 'maj'Sa.ta
A questão sempre volta ao poder e a como ele é oposto ao relacionamento que vocês têm entre si.	a kes'ta~w~ 'se~.pri 'vOw.ta aw po'der i a 'ko~.mu 'e.li E o'pos.tu aw Re.la.si.o~.na~'me~.tu ki vo'sejs 'te~j~ 'e~.tri si
Eu adoraria experimentar isso com vocês e com Nan.	ew a.do.ra'ri.a es.pe.ri~.me~'tar 'i.su ko~ vo'sejz i ko~ 'na~
E por essa razão está aqui.	i pur 'E.sa Ra'za~w~ es'ta a'ki
Gostaria que ela estivesse também.	gos.ta'ri.a ki 'E.la es.Ti'vE.si ta~'be~j~
Ah, o que poderia ter sido! meditou Jesus.	'a, u ki po.de'ri.a 'teX 'si.du, me.Di'tow Ze'zujs
Mack não teve idéia do que ele queria dizer.	'mE.ki 'na~w~ 'te.vi i'dEj.a du ki 'e.li ke'ri.a Di'zeX
O silêncio se instalou por alguns minutos, interrompido pelo som leve das pedras ricocheteando na água.	u si'le~.sju si i~s.ta'low pur aw'gu~s mi~'nu.tus, i~.te.Ro~'pi.du 'pe.lu 'so~ 'lE.vi das 'pE.dras Ri.ko.Se.te'a~.du na 'a.gwa
Jesus parou antes de jogar mais uma pedra.	Ze'zujs pa'row 'a~.Tis Di Zo'gaR 'majz u~.ma 'pE.dra
Uma última coisa que eu quero que você lembre desta conversa, Mack, antes de você ir.	u~.ma 'uw.Ti~.ma 'koj.za ki ew 'kE.ru ki vo'se 'le~.bri 'dEs.ta ko~'vEX.sa, 'mE.ki, 'a~.Tis Di vo'se 'iX
Ele jogou a pedra.	'e.li Zo'gow a 'pE.dra
Mack levantou os olhos, surpreso.	'mE.ki le.va~'tow uz 'O.Lus, suX'pre.zu
Antes de eu ir?	'a~.Tis Di ew 'iX
Jesus ignorou a pergunta.	Ze'zujz i.gi~.no'row a peR'gu~.ta
Mack, assim como o amor, a submissão não é algo que você pode praticar, especialmente sozinho.	'mE.ki, a'si~ 'ko~.mu u a~'moX, a sub.mi'sa~w~ 'na~w~ E 'aw.gu ki vo'se 'pO.Di pra.Ti'kaX, es.pe.si.aw'me~.Ti sO'zi~.Ju
Fora de minha vida dentro de você, você não pode se submeter a Nan, ou aos seus filhos, ou a mais ninguém, inclusive Papai.	'fO.ra Di 'mi~.Ja 'vi.da 'de~.tru Di vo'se, vo'se 'na~w~ 'pO.Di si sub.me'ter a 'na~, ow aws 'sews 'fi.Lus, ow a 'majs ni~'ge~j~, i~.klu'zi.vi pa'paj
Quer dizer, exclamou Mack, um tanto sarcástico, que eu não posso simplesmente perguntar: O que Jesus faria?	'kER Di'zeX, es.kla~'mow 'mE.ki, u~ 'ta~.tu saX'kas.Ti.ku, ki ew 'na~w~ 'pO.su si~.pliz'me~.Ti peR.gu~'taX, u ki Ze'zujs fa'ri.a
Boas intenções, má idéia.	'bo.az i~.te~'so~j~s, 'ma i'dEj.a
Não deixe de me contar como a coisa funciona para você, se escolher esse caminho.	'na~w~ 'dej.Si Di mi ko~'taX 'ko~.mu a 'koj.za fu~.si'o~.na 'pa.ra vo'se, si es.ko'Ler 'e.si ka~'mi~.Ju
Parou e ficou sério.	pa'row i fi'kow 'sE.rju
É verdade, minha vida não se destinava a tornar-se um exemplo a copiar.	E veR'da.Di, 'mi~.Ja 'vi.da 'na~w~ si des.Ti~'na.va a toR'naX si u~ e'ze~.plu a ko.pi'aX
Ser meu seguidor não significa tentar ser como Jesus, significa matar sua independência.	'seR 'mew se.gi'doR 'na~w~ si.gi~.ni'fi.ka te~'taX 'seX 'ko~.mu Ze'zujs, si.gi~.ni'fi.ka ma'taX 'su.a i~.de.pe~'de~.sja
Eu vim lhe dar vida, vida real, minha vida.	ew 'vi~ Li 'daR 'vi.da, 'vi.da Re'aw, 'mi~.Ja 'vi.da
Nós viveremos nossa vida dentro de você, de modo que você comece a ver com nossos olhos, ouvir com nossos ouvidos, tocar com nossas mãos e pensar como nós.	'nOjs vi.ve're~.mus 'nO.sa 'vi.da 'de~.tru Di vo'se, Di 'mO.du ki vo'se ko~'mE.si a 'veX ko~ 'nO.suz 'O.Lus, ow'viX ko~ 'nO.suz ow'vi.dus, to'kaX ko~ 'nO.sas 'ma~w~z i pe~'saX 'ko~.mu 'nOjs
Mas nunca forçaremos essa união.	majs 'nu~.ka foX.sa're~.muz 'E.sa u~.ni'a~w~
Se você quiser fazer as coisas do seu jeito, tudo bem.	si vo'se ki'zEX fa'zer as 'koj.zas du 'sew 'Zej.tu, 'tu.du 'be~j~
O tempo está a nosso favor.	u 'te~.pu es'ta a 'nO.su fa'voX
E, por falar em tempo, Jesus virou-se e apontou para o caminho que levava até a floresta no fim da clareira, você tem um compromisso.	i, puX fa'lar e~j~ 'te~.pu, Ze'zujs vi'row si i a.po~'tow 'pa.ra u ka~'mi~.Ju ki le'va.va a'tE a flo'rEs.ta nu 'fi~ da kla'rej.ra, vo'se 'te~j~ u~ ko~.pro~'mi.su
Siga aquele caminho e entre onde ele acaba.	'si.ga a'ke.li ka~'mi~.Ju i 'e~.tri 'o~.Di 'e.li a'ka.ba
Vou esperar aqui.	'vow es.pe'rar a'ki
Por mais que quisesse, Mack soube que não adiantaria tentar prosseguir na conversa.	puR 'majs ki ki'zE.si, 'mE.ki 'sow.bi ki 'na~w~ a.Di.a~.ta'ri.a te~'taX pro.se'giR na ko~'vEX.sa
Num silêncio pensativo, calçou as meias e os sapatos.	nu~ si'le~.sju pe~.sa'Ti.vu, kaw'sow as 'mej.az i us sa'pa.tus
Não estavam totalmente secos, mas ofereciam algum conforto.	'na~w~ es'ta.va~w~ to.taw'me~.Ti 'sE.kus, majz o.fe.re'si.a~w~ aw'gu~ ko~'foX.tu
Levantou-se sem dizer mais nada, foi na direção do fim da praia, parou um minuto para olhar de novo a cachoeira, pulou por cima do córrego e entrou na floresta por um caminho bem cuidado e nítido.	le.va~'tow si se~j~ Di'zeR 'majs 'na.da, 'foj na Di.re'sa~w~ du 'fi~ da 'praj.a, pa'row 'u~ mi~'nu.tu 'pa.ra o'LaR Di 'no.vu a ka.So'ej.ra, pu'low puX 'si~.ma du 'kO.Re.gu i e~'trow na flo'rEs.ta pur u~ ka~'mi~.Ju 'be~j~ kuj'da.du i 'ni.Ti.du
Quem decidir se colocar como juiz da Verdade e do Conhecimento será naufragado pela gargalhada dos deuses.	'ke~j~ de.si'DiX si ko.lo'kaX 'ko~.mu Zu'iz da veR'da.Di i du ko~.Je.si~'me~.tu se'ra naw.fra'ga.du 'pe.la gaR.ga'La.da dus 'dew.zis
Ah, minha alma, prepare-se para encontrar Aquele que sabe fazer perguntas.	'a, 'mi~.Ja 'aw.ma, pre'pa.ri si 'pa.ra e~.ko~'trar a'ke.li ki 'sa.bi fa'zeX peR'gu~.tas
Mack seguiu a trilha, que serpenteava, passando pela cachoeira, afastando-se do lago, e atravessou um denso bosque de cedros.	'mE.ki se'giw a 'tri.La, ki seX.pe~.te'a.va, pa'sa~.du 'pe.la ka.So'ej.ra, a.fas'ta~.du si du 'la.gu, i a.tra.ve'sow u~ 'de~.su 'bOs.ki Di 'sE.drus
Demorou menos de cinco minutos para chegar a um impasse.	de~.mo'row 'me~.nus Di 'si~.ku mi~'nu.tus 'pa.ra Se'gar a u~ i~'pa.si
O caminho o levou diretamente até a face de uma rocha onde havia a leve silhueta de uma porta praticamente invisível.	u ka~'mi~.Ju u le'vow Di.rE.ta~'me~.Ti a'tE a 'fa.si Di u~.ma 'RO.Sa 'o~.Di a'vi.a a 'lE.vi si.Lu'e.ta Di u~.ma 'pOX.ta pra.Ti.ka~'me~.Ti i~.vi'zi.vew
Obviamente ele devia entrar, por isso estendeu a mão, hesitando, e empurrou.	Ob.vi.a~'me~.Ti 'e.li de'vi.a e~'traX, pur 'i.su es.te~'dew a 'ma~w~, e.zi'ta~.du, i e~.pu'Row
Sua mão simplesmente penetrou na parede e Mack continuou a se mover cautelosamente adiante até todo o seu corpo passar pelo que parecia o sólido exterior de pedra da montanha.	'su.a 'ma~w~ si~.pliz'me~.Ti pe~.ne'trow na pa're.Di i 'mE.ki ko~.Ti~.nu'ow a si mo'veX kaw.te.lO.za~'me~.Ti a.Di'a~.Ti a'tE 'to.du u 'sew 'koX.pu pa'saX 'pe.lu ki pa.re'si.a u 'sO.li.du es.te.ri'oR Di 'pE.dra da mo~'ta~.Ja
Dentro, a escuridão era tão espessa que ele nada via.	'de~.tru, a es.ku.ri'da~w~ 'E.ra 'ta~w~ es'pe.sa ki 'e.li 'na.da 'vi.a
Respirando fundo e com as mãos estendidas à frente do corpo, aventurou-se dando pequenos passos na escuridão total e parou.	Res.pi'ra~.du 'fu~.du i ko~ as 'ma~w~z es.te~'Di.daz a 'fre~.Ti du 'koX.pu, a.ve~.tu'row si 'da~.du pe'ke~.nus 'pa.sus na es.ku.ri'da~w~ to'taw i pa'row
O medo o dominou e ele respirava com dificuldade, sem saber se deveria prosseguir ou não.	u 'me.du u do~.mi~'now i 'e.li Res.pi'ra.va ko~ Di.fi.kuw'da.Di, se~j~ sa'beX si de.ve'ri.a pro.se'gir ow 'na~w~
Enquanto seu estômago se apertava, sentiu de novo a Grande Tristeza pousando pesadamente em seus ombros, quase o sufocando.	e~'kwa~.tu 'sew es'to~.ma.gu si a.peX'ta.va, se~'Tiw Di 'no.vu a 'gra~.Di tris'te.za pow'za~.du pe.za.da~'me~.Ti e~j~ 'sewz 'o~.brus, 'kwa.zi u su.fo'ka~.du
Queria voltar desesperadamente para a luz, mas acreditava que Jesus não iria mandá-lo para ali sem um bom propósito.	ke'ri.a vow'taR de.zes.pe.ra.da~'me~.Ti 'pa.ra a 'lujs, majz a.kre.Di'ta.va ki Ze'zujs 'na~w~ i'ri.a ma~'da lu 'pa.ra a'li se~j~ u~ 'bo~ pro'pO.zi.tu
Foi em frente.	'foj e~j~ 'fre~.Ti
Devagar, seus olhos se acostumaram com as sombras profundas e foi possível perceber um corredor se curvando à esquerda.	de.va'gaX, 'sewz 'O.Lus si a.kos.tu~'ma.ra~w~ ko~ as 'so~.bras pro'fu~.daz i 'foj po'si.vew peX.se'ber u~ ko.Re'doX si kuR'va~.du a es'keR.da
Enquanto seguia por ele, surgiu uma leve luminosidade que se refletia nas paredes, vinda de algum lugar à frente.	e~'kwa~.tu se'gi.a pur 'e.li, suR'Ziw u~.ma 'lE.vi lu~.mi~.no.zi'da.Di ki si Re.fle'Ti.a nas pa're.Dis, 'vi~.da Di aw'gu~ lu'gar a 'fre~.Ti
A menos de 30 metros o túnel virou abruptamente para a esquerda e Mack se viu na borda do que imaginou ser uma caverna enorme.	a 'me~.nus Di 'tri~.ta 'mE.truz u 'tu~.new vi'row a.brup.ta~'me~.Ti 'pa.ra a es'keR.da i 'mE.ki si 'viw na 'bOR.da du ki i~.ma.Zi~'now 'ser u~.ma ka'vER.na e~'nOR.mi
A ilusão era ampliada pela única luz presente, um leve fulgor que o envolvia, mas se dissipava a menos de 3 metros em todas as direções.	a i.lu'za~w~ 'E.ra a~.pli'a.da 'pe.la 'u~.ni.ka 'lujs pre'ze~.Ti, u~ 'lE.vi fuw'goX ki u e~.vow'vi.a, majs si Di.si'pa.va a 'me~.nus Di 'trejs 'mE.truz e~j~ 'to.daz as Di.re'so~j~s
Para além disso não conseguia ver nada, somente o negrume.	'pa.ra a'le~j~ 'Di.su 'na~w~ ko~.se'gi.a 'veR 'na.da, sO~'me~.Ti u ne'gru~.mi
O ar era pesado e opressivo, com um frio de tirar o fôlego.	u 'ar 'E.ra pe'za.du i o.pre'si.vu, ko~ u~ 'fri.u Di Ti'rar u 'fo.le.gu
Olhou para baixo e ficou aliviado ao vislumbrar o leve reflexo de uma superfície, não a terra e a rocha do túnel, mas um piso liso e escuro como mica polida.	o'Low 'pa.ra 'baj.Su i fi'kow a.li.vi'a.du aw viz.lu~'brar u 'lE.vi Re'flEk.su Di u~.ma su.peX'fi.si, 'na~w~ a 'tE.Ra i a 'RO.Sa du 'tu~.new, majz u~ 'pi.zu 'li.zu i es'ku.ru 'ko~.mu 'mi.ka po'li.da
Dando corajosamente um passo à frente, notou que o círculo de luz se movia com ele, iluminando um pouco mais a área adiante.	'da~.du ko.ra.ZO.za~'me~.Ti u~ 'pa.su a 'fre~.Ti, no'tow ki u 'siX.ku.lu Di 'lujs si mo'vi.a ko~ 'e.li, i.lu~.mi~'na~.du u~ 'pow.ku 'majz a 'a.rja a.Di'a~.Ti
Sentindo-se mais confiante, começou a andar lenta e deliberadamente na direção para a qual estivera virado, concentrando-se no chão.	se~'Ti~.du si 'majs ko~.fi'a~.Ti, ko~.me'sow a a~'daR 'le~.ta i de.li.be.ra.da~'me~.Ti na Di.re'sa~w~ 'pa.ra a 'kwaw es.Ti'vE.ra vi'ra.du, ko~.se~'tra~.du si nu 'Sa~w~
Estava tão ligado nos próprios pés que trombou num objeto e quase caiu.	es'ta.va 'ta~w~ li'ga.du nus 'prO.prjus 'pEjs ki tro~'bow nu~ ob'ZE.tu i 'kwa.zi ka'iw
Mack decidiu rapidamente sentar-se e esperar.	'mE.ki de.si'Diw Ra.pi.da~'me~.Ti se~'taX si i es.pe'raX
Ao fazer isso, a luz que o havia ajudado continuou a se mover à frente como se ele ainda estivesse andando.	aw fa'zer 'i.su, a 'lujs ki u a'vi.a a.Zu'da.du ko~.Ti~.nu'ow a si mo'ver a 'fre~.Ti 'ko~.mu si 'e.li a'i~.da es.Ti'vE.si a~'da~.du
Logo adiante pôde ver uma escrivaninha de ébano, de tamanho considerável, completamente vazia.	'lO.gu a.Di'a~.Ti 'po.Di 'ver u~.ma es.kri.va~'ni~.Ja Di 'E.ba~.nu, Di ta~'ma~.Ju ko~.si.de'ra.vew, ko~.plE.ta~'me~.Ti va'zi.a
E deu um pulo quando a luz se concentrou num ponto e finalmente ele a viu.	i 'dew u~ 'pu.lu 'kwa~.du a 'lujs si ko~.se~'trow nu~ 'po~.tu i fi~.naw'me~.Ti 'e.li a 'viw
Atrás da mesa se encontrava uma mulher alta, linda, de pele morena, com feições hispânicas bem marcadas, vestindo um manto largo de cores escuras.	a'trajs da 'me.za si e~.ko~'tra.va u~.ma mu'LEr 'aw.ta, 'li~.da, Di 'pE.li mo're~.na, ko~ fej'so~j~z is'pa~.ni.kas 'be~j~ maX'ka.das, ves'Ti~.du u~ 'ma~.tu 'laR.gu Di 'ko.riz es'ku.ras
Estava sentada ereta e regia como um juiz da suprema corte.	es'ta.va se~'ta.da e'rE.ta i Re'Zi.a 'ko~.mu u~ Zu'iz da su'pre~.ma 'koX.Ti
Sua beleza era estonteante.	'su.a be'le.za 'E.ra es.to~.te'a~.Ti
Ela é a beleza, pensou ele.	'E.la E a be'le.za, pe~'sow 'e.li
Tudo que a sensualidade luta para ser mas fica muito longe de conseguir.	'tu.du ki a se~.su.a.li'da.Di 'lu.ta 'pa.ra 'seR majs 'fi.ka 'mu~j~.tu 'lo~.Zi Di ko~.se'giX
À luz fraca era difícil ver onde seu rosto começava, como se o cabelo e o manto emoldurassem as feições e se fundissem nelas.	a 'lujs 'fra.ka 'E.ra Di'fi.siw 'ver 'o~.Di 'sew 'Ros.tu ko~.me'sa.va, 'ko~.mu si u ka'be.lu i u 'ma~.tu e~.mow.du'ra.se~j~ as fej'so~j~z i si fu~'Di.se~j~ 'nE.las
Os olhos brilhavam e luziam como se fossem portais para a vastidão do céu estrelado, refletindo alguma fonte de luz desconhecida dentro da mulher.	uz 'O.Lus bri'La.va~w~ i lu'zi.a~w~ 'ko~.mu si 'fo.se~j~ poX'tajs 'pa.ra a vas.Ti'da~w~ du 'sEw es.tre'la.du, Re.fle'Ti~.du aw'gu~.ma 'fo~.Ti Di 'lujz des.ko~.Je'si.da 'de~.tru da mu'LEX
Mack não ousou falar, com medo de que sua voz fosse engolida pela intensidade do ambiente.	'mE.ki 'na~w~ ow'zow fa'laX, ko~ 'me.du Di ki 'su.a 'vOjs 'fo.si e~.go'li.da 'pe.la i~.te~.si'da.Di du a~.bi'e~.Ti
Pensou: Sou o camundongo Mickey em vias de falar com Pavarotti.	pe~'sow, 'sow u ka~.mu~'do~.gu 'mi.kej e~j~ 'vi.as Di fa'laX ko~ pa.va'rO.Ti
O pensamento o fez sorrir.	u pe~.sa~'me~.tu u 'fejs so'RiX
Como se de algum modo o tivesse ouvido, a mulher sorriu de volta e o lugar clareou nitidamente.	'ko~.mu si Di aw'gu~ 'mO.du u Ti'vE.si ow'vi.du, a mu'LEX so'Riw Di 'vOw.ta i u lu'gaX kla.re'ow ni.Ti.da~'me~.Ti
Foi o necessário para Mack entender que era esperado e bem-vindo.	'foj u ne.se'sa.rju 'pa.ra 'mE.ki e~.te~'deX ki 'E.ra es.pe'ra.du i 'be~j~ 'vi~.du
A mulher parecia estranhamente familiar, como se ele a tivesse conhecido ou vislumbrado em algum lugar no passado, apesar de saber que nunca a vira nem se encontrara com ela de verdade.	a mu'LEX pa.re'si.a es.tra~.Ja~'me~.Ti fa~.mi.li'aX, 'ko~.mu si 'e.li a Ti'vE.si ko~.Je'si.du ow viz.lu~'bra.du e~j~ aw'gu~ lu'gaR nu pa'sa.du, a.pe'zaR Di sa'beX ki 'nu~.ka a 'vi.ra ne~j~ si e~.ko~'tra.ra ko~ 'E.la Di veR'da.Di
Ela ignorou a pergunta.	'E.la i.gi~.no'row a peR'gu~.ta
Você sabe por que está aqui?	vo'se 'sa.bi puX 'ke es'ta a'ki
Como uma brisa varrendo a poeira, a voz dela afastou a pergunta de Mack para fora da sala.	'ko~.mu u~.ma 'bri.za va'Re~.du a po'ej.ra, a 'vOjz 'dE.la a.fas'tow a peR'gu~.ta Di 'mE.ki 'pa.ra 'fO.ra da 'sa.la
Ele quase podia sentir as palavras chovendo sobre sua cabeça e se dissolvendo na coluna vertebral, lançando arrepios deliciosos para todos os lados.	'e.li 'kwa.zi po'Di.a se~'Tir as pa'la.vra.So've~.du 'so.bri 'su.a ka'be.sa i si Di.sow've~.du na ko'lu~.na veX.te'braw, la~'sa~.du a.Re'pi.us de.li.si'O.zus 'pa.ra 'to.duz us 'la.dus
Estremeceu e decidiu que não queria falar.	es.tre~.me'sew i de.si'Diw ki 'na~w~ ke'ri.a fa'laX
Só desejava que ela falasse, com ele ou com qualquer um, desde que ele a ouvisse.	'sO de.ze'Za.va ki 'E.la fa'la.si, ko~ 'e.li ow ko~ kwaw'kEr 'u~, 'dez.Di ki 'e.li a ow'vi.si
Mas a mulher esperou.	majz a mu'LEr es.pe'row
Você sabe, disse ele baixinho, surpreso com a sonoridade da própria voz e convicto de que dizia a verdade.	vo'se 'sa.bi, 'Di.si 'e.li baj'Si~.Ju, suX'pre.zu ko~ a so~.no.ri'da.Di da 'prO.prja 'vOjz i ko~'vik.tu Di ki Di'zi.a a veR'da.Di
Eu não faço idéia, acrescentou, voltando o olhar para o chão.	ew 'na~w~ 'fa.su i'dEj.a, a.kre.se~'tow, vow'ta~.du u o'LaX 'pa.ra u 'Sa~w~
Ninguém me disse.	ni~'ge~j~ mi 'Di.si
Bem, Mackenzie Allen Phillips, ela riu, fazendo-o levantar os olhos rapidamente.	'be~j~, ma'ke~.zi 'a.le~ 'fi.lips, 'E.la 'Riw, fa'ze~.du u le.va~'tar uz 'O.Lus Ra.pi.da~'me~.Ti
Estou aqui para ajudá-lo.	es'tow a'ki 'pa.ra a.Zu'da lu
Se um arco-íris ou uma flor desabrochando fizessem som, esse seria o som do riso dela.	si u~ 'aX.ku 'i.ris ow u~.ma 'floR de.za.bro'Sa~.du fi'zE.se~j~ 'so~, 'e.si se'ri.a u 'so~ du 'Ri.zu 'dE.la
Era uma chuva de luz, um convite para falar, e Mack riu com ela, sem mesmo saber ou se importar por quê.	'E.ra u~.ma 'Su.va Di 'lujs, u~ ko~'vi.Ti 'pa.ra fa'laX, i 'mE.ki 'Riw ko~ 'E.la, se~j~ 'mez.mu sa'ber ow si i~.poX'taX puX 'ke
De novo houve silêncio, e o rosto da mulher, embora permanecesse suave, assumiu uma intensidade feroz, como se ela pudesse olhar no fundo dele, para além dos fingimentos e fachadas, até os lugares dos quais raramente se fala, se é que se fala.	Di 'no.vu 'ow.vi si'le~.sju, i u 'Ros.tu da mu'LEX, e~'bO.ra peR.ma~.ne'se.si su'a.vi, a.su~'miw u~.ma i~.te~.si'da.Di fe'rOjs, 'ko~.mu si 'E.la pu'dE.si o'LaR nu 'fu~.du 'de.li, 'pa.ra a'le~j~ dus fi~.Zi~'me~.tuz i fa'Sa.das, a'tE us lu'ga.ris dus 'kwajs Ra.ra~'me~.Ti si 'fa.la, si E ki si 'fa.la
Hoje é um dia muito sério, com consequências sérias. Ela fez uma pausa, como para dar peso às suas palavras nitidamente pesadas.	'o.Zi E u~ 'Di.a 'mu~j~.tu 'sE.rju, ko~ ko~.se'kwe~.sjas 'sE.rjas, 'E.la 'fejz u~.ma 'paw.za, 'ko~.mu 'pa.ra 'daX 'pe.zu as 'su.as pa'la.vras ni.Ti.da~'me~.Ti pe'za.das
Mackenzie, você está aqui em parte por causa de seus filhos, mas também está aqui por...	ma'ke~.zi, vo'se es'ta a'ki e~j~ 'paX.Ti puX 'kaw.za Di 'sews 'fi.Lus, majs ta~'be~j~ es'ta a'ki puX
Meus filhos? interrompeu Mack.	'mews 'fi.Lus, i~.te.Ro~'pew 'mE.ki
Como assim, estou aqui por causa dos meus filhos?	'ko~.mu a'si~, es'tow a'ki puX 'kaw.za dus 'mews 'fi.Lus
Mackenzie, você ama seus filhos de um modo que seu pai jamais conseguiu amar você e suas irmãs.	ma'ke~.zi, vo'se 'a~.ma 'sews 'fi.Lus Di u~ 'mO.du ki 'sew 'paj Za~'majs ko~.se'giw a~'maR vo'se i 'su.az iR'ma~j~s
Claro que amo meus filhos.	'kla.ru ki 'a~.mu 'mews 'fi.Lus
Todo pai ama os filhos.	'to.du 'paj 'a~.ma us 'fi.Lus
Mas por que isso tem a ver com o motivo de eu estar aqui?	majs puX 'ke 'i.su te~j~ a 'veX ko~ u mo'Ti.vu Di ew es'tar a'ki
Em certo sentido, todo pai ama os filhos, respondeu ela, ignorando a segunda pergunta.	e~j~ 'sEX.tu se~'Ti.du, 'to.du 'paj 'a~.ma us 'fi.Lus, Res.po~'dew 'E.la, i.gi~.no'ra~.du a se'gu~.da peR'gu~.ta
Mas alguns pais estão machucados demais para amá-los bem, e outros mal conseguem amá-los, você deveria saber disso.	majz aw'gu~s 'pajz es'ta~w~ ma.Su'ka.dus de~'majs 'pa.ra a~'ma lus 'be~j~, i 'ow.trus 'maw ko~'sE.ge~j~ a~'ma lus, vo'se de.ve'ri.a sa'beR 'Di.su
Mas você ama seus filhos bem, muito bem.	majs vo'se 'a~.ma 'sews 'fi.Lus 'be~j~, 'mu~j~.tu 'be~j~
Aprendi muito disso com Nan.	a.pre~'Di 'mu~j~.tu 'Di.su ko~ 'na~
Mas aprendeu, não foi?	majz a.pre~'dew, 'na~w~ 'foj
Dentre os mistérios de uma humanidade ferida, este também é bastante notável: aprender, permitir a mudança.	'de~.tri us mis'tE.rjus Di u~.ma u~.ma~.ni'da.Di fe'ri.da, 'es.Ti ta~'be~j~ E bas'ta~.Ti no'ta.vew, a.pre~'deX, peR.mi'Tir a mu'da~.sa
Ela era calma como um mar sem vento.	'E.la 'E.ra 'kaw.ma 'ko~.mu u~ 'maX se~j~ 've~.tu
Então, Mackenzie, qual de seus filhos você mais ama?	e~'ta~w~, ma'ke~.zi, 'kwaw Di 'sews 'fi.Lus vo'se 'majz 'a~.ma
Mack sorriu por dentro.	'mE.ki so'Riw puR 'de~.tru
Era uma pergunta que ele se fizera muitas vezes sem encontrar resposta.	'E.ra u~.ma peR'gu~.ta ki 'e.li si fi'zE.ra 'mu~j~.tas 've.zis se~j~ e~.ko~'tra.Res'pOs.ta
Não amo nenhum mais do que os outros.	'na~w~ 'a~.mu ne~'Ju~ 'majs du ki uz 'ow.trus
Amo cada um de um modo diferente, disse, escolhendo as palavras com cuidado.	'a~.mu 'ka.da 'u~ Di u~ 'mO.du Di.fe're~.Ti, 'Di.si, es.ko'Le~.du as pa'la.vras ko~ kuj'da.du
Explique isso, Mackenzie, pediu ela com interesse.	es'pli.ki 'i.su, ma'ke~.zi, pe'Diw 'E.la ko~ i~.te're.si
Bom, cada um dos meus filhos é único, tem uma personalidade especial.	'bo~, 'ka.da 'u~ dus 'mews 'fi.Luz E 'u~.ni.ku, te~j~ u~.ma peX.so~.na.li'da.Di es.pe.si'aw
E essa condição única provoca uma reação única em mim.	i 'E.sa ko~.Di'sa~w~ 'u~.ni.ka pro'vO.ka u~.ma Re.a'sa~w~ 'u~.ni.ka e~j~ 'mi~
Mack se recostou na cadeira.	'mE.ki si Re.kos'tow na ka'dej.ra
Lembro-me de quando Jon, o primeiro, nasceu.	'le~.bru mi Di 'kwa~.du 'Zo~w~, u pri~'mej.ru, na'sew
Fiquei tão maravilhado com aquele ser tão pequeno e frágil que na verdade me preocupei, pensando se me restaria amor para um segundo filho.	fi'kej 'ta~w~ ma.ra.vi'La.du ko~ a'ke.li 'seX 'ta~w~ pe'ke~.nu i 'fra.Ziw ki na veR'da.Di mi prew.ku'pej, pe~'sa~.du si mi Res.ta'ri.a a~'moX 'pa.ra u~ se'gu~.du 'fi.Lu
Pensando bem, é como quando Papai diz que gosta de modo especial de alguém.	pe~'sa~.du 'be~j~, E 'ko~.mu 'kwa~.du pa'paj 'Dis ki 'gOs.ta Di 'mO.du es.pe.si'aw Di aw'ge~j~
Quando penso em cada um dos meus filhos individualmente, descubro que gosto especialmente de cada um.	'kwa~.du 'pe~.su e~j~ 'ka.da 'u~ dus 'mews 'fi.Luz i~.Di.vi.du.aw'me~.Ti, des'ku.bru ki 'gOs.tu es.pe.si.aw'me~.Ti Di 'ka.da 'u~
Muito bem, Mackenzie! A apreciação dela era tangível e ela prosseguiu, inclinando-se um pouco, com o tom ainda suave, porém sério.	'mu~j~.tu 'be~j~, ma'ke~.zi, a a.pre.si.a'sa~w~ 'dE.la 'E.ra ta~'Zi.vew i 'E.la pro.se'giw, i~.kli~'na~.du si u~ 'pow.ku, ko~ u 'to~ a'i~.da su'a.vi, po're~j~ 'sE.rju
Mas e quando eles não se comportam, ou quando fazem escolhas diferentes das que você gostaria que fizessem, ou quando são agressivos e grosseiros?	majz i 'kwa~.du 'e.lis 'na~w~ si ko~'pOX.ta~w~, ow 'kwa~.du 'fa.ze~j~ es'ko.Las Di.fe're~.Tis das ki vo'se gos.ta'ri.a ki fi'zE.se~j~, ow 'kwa~.du 'sa~w~ a.gre'si.vuz i gro'sej.rus
E quando eles o embaraçam na frente dos outros?	i 'kwa~.du 'e.liz u e~.ba'ra.sa~w~ na 'fre~.Ti duz 'ow.trus
Como isso afeta seu amor por eles?	'ko~.mu 'i.su a'fE.ta 'sew a~'moX pur 'e.lis
Mack respondeu lenta e decididamente: Na verdade, não afeta.	'mE.ki Res.po~'dew 'le~.ta i de.si.Di.da~'me~.Ti, na veR'da.Di, 'na~w~ a'fE.ta
Ele sabia que estava sendo sincero, mesmo que algumas vezes Katie não acreditasse.	'e.li sa'bi.a ki es'ta.va 'se~.du si~'sE.ru, 'mez.mu ki aw'gu~.mas 've.zis 'kej.Ti 'na~w~ a.kre.Di'ta.si
Admito que isso me incomoda e algumas vezes fico sem graça ou com raiva, mas, mesmo quando eles agem mal, ainda são meus filhos e serão para sempre.	a.Di~'mi.tu ki 'i.su mi i~.ko~'mO.da i aw'gu~.mas 've.zis 'fi.ku se~j~ 'gra.sa ow ko~ 'Raj.va, majs, 'mez.mu 'kwa~.du 'e.liz 'a.Ze~j~ 'maw, a'i~.da 'sa~w~ 'mews 'fi.Luz i se'ra~w~ 'pa.ra 'se~.pri
O que fazem pode afetar meu orgulho, mas não meu amor.	u ki 'fa.ze~j~ 'pO.Di a.fe'taR 'mew oR'gu.Lu, majs 'na~w~ 'mew a~'moX
Ela se recostou, rindo de orelha a orelha.	'E.la si Re.kos'tow, 'Ri~.du Di o're.La a o're.La
Você é sábio em termos de amor verdadeiro, Mackenzie.	vo'se E 'sa.bju e~j~ 'teR.mus Di a~'moR veR.da'dej.ru, ma'ke~.zi
Muitos acreditam que é o amor que cresce, mas é o conhecimento que cresce, e o amor simplesmente se expande para contê-lo.	'mu~j~.tuz a.kre'Di.ta~w~ ki E u a~'moX ki 'krE.si, majz E u ko~.Je.si~'me~.tu ki 'krE.si, i u a~'moX si~.pliz'me~.Ti si es'pa~.Di 'pa.ra ko~'te lu
O amor é simplesmente a pele do conhecimento.	u a~'mor E si~.pliz'me~.Ti a 'pE.li du ko~.Je.si~'me~.tu
Mackenzie, você ama seus filhos que conhece tão bem com um amor maravilhoso e verdadeiro.	ma'ke~.zi, vo'se 'a~.ma 'sews 'fi.Lus ki ko~'JE.si 'ta~w~ 'be~j~ ko~ u~ a~'moR ma.ra.vi'Lo.zu i veR.da'dej.ru
Meio sem graça com o elogio, Mack baixou o olhar.	'mej.u se~j~ 'gra.sa ko~ u e.lo'Zi.u, 'mE.ki baj'Sow u o'LaX
Bem, obrigado, mas não sou assim com muitas outras pessoas.	'be~j~, o.bri'ga.du, majs 'na~w~ 'sow a'si~ ko~ 'mu~j~.taz 'ow.tras pe'so.as
Meu amor tende a ser bastante condicional na maior parte do tempo.	'mew a~'moX 'te~.Di a 'seR bas'ta~.Ti ko~.Di.si.o~'naw na maj'OX 'paX.Ti du 'te~.pu
Mas isso é um começo, não é, Mackenzie?	majz 'i.su E u~ ko~'me.su, 'na~w~ E, ma'ke~.zi
E você não ultrapassou sozinho a incapacidade de seu pai.	i vo'se 'na~w~ uw.tra.pa'sow sO'zi~.Ju a i~.ka.pa.si'da.Di Di 'sew 'paj
Foram Deus e você, juntos, que causaram essa mudança, para que você pudesse amar desse modo.	'fo.ra~w~ 'dewz i vo'se, 'Zu~.tus, ki kaw'za.ra~w~ 'E.sa mu'da~.sa, 'pa.ra ki vo'se pu'dE.si a~'maR 'de.si 'mO.du
E agora você ama seus filhos praticamente como o Pai ama os dele.	i a'gO.ra vo'se 'a~.ma 'sews 'fi.Lus pra.Ti.ka~'me~.Ti 'ko~.mu u 'paj 'a~.ma us 'de.li
Mack percebeu seu maxilar se apertando e sentiu de novo a raiva começar a crescer.	'mE.ki peX.se'bew 'sew mak.si'laX si a.peX'ta~.du i se~'Tiw Di 'no.vu a 'Raj.va ko~.me'sar a kre'seX
O que deveria ter sido um elogio tranquilizador parecia mais uma pílula amarga que agora ele se recusava a engolir.	u ki de.ve'ri.a 'teX 'si.du u~ e.lo'Zi.u tra~.kwi.li.za'doX pa.re'si.a 'majz u~.ma 'pi.lu.la a~'maR.ga ki a'gO.ra 'e.li si Re.ku'za.va a e~.go'liX
Tentou relaxar para encobrir as emoções, mas, pela expressão dela, soube que era inútil.	te~'tow Re.la'SaX 'pa.ra e~.ko'brir az e~.mo'so~j~s, majs, 'pe.la es.pre'sa~w~ 'dE.la, 'sow.bi ki 'E.ra i~'nu.Tiw
Dessa vez o olhar dela o deixou desconfortável.	'dE.sa 'vejz u o'LaR 'dE.la u dej'Sow des.ko~.foX'ta.vew
Mack sentiu-se exposto.	'mE.ki se~'Tiw si es'pos.tu
O silêncio que se seguiu à pergunta pairava no ar.	u si'le~.sju ki si se'giw a peR'gu~.ta paj'ra.va nu 'aX
Mack lutou para manter a compostura.	'mE.ki lu'tow 'pa.ra ma~'ter a ko~.pos'tu.ra
Podia ouvir o conselho de sua mãe ressoando nos ouvidos: Se não tiver nada de bom para dizer, não diga nada.	po'Di.a ow'vir u ko~'se.Lu Di 'su.a 'ma~j~ Re.so'a~.du nuz ow'vi.dus, si 'na~w~ Ti'vER 'na.da Di 'bo~ 'pa.ra Di'zeX, 'na~w~ 'Di.ga 'na.da
Mackenzie, instigou ela, este não é um momento para usar o bom senso da sua mãe.	ma'ke~.zi, i~s.Ti'gow 'E.la, 'es.Ti 'na~w~ E u~ mo~'me~.tu 'pa.ra u'zar u 'bo~ 'se~.su da 'su.a 'ma~j~
É um momento de honestidade, de verdade.	E u~ mo~'me~.tu Di o~.nes.Ti'da.Di, Di veR'da.Di
Você não acredita que o Pai ame bem seus filhos, não é?	vo'se 'na~w~ a.kre'Di.ta ki u 'paj 'a~.mi 'be~j~ 'sews 'fi.Lus, 'na~w~ E
Você não acredita realmente que Deus seja bom, não é?	vo'se 'na~w~ a.kre'Di.ta Re.aw'me~.Ti ki 'dews 'se.Za 'bo~, 'na~w~ E
Missy é filha dele? perguntou Mack rispidamente.	'mi.si E 'fi.La 'de.li, peR.gu~'tow 'mE.ki Ris.pi.da~'me~.Ti
Então, não! respondeu ele bruscamente, levantando-se.	e~'ta~w~, 'na~w~, Res.po~'dew 'e.li brus.ka~'me~.Ti, le.va~'ta~.du si
Não acredito que Deus ame todos os seus filhos muito bem!	'na~w~ a.kre'Di.tu ki 'dewz 'a~.mi 'to.duz us 'sews 'fi.Lus 'mu~j~.tu 'be~j~
Tinha dito, e agora a acusação ecoava nas paredes que poderiam existir na câmara.	'Ti~.Ja 'Di.tu, i a'gO.ra a a.ku.za'sa~w~ e.ko'a.va nas pa're.Dis ki po.de'ri.a~w~ e.zis'TiR na 'ka~.ma.ra
Enquanto Mack estava ali parado, com raiva e pronto para explodir, a mulher permaneceu calma e sem alterar a postura.	e~'kwa~.tu 'mE.ki es'ta.va a'li pa'ra.du, ko~ 'Raj.va i 'pro~.tu 'pa.ra es.plo'DiX, a mu'LEX peR.ma~.ne'sew 'kaw.ma i se~j~ aw.te'rar a pos'tu.ra
Lentamente, levantou-se da cadeira de encosto alto, passou em silêncio por trás dele e o chamou.	le~.ta~'me~.Ti, le.va~'tow si da ka'dej.ra Di e~'kos.tu 'aw.tu, pa'sow e~j~ si'le~.sju puX 'trajs 'de.li i u Sa~'mow
Por que não se senta aqui?	puX 'ke 'na~w~ si 'se~.ta a'ki
Ele encarou-a com sarcasmo, mas não se mexeu.	'e.li e~.ka'row a ko~ saX'kaz.mu, majs 'na~w~ si me'Sew
Mackenzie. Ela permaneceu de pé atrás da cadeira.	ma'ke~.zi, 'E.la peR.ma~.ne'sew Di 'pE a'trajs da ka'dej.ra
Antes comecei a dizer por que você está aqui hoje.	'a~.Tis ko~.me'sej a Di'zeX puX 'ke vo'se es'ta a'ki 'o.Zi
Não somente por causa dos seus filhos.	'na~w~ sO~'me~.Ti puX 'kaw.za dus 'sews 'fi.Lus
Está aqui para o julgamento.	es'ta a'ki 'pa.ra u Zuw.ga~'me~.tu
Enquanto a palavra ecoava na câmara, o pânico subiu por dentro de Mack como um maremoto e lentamente ele se deixou afundar na cadeira.	e~'kwa~.tu a pa'la.vra e.ko'a.va na 'ka~.ma.ra, u 'pa~.ni.ku su'biw puR 'de~.tru Di 'mE.ki 'ko~.mu u~ ma.re~'mO.tu i le~.ta~'me~.Ti 'e.li si dej'Sow a.fu~'daR na ka'dej.ra
Lembranças se derramavam da mente como ratos fugindo da enchente e no mesmo instante ele se sentiu culpado.	le~'bra~.sas si de.Ra~'ma.va~w~ da 'me~.Ti 'ko~.mu 'Ra.tus fu'Zi~.du da e~'Se~.Ti i nu 'mez.mu i~s'ta~.Ti 'e.li si se~'Tiw kuw'pa.du
Segurou os braços da cadeira, tentando encontrar algum equilíbrio, inundado por imagens e emoções.	se.gu'row us 'bra.sus da ka'dej.ra, te~'ta~.du e~.ko~'trar aw'gu~ e.ki'li.brju, i~.nu~'da.du pur i~'ma.Ze~z i e~.mo'so~j~s
Seus fracassos como ser humano subitamente se tornaram enormes e no fundo da mente quase pôde ouvir uma voz entoando uma lista crescente e apavorante de pecados.	'sews fra'ka.sus 'ko~.mu 'ser u~'ma~.nu su.bi.ta~'me~.Ti si toR'na.ra~w~ e~'nOR.miz i nu 'fu~.du da 'me~.Ti 'kwa.zi 'po.Di ow'vir u~.ma 'vOjz e~.to'a~.du u~.ma 'lis.ta kre'se~.Ti i a.pa.vo'ra~.Ti Di pe'ka.dus
Não tinha defesa.	'na~w~ 'Ti~.Ja de'fe.za
Sabia que estava perdido.	sa'bi.a ki es'ta.va peR'Di.du
Mackenzie? começou ela, mas ele a interrompeu.	ma'ke~.zi, ko~.me'sow 'E.la, majz 'e.li a i~.te.Ro~'pew
Agora entendo.	a'gO.ra e~'te~.du
Estou morto, não estou?	es'tow 'moX.tu, 'na~w~ es'tow
Por isso consigo ver Jesus e Papai, porque estou morto.	pur 'i.su ko~'si.gu 'veR Ze'zujz i pa'paj, puX'ke es'tow 'moX.tu
Ele se recostou e olhou para a escuridão, sentindo-se nauseado.	'e.li si Re.kos'tow i o'Low 'pa.ra a es.ku.ri'da~w~, se~'Ti~.du si naw.ze'a.du
Não acredito!	'na~w~ a.kre'Di.tu
Não senti nada.	'na~w~ se~'Ti 'na.da
Olhou para a mulher, que o observava com paciência.	o'Low 'pa.ra a mu'LEX, ki u ob.seR'va.va ko~ pa.si'e~.sja
Há quanto tempo estou morto?	'a 'kwa~.tu 'te~.pu es'tow 'moX.tu
Mackenzie, lamento desapontá-lo, mas você ainda não caiu no sono no seu mundo, e acredito que se engana...	ma'ke~.zi, la~'me~.tu de.za.po~'ta lu, majs vo'se a'i~.da 'na~w~ ka'iw nu 'so~.nu nu 'sew 'mu~.du, i a.kre'Di.tu ki si e~'ga~.na
De novo Mack a interrompeu: Não estou morto?	Di 'no.vu 'mE.ki a i~.te.Ro~'pew, 'na~w~ es'tow 'moX.tu
Incrédulo, levantou-se de novo.	i~'krE.du.lu, le.va~'tow si Di 'no.vu
Quer dizer que tudo isto é real e ainda estou vivo?	'kER Di'zeX ki 'tu.du 'is.tu E Re'aw i a'i~.da es'tow 'vi.vu
Mas você disse que eu tinha vindo aqui para ser julgado.	majs vo'se 'Di.si ki ew 'Ti~.Ja 'vi~.du a'ki 'pa.ra 'seR Zuw'ga.du
Disse, sim, declarou ela em tom casual, com uma expressão divertida. Mas Macken...	'Di.si, 'si~, de.kla'row 'E.la e~j~ 'to~ ka.zu'aw, ko~ u~.ma es.pre'sa~w~ Di.veX'Ti.da, majs ma'ke~
E nem estou morto?	i ne~j~ es'tow 'moX.tu
Pela terceira vez ele a interrompeu, com a raiva substituindo o pânico.	'pe.la teX'sej.ra 'vejz 'e.li a i~.te.Ro~'pew, ko~ a 'Raj.va subs.Ti.tu'i~.du u 'pa~.ni.ku
Não é justo!	'na~w~ E 'Zus.tu
Ele sabia que suas emoções não estavam ajudando.	'e.li sa'bi.a ki 'su.az e~.mo'so~j~s 'na~w~ es'ta.va~w~ a.Zu'da~.du
Isso acontece com outras pessoas?	'i.su a.ko~'tE.si ko~ 'ow.tras pe'so.as
Quero dizer, ser julgado antes mesmo de morrer?	'kE.ru Di'zeX, 'seR Zuw'ga.du 'a~.Tis 'mez.mu Di mo'ReX
E se eu mudar?	i si ew mu'daX
E se eu for melhor pelo resto da vida?	i si ew 'foR me'LOX 'pe.lu 'REs.tu da 'vi.da
E se me arrepender?	i si mi a.Re.pe~'deX
E aí?	i a'i
Há alguma coisa da qual você queira se arrepender, Mackenzie? perguntou ela, sem se abalar com a explosão.	'a aw'gu~.ma 'koj.za da 'kwaw vo'se 'kej.ra si a.Re.pe~'deX, ma'ke~.zi, peR.gu~'tow 'E.la, se~j~ si a.ba'laX ko~ a es.plo'za~w~
Mack sentou-se de novo, lentamente.	'mE.ki se~'tow si Di 'no.vu, le~.ta~'me~.Ti
Olhou a superfície lisa do chão e balançou a cabeça antes de responder.	o'Low a su.peX'fi.si 'li.za du 'Sa~w~ i ba.la~'sow a ka'be.sa 'a~.Tis Di Res.po~'deX
Eu não saberia por onde começar, murmurou.	ew 'na~w~ sa.be'ri.a pur 'o~.Di ko~.me'saX, muR.mu'row
Sou uma confusão, não é?	'sow u~.ma ko~.fu'za~w~, 'na~w~ E
É, sim.	E, 'si~
Mack levantou os olhos e ela sorriu.	'mE.ki le.va~'tow uz 'O.Luz i 'E.la so'Riw
Você é uma confusão gloriosa e destrutiva, Mackenzie, mas não está aqui para se arrepender, pelo menos não do modo como entende o arrependimento.	vo'se E u~.ma ko~.fu'za~w~ glo.ri'O.za i des.tru'Ti.va, ma'ke~.zi, majs 'na~w~ es'ta a'ki 'pa.ra si a.Re.pe~'deX, 'pe.lu 'me~.nus 'na~w~ du 'mO.du 'ko~.mu e~'te~.Di u a.Re.pe~.Di~'me~.tu
Mackenzie, você não está aqui para ser julgado.	ma'ke~.zi, vo'se 'na~w~ es'ta a'ki 'pa.ra 'seR Zuw'ga.du
Mas, interrompeu ele de novo. Achei que você disse que eu vim...	majs, i~.te.Ro~'pew 'e.li Di 'no.vu, a'Sej ki vo'se 'Di.si ki ew 'vi~
Disse. Mas você não está em julgamento.	'Di.si, majs vo'se 'na~w~ es'ta e~j~ Zuw.ga~'me~.tu
Mack respirou fundo, aliviado com as palavras.	'mE.ki Res.pi'row 'fu~.du, a.li.vi'a.du ko~ as pa'la.vras
Você será o juiz.	vo'se se'ra u Zu'is
O nó no estômago retornou quando ele percebeu o que ela dissera.	u 'nO nu es'to~.ma.gu Re.toR'now 'kwa~.du 'e.li peX.se'bew u ki 'E.la Di'sE.ra
Por fim baixou os olhos para a cadeira que o esperava.	puX 'fi~ baj'Sow uz 'O.Lus 'pa.ra a ka'dej.ra ki u es.pe'ra.va
O quê? Eu? Fez uma pausa.	u 'ke, ew, 'fejz u~.ma 'paw.za
Não tenho nenhuma capacidade de julgar.	'na~w~ 'te~.Ju ne~'Ju~.ma ka.pa.si'da.Di Di Zuw'gaX
Ah, não é verdade, foi a resposta rápida, agora tingida por um leve sarcasmo.	'a, 'na~w~ E veR'da.Di, 'foj a Res'pOs.ta 'Ra.pi.da, a'gO.ra Ti~'Zi.da pur u~ 'lE.vi saX'kaz.mu
Você já se mostrou bastante capaz, mesmo no pouco tempo que passamos juntos.	vo'se 'Za si mos'trow bas'ta~.Ti ka'pajs, 'mez.mu nu 'pow.ku 'te~.pu ki pa'sa~.mu.Zu~'tus
E, além disso, já julgou muitas pessoas durante a vida.	i, a'le~j~ 'Di.su, 'Za Zuw'gow 'mu~j~.tas pe'so.as du'ra~.Ti a 'vi.da
Julgou os atos e até mesmo as motivações dos outros, como se soubesse quais eram.	Zuw'gow uz 'a.tuz i a'tE 'mez.mu as mo.Ti.va'so~j~s duz 'ow.trus, 'ko~.mu si sow'bE.si 'kwajz 'E.ra~w~
Julgou a cor da pele, a linguagem corporal e o odor pessoal.	Zuw'gow a 'koR da 'pE.li, a li~'gwa.Ze~j~ koX.po'raw i u o'doX pe.so'aw
Julgou histórias e relacionamentos.	Zuw'gow is'tO.rjaz i Re.la.si.o~.na~'me~.tus
Até julgou o valor da vida de uma pessoa segundo seu conceito de beleza.	a'tE Zuw'gow u va'loR da 'vi.da Di u~.ma pe'so.a se'gu~.du 'sew ko~'sej.tu Di be'le.za
Em todos os sentidos, você é bastante treinado nessa atividade.	e~j~ 'to.duz us se~'Ti.dus, vo'se E bas'ta~.Ti trej~'na.du 'nE.sa a.Ti.vi'da.Di
Mack sentiu a vergonha avermelhando seu rosto.	'mE.ki se~'Tiw a veR'go~.Ja a.veR.me'La~.du 'sew 'Ros.tu
Tinha de admitir que já fizera um bocado de julgamentos.	'Ti~.Ja Di a.Di~.mi'TiX ki 'Za fi'zE.ra u~ bo'ka.du Di Zuw.ga~'me~.tus
Mas não era diferente de mais ninguém, era?	majs 'na~w~ 'E.ra Di.fe're~.Ti Di 'majs ni~'ge~j~, 'E.ra
Quem não julga impulsivamente as ações e intenções dos outros?	'ke~j~ 'na~w~ 'Zuw.ga i~.puw.si.va~'me~.Ti az a'so~j~z i i~.te~'so~j~s duz 'ow.trus
Ao levantar os olhos, viu-a espiando-o com atenção e rapidamente voltou a olhar para baixo.	aw le.va~'tar uz 'O.Lus, 'viw a es.pi'a~.du u ko~ a.te~'sa~w~ i Ra.pi.da~'me~.Ti vow'tow a o'LaX 'pa.ra 'baj.Su
Diga, pediu ela, se é que posso perguntar: qual é o critério pelo qual você baseia seus julgamentos?	'Di.ga, pe'Diw 'E.la, si E ki 'pO.su peR.gu~'taX, 'kwaw E u kri'tE.rju 'pe.lu 'kwaw vo'se ba'zej.a 'sew.Zuw.ga~'me~.tus
Mack tentou encará-la, mas descobriu que quando a olhava diretamente seu pensamento oscilava.	'mE.ki te~'tow e~.ka'ra la, majs des.ko'briw ki 'kwa~.du a o'La.va Di.rE.ta~'me~.Ti 'sew pe~.sa~'me~.tu o.si'la.va
Teve de desviar os olhos para a escuridão do canto a sala, esperando recuperar o controle.	'te.vi Di dez.vi'ar uz 'O.Lus 'pa.ra a es.ku.ri'da~w~ du 'ka~.tu a 'sa.la, es.pe'ra~.du Re.ku.pe'rar u ko~'tro.li
Nada que pareça fazer muito sentido neste momento, admitiu finalmente, com a voz embargada.	'na.da ki pa're.sa fa'zeR 'mu~j~.tu se~'Ti.du 'nes.Ti mo~'me~.tu, a.Di~.mi'Tiw fi~.naw'me~.Ti, ko~ a 'vOjz e~.baR'ga.da
Confesso que quando fiz aqueles julgamentos eu me sentia bastante justificado, mas agora...	ko~'fE.su ki 'kwa~.du 'fiz a'ke.li.Zuw.ga~'me~.tuz ew mi se~'Ti.a bas'ta~.Ti Zus.Ti.fi'ka.du, majz a'gO.ra
Claro que se sentia. Ela afirmou como uma declaração, como algo rotineiro, sem registrar sequer por um momento a evidente vergonha e perturbação dele.	'kla.ru ki si se~'Ti.a, 'E.la a.fiR'mow 'ko~.mu u~.ma de.kla.ra'sa~w~, 'ko~.mu 'aw.gu Ro.Ti~'nej.ru, se~j~ Re.Zis'traX se'kEX pur u~ mo~'me~.tu a e.vi'de~.Ti veR'go~.Ja i peX.tuR.ba'sa~w~ 'de.li
Julgar exige que você se considere superior a quem você julga.	Zuw'gar e'zi.Zi ki vo'se si ko~.si'dE.ri su.pe.ri'or a 'ke~j~ vo'se 'Zuw.ga
Venha, disse ela, dando um tapinha no encosto da cadeira.	've~.Ja, 'Di.si 'E.la, 'da~.du u~ ta'pi~.Ja nu e~'kos.tu da ka'dej.ra
Quero que se sente aqui.	'kE.ru ki si 'se~.Ti a'ki
Hesitando, ele foi obedientemente até ela e a cadeira que o esperava.	e.zi'ta~.du, 'e.li 'foj o.be.Di.e~.Ti~'me~.Ti a'tE 'E.la i a ka'dej.ra ki u es.pe'ra.va
A cada passo parecia ficar menor.	a 'ka.da 'pa.su pa.re'si.a fi'kaR me~'nOX
Subiu com dificuldade na cadeira e sentiu-se infantil, os pés mal tocando o chão.	su'biw ko~ Di.fi.kuw'da.Di na ka'dej.ra i se~'Tiw si i~.fa~'Tiw, us 'pEjs 'maw to'ka~.du u 'Sa~w~
E exatamente o que vou julgar? perguntou, virando-se para olhá-la.	i e.za.ta~'me~.Ti u ki 'vow Zuw'gaX, peR.gu~'tow, vi'ra~.du si 'pa.ra o'La la
Não o quê. Ela foi para o lado da mesa. Quem.	'na~w~ u 'ke, 'E.la 'foj 'pa.ra u 'la.du da 'me.za, 'ke~j~
O desconforto de Mack crescia aos saltos e sentar-se numa cadeira solene e grande demais não ajudava.	u des.ko~'foX.tu Di 'mE.ki kre'si.a aws 'saw.tuz i se~'taX si 'nu~.ma ka'dej.ra so'le~.ni i 'gra~.Di de~'majs 'na~w~ a.Zu'da.va
Que direito ele tinha de julgar alguém?	ki Di'rej.tu 'e.li 'Ti~.Ja Di Zuw'gar aw'ge~j~
Claro, de certa forma era culpado de julgar praticamente todo mundo que conhecera e muitos desconhecidos.	'kla.ru, Di 'sEX.ta 'fOR.ma 'E.ra kuw'pa.du Di Zuw'gaX pra.Ti.ka~'me~.Ti 'to.du 'mu~.du ki ko~.Je'se.ra i 'mu~j~.tus des.ko~.Je'si.dus
Mack sabia que era totalmente culpado de ser egocêntrico.	'mE.ki sa'bi.a ki 'E.ra to.taw'me~.Ti kuw'pa.du Di 'ser e.go'se~.tri.ku
Como é que ele ousava julgar alguém?	'ko~.mu E ki 'e.li ow'za.va Zuw'gar aw'ge~j~
Todos os seus julgamentos haviam sido superficiais, baseados na aparência e nos atos, motivados por preconceitos, estados de espírito ou por sua necessidade de sentir-se melhor ou superior.	'to.duz us 'sew.Zuw.ga~'me~.tuz a'vi.a~w~ 'si.du su.peX.fi.si'ajs, ba.ze'a.dus na a.pa're~.sja i nuz 'a.tus, mo.Ti'va.dus puX pre.ko~'sej.tus, es'ta.dus Di es'pi.ri.tu ow puX 'su.a ne.se.si'da.Di Di se~'TiX si me'LOr ow su.pe.ri'oX
Estava começando a entrar em pânico.	es'ta.va ko~.me'sa~.du a e~'trar e~j~ 'pa~.ni.ku
Sua imaginação, ela interrompeu seus pensamentos, não vai ajudá-lo muito neste momento.	'su.a i~.ma.Zi~.na'sa~w~, 'E.la i~.te.Ro~'pew 'sews pe~.sa~'me~.tus, 'na~w~ 'vaj a.Zu'da lu 'mu~j~.tu 'nes.Ti mo~'me~.tu
Não brinca, Sherlock! ele pensou ironicamente, mas tudo que saiu de sua boca foi: Não posso fazer isso.	'na~w~ 'bri~.ka, SeR'lO.ki, 'e.li pe~'sow i.ro~.ni.ka~'me~.Ti, majs 'tu.du ki sa'iw Di 'su.a 'bo.ka 'foj, 'na~w~ 'pO.su fa'zer 'i.su
Sua capacidade de fazer isso ou não ainda não foi determinada, disse ela com um sorriso.	'su.a ka.pa.si'da.Di Di fa'zer 'i.su ow 'na~w~ a'i~.da 'na~w~ 'foj de.teR.mi~'na.da, 'Di.si 'E.la ko~ u~ so'Ri.zu
E meu nome não é Sherlock.	i 'mew 'no~.mi 'na~w~ E SeR'lO.ki
Mack sentiu-se grato pela sala escura que escondia seu embaraço.	'mE.ki se~'Tiw si 'gra.tu 'pe.la 'sa.la es'ku.ra ki es.ko~'Di.a 'sew e~.ba'ra.su
O silêncio que se seguiu pareceu mantê-lo cativo por muito mais tempo do que os poucos segundos necessários para encontrar a voz e finalmente fazer a pergunta: Então quem devo julgar?	u si'le~.sju ki si se'giw pa.re'sew ma~'te lu ka'Ti.vu puR 'mu~j~.tu 'majs 'te~.pu du ki us 'pow.kus se'gu~.dus ne.se'sa.rjus 'pa.ra e~.ko~'trar a 'vOjz i fi~.naw'me~.Ti fa'zer a peR'gu~.ta, e~'ta~w~ 'ke~j~ 'de.vu Zuw'gaX
Deus, ela fez uma pausa, e a raça humana.	'dews, 'E.la 'fejz u~.ma 'paw.za, i a 'Ra.sa u~'ma~.na
Disse como se isso não tivesse importância especial.	'Di.si 'ko~.mu si 'i.su 'na~w~ Ti'vE.si i~.poX'ta~.sja es.pe.si'aw
As palavras simplesmente rolaram de sua língua, como se fosse um acontecimento cotidiano.	as pa'la.vras si~.pliz'me~.Ti Ro'la.ra~w~ Di 'su.a 'li~.gwa, 'ko~.mu si 'fo.si u~ a.ko~.te.si~'me~.tu ko.Ti.Di'a~.nu
Mack ficou aparvalhado.	'mE.ki fi'kow a.paR.va'La.du
Você só pode estar brincando! exclamou.	vo'se 'sO 'pO.Di es'taR bri~'ka~.du, es.kla~'mow
Por que não?	puX 'ke 'na~w~
Sem dúvida há muitas pessoas no seu mundo que você acha que merecem julgamento.	se~j~ 'du.vi.da 'a 'mu~j~.tas pe'so.as nu 'sew 'mu~.du ki vo'se 'a.Sa ki me'rE.se~j~ Zuw.ga~'me~.tu
Deve haver pelo menos algumas culpadas por boa parte da dor e do sofrimento, não é?	'dE.vi a'veX 'pe.lu 'me~.nuz aw'gu~.mas kuw'pa.das puR 'bo.a 'paX.Ti da 'dor i du so.fri~'me~.tu, 'na~w~ E
Que tal os gananciosos que exploram os pobres do mundo?	ki 'taw us ga~.na~.si'O.zus ki es'plO.ra~w~ us 'pO.bris du 'mu~.du
Que tal os que promovem as guerras?	ki 'taw us ki pro~'mO.ve~j~ as 'gE.Ras
Que tal os homens que agridem as mulheres, Mackenzie?	ki 'taw uz 'o~.me~s ki a'gri.de~j~ as mu'LE.ris, ma'ke~.zi
Que tal os pais que batem nos filhos sem qualquer motivo além de aplacar seu próprio sofrimento?	ki 'taw us 'pajs ki 'ba.te~j~ nus 'fi.Lus se~j~ kwaw'kER mo'Ti.vu a'le~j~ Di a.pla'kaX 'sew 'prO.prju so.fri~'me~.tu
Eles não merecem julgamento, Mackenzie?	'e.lis 'na~w~ me'rE.se~j~ Zuw.ga~'me~.tu, ma'ke~.zi
Mack percebia a profundidade de sua raiva não resolvida subir como um jorro de fúria.	'mE.ki peX.se'bi.a a pro.fu~.Di'da.Di Di 'su.a 'Raj.va 'na~w~ Re.zow'vi.da su'biX 'ko~.mu u~ 'Zo.Ru Di 'fu.rja
Afundou na cadeira tentando manter o equilíbrio abalado por um tiroteio de imagens, mas podia sentir o controle se esvaindo.	a.fu~'dow na ka'dej.ra te~'ta~.du ma~'ter u e.ki'li.brju a.ba'la.du pur u~ Ti.ro'tej.u Di i~'ma.Ze~s, majs po'Di.a se~'Tir u ko~'tro.li si ez.va'i~.du
Seu estômago deu um nó enquanto ele fechava os punhos, com a respiração curta e rápida.	'sew es'to~.ma.gu 'dew u~ 'nO e~'kwa~.tu 'e.li fe'Sa.va us 'pu~.Jus, ko~ a Res.pi.ra'sa~w~ 'kuX.ta i 'Ra.pi.da
E que tal o homem que é um predador de menininhas inocentes?	i ki 'taw u 'o~.me~j~ ki E u~ pre.da'doR Di me~.ni~'ni~.Jaz i~.no'se~.Tis
Que tal ele, Mackenzie?	ki 'taw 'e.li, ma'ke~.zi
Esse homem é culpado?	'e.si 'o~.me~j~ E kuw'pa.du
Ele deve ser julgado?	'e.li 'dE.vi 'seR Zuw'ga.du
Deve! gritou Mack. Deve ser mandado para o inferno!	'dE.vi, gri'tow 'mE.ki, 'dE.vi 'seR ma~'da.du 'pa.ra u i~'fER.nu
Ele é culpado da sua perda?	'e.li E kuw'pa.du da 'su.a 'peR.da
E o pai dele, o homem que deformou o filho até que ele se transformasse num terror?	i u 'paj 'de.li, u 'o~.me~j~ ki de.foR'mow u 'fi.Lu a'tE ki 'e.li si tra~s.foR'ma.si nu~ te'RoX
E ele?	i 'e.li
É, ele também!	E, 'e.li ta~'be~j~
Até onde devemos voltar, Mackenzie?	a'tE 'o~.Di de've~.mus vow'taX, ma'ke~.zi
Esse legado de deformação remonta até Adão.	'e.si le'ga.du Di de.foR.ma'sa~w~ Re~'mo~.ta a'tE a'da~w~
Mas por que pararmos aqui?	majs puX 'ke pa'raR.muz a'ki
E Deus?	i 'dews
Deus começou essa coisa toda.	'dews ko~.me'sow 'E.sa 'koj.za 'to.da
Deus deve ser culpado?	'dews 'dE.vi 'seX kuw'pa.du
Mack estava tonto.	'mE.ki es'ta.va 'to~.tu
Não se sentia de modo algum um juiz, e sim um réu sendo julgado.	'na~w~ si se~'Ti.a Di 'mO.du aw'gu~ u~ Zu'is, i 'si~ u~ 'REw 'se~.du Zuw'ga.du
A mulher não se aplacava.	a mu'LER 'na~w~ si a.pla'ka.va
Não é aí que você está travado, Mackenzie?	'na~w~ E a'i ki vo'se es'ta tra'va.du, ma'ke~.zi
Não é isso que alimenta a Grande Tristeza?	'na~w~ E 'i.su ki a.li~'me~.ta a 'gra~.Di tris'te.za
Sem dúvida, um pai como você pode julgar o Pai!	se~j~ 'du.vi.da, u~ 'paj 'ko~.mu vo'se 'pO.Di Zuw'gar u 'paj
De novo a raiva dele subiu como uma chama gigantesca.	Di 'no.vu a 'Raj.va 'de.li su'biw 'ko~.mu u~.ma 'Sa~.ma Zi.ga~'tes.ka
Queria golpear alguma coisa, mas ela estava certa e não havia sentido em negar.	ke'ri.a gow.pe'ar aw'gu~.ma 'koj.za, majz 'E.la es'ta.va 'sEX.ta i 'na~w~ a'vi.a se~'Ti.du e~j~ ne'gaX
A mulher prosseguiu: Sua reclamação não é justa, Mackenzie?	a mu'LEX pro.se'giw, 'su.a Re.kla~.ma'sa~w~ 'na~w~ E 'Zus.ta, ma'ke~.zi
O fato de Deus ter fracassado com você, ter fracassado com Missy?	u 'fa.tu Di 'dews 'teX fra.ka'sa.du ko~ vo'se, 'teX fra.ka'sa.du ko~ 'mi.si
O fato de, antes da Criação, Deus saber que um dia sua Missy seria brutalizada e mesmo assim a ter criado?	u 'fa.tu Di, 'a~.Tis da kri.a'sa~w~, 'dews sa'beX ki u~ 'Di.a 'su.a 'mi.si se'ri.a bru.ta.li'za.da i 'mez.mu a'si~ a 'teX kri'a.du
E depois permitir que aquela alma deturpada a arrancasse de seus braços amorosos quando ele tinha poder para impedir?	i de'pojs peR.mi'TiX ki a'kE.la 'aw.ma de.tuX'pa.da a a.Ra~'ka.si Di 'sews 'bra.suz a~.mo'rO.zus 'kwa~.du 'e.li 'Ti~.Ja po'deX 'pa.ra i~.pe'DiX
Deus não deve ser culpado, Mackenzie?	'dews 'na~w~ 'dE.vi 'seX kuw'pa.du, ma'ke~.zi
Mack olhava para o chão, com uma avalanche de imagens empurrando seus sentimentos em todas as direções.	'mE.ki o'La.va 'pa.ra u 'Sa~w~, ko~ u~.ma a.va'la~.Si Di i~'ma.Ze~z e~.pu'Ra~.du 'sews se~.Ti~'me~.tuz e~j~ 'to.daz as Di.re'so~j~s
Por fim falou, mais alto do que pretendia, e apontou o dedo diretamente para ela.	puX 'fi~ fa'low, 'majz 'aw.tu du ki pre.te~'Di.a, i a.po~'tow u 'de.du Di.rE.ta~'me~.Ti 'pa.ra 'E.la
Sim! A culpa é de Deus!	'si~, a 'kuw.pa E Di 'dews
A acusação pairou no ar enquanto o martelo de juiz batia em seu coração.	a a.ku.za'sa~w~ paj'row nu 'ar e~'kwa~.tu u maX'tE.lu Di Zu'iz ba'Ti.a e~j~ 'sew ko.ra'sa~w~
Então, disse ela em tom definitivo, se você pode julgar Deus com tanta facilidade, certamente pode julgar o mundo.	e~'ta~w~, 'Di.si 'E.la e~j~ 'to~ de.fi~.ni'Ti.vu, si vo'se 'pO.Di Zuw'gaR 'dews ko~ 'ta~.ta fa.si.li'da.Di, sEX.ta~'me~.Ti 'pO.Di Zuw'gar u 'mu~.du
Sua voz não expressava emoção.	'su.a 'vOjz 'na~w~ es.pre'sa.va e~.mo'sa~w~
Você deve escolher dois de seus filhos para passar à eternidade no novo Céu e na nova Terra de Deus, mas apenas dois.	vo'se 'dE.vi es.ko'LeR 'dojs Di 'sews 'fi.Lus 'pa.ra pa'sar a e.teR.ni'da.Di nu 'no.vu 'sEw i na 'nO.va 'tE.Ra Di 'dews, majz a'pe~.nas 'dojs
O quê? explodiu ele, incrédulo.	u 'ke, es.plo'Diw 'e.li, i~'krE.du.lu
E você deve escolher três filhos para passar a eternidade no inferno.	i vo'se 'dE.vi es.ko'LeX 'trejs 'fi.Lus 'pa.ra pa'sar a e.teR.ni'da.Di nu i~'fER.nu
Mack não podia acreditar no que estava ouvindo e começou a entrar em pânico.	'mE.ki 'na~w~ po'Di.a a.kre.Di'taR nu ki es'ta.va ow'vi~.du i ko~.me'sow a e~'trar e~j~ 'pa~.ni.ku
Mackenzie. Agora a voz dela veio tão calma e maravilhosa quanto na primeira vez em que ele a havia escutado.	ma'ke~.zi, a'gO.ra a 'vOjz 'dE.la 'vej.u 'ta~w~ 'kaw.ma i ma.ra.vi'LO.za 'kwa~.tu na pri~'mej.ra 'vejz e~j~ ki 'e.li a a'vi.a es.ku'ta.du
Só estou lhe pedindo para fazer uma coisa que você acredita que Deus faz.	'sO es'tow Li pe'Di~.du 'pa.ra fa'zer u~.ma 'koj.za ki vo'se a.kre'Di.ta ki 'dews 'fajs
Ele ama cada um segundo o que conhece do ser desse filho ou dessa filha.	'e.li 'a~.ma 'ka.da 'u~ se'gu~.du u ki ko~'JE.si du 'seR 'de.si 'fi.Lu ow 'dE.sa 'fi.La
Você acredita que ele irá condenar a maioria a uma eternidade de tormento, para longe de Sua presença e de Seu amor.	vo'se a.kre'Di.ta ki 'e.li i'ra ko~.de~'nar a maj.o'ri.a a u~.ma e.teR.ni'da.Di Di toR'me~.tu, 'pa.ra 'lo~.Zi Di 'su.a pre'ze~.sa i Di 'sew a~'moX
Não é verdade?	'na~w~ E veR'da.Di
Acho que sim. Simplesmente nunca pensei na coisa desse modo. Ele tropeçava nas palavras, chocado.	'a.Su ki 'si~, si~.pliz'me~.Ti 'nu~.ka pe~'sej na 'koj.za 'de.si 'mO.du, 'e.li tro.pe'sa.va nas pa'la.vras, So'ka.du
Simplesmente achei que, de algum modo, Deus poderia fazer isso.	si~.pliz'me~.Ti a'Sej ki, Di aw'gu~ 'mO.du, 'dews po.de'ri.a fa'zer 'i.su
Então você acha que Deus faz isso com facilidade, mas você não?	e~'ta~w~ vo'se 'a.Sa ki 'dews 'fajz 'i.su ko~ fa.si.li'da.Di, majs vo'se 'na~w~
Ande, Mackenzie.	'a~.Di, ma'ke~.zi
Quais de seus cinco filhos você condenará ao inferno?	'kwajs Di 'sews 'si~.ku 'fi.Lus vo'se ko~.de~.na'ra aw i~'fER.nu
Katie é a que está em maior conflito com você agora.	'kej.Ti E a ki es'ta e~j~ maj'OX ko~'fli.tu ko~ vo'se a'gO.ra
Ela o trata mal e lhe diz coisas dolorosas.	'E.la u 'tra.ta 'maw i Li 'Dis 'koj.zas do.lo'rO.zas
Talvez ela seja a primeira escolha, a mais lógica. Que tal ela?	taw'vejz 'E.la 'se.Za a pri~'mej.ra es'ko.La, a 'majs 'lO.Zi.ka, ki 'taw 'E.la
Você é o juiz, Mackenzie, e deve escolher.	vo'se E u Zu'is, ma'ke~.zi, i 'dE.vi es.ko'LeX
Não quero ser juiz, disse ele, levantando-se.	'na~w~ 'kE.ru 'seR Zu'is, 'Di.si 'e.li, le.va~'ta~.du si
A mente de Mack disparava.	a 'me~.Ti Di 'mE.ki Dis.pa'ra.va
Isso não podia ser real.	'i.su 'na~w~ po'Di.a 'se.Re'aw
Como Deus seria capaz de pedir que ele escolhesse entre os próprios filhos?	'ko~.mu 'dews se'ri.a ka'pajz Di pe'DiX ki 'e.li es.ko'Le.si 'e~.tri us 'prO.prjus 'fi.Lus
Era absolutamente impossível condenar Katie ou qualquer um dos outros a uma eternidade no inferno simplesmente porque ela havia pecado contra ele.	'E.ra ab.so.lu.ta~'me~.Ti i~.po'si.vew ko~.de~'naX 'kej.Ti ow kwaw'kEr 'u~ duz 'ow.truz a u~.ma e.teR.ni'da.Di nu i~'fER.nu si~.pliz'me~.Ti puX'ke 'E.la a'vi.a pe'ka.du 'ko~.tra 'e.li
Mesmo que Katie, Josh, Jon ou Tyler cometessem algum crime hediondo, ele não faria isso.	'mez.mu ki 'kej.Ti, 'ZOS, 'Zo~w~ ow 'taj.leX ko~.me'te.se~j~ aw'gu~ 'kri~.mi e.Di'o~.du, 'e.li 'na~w~ fa'ri.a 'i.su
Não podia!	'na~w~ po'Di.a
Para ele, isso não tinha relação com o desempenho dos filhos.	'pa.ra 'e.li, 'i.su 'na~w~ 'Ti~.Ja Re.la'sa~w~ ko~ u de.ze~'pe~.Ju dus 'fi.Lus
Tinha a ver com seu amor por eles.	'Ti~.Ja a 'veX ko~ 'sew a~'moX pur 'e.lis
Não posso fazer isso, disse baixinho.	'na~w~ 'pO.su fa'zer 'i.su, 'Di.si baj'Si~.Ju
Você deve.	vo'se 'dE.vi
Não posso fazer isso, disse mais alto e veemente.	'na~w~ 'pO.su fa'zer 'i.su, 'Di.si 'majz 'aw.tu i ve.e~'me~.Ti
Você deve, repetiu ela, com a voz mais suave.	vo'se 'dE.vi, Re.pe'Tiw 'E.la, ko~ a 'vOjz 'majs su'a.vi
Você deve, sussurrou ela.	vo'se 'dE.vi, su.su'Row 'E.la
Não posso. Não posso. Não vou! gritou ele, e agora as palavras e emoções saíram num jorro.	'na~w~ 'pO.su, 'na~w~ 'pO.su, 'na~w~ 'vow, gri'tow 'e.li, i a'gO.ra as pa'la.vraz i e~.mo'so~j~s sa'i.ra~w~ nu~ 'Zo.Ru
A mulher simplesmente ficou parada, esperando.	a mu'LEX si~.pliz'me~.Ti fi'kow pa'ra.da, es.pe'ra~.du
Por fim ele a encarou, implorando com os olhos.	puX 'fi~ 'e.li a e~.ka'row, i~.plo'ra~.du ko~ uz 'O.Lus
Eu não posso ir no lugar deles?	ew 'na~w~ 'pO.su 'iR nu lu'gaR 'de.lis
Eu poderia fazer isso? Caiu aos pés dela, chorando e implorando.	ew po.de'ri.a fa'zer 'i.su, ka'iw aws 'pEjs 'dE.la, So'ra~.du i i~.plo'ra~.du
Por favor, deixe-me ir no lugar dos meus filhos, por favor, eu ficaria feliz em...	puX fa'voX, 'dej.Si mi 'iR nu lu'gaR dus 'mews 'fi.Lus, puX fa'voX, ew fi.ka'ri.a fe'liz e~j~
Por favor, estou implorando.	puX fa'voX, es'tow i~.plo'ra~.du
Mackenzie, Mackenzie, sussurrou a mulher, e suas palavras vieram como um jato de água fria num dia de calor brutal.	ma'ke~.zi, ma'ke~.zi, su.su'Row a mu'LEX, i 'su.as pa'la.vras vi'E.ra~w~ 'ko~.mu u~ 'Za.tu Di 'a.gwa 'fri.a nu~ 'Di.a Di ka'loR bru'taw
Suas mãos tocaram gentilmente o rosto dele enquanto ela o punha de pé.	'su.as 'ma~w~s to'ka.ra~w~ Ze~.Tiw'me~.Ti u 'Ros.tu 'de.li e~'kwa~.tu 'E.la u 'pu~.Ja Di 'pE
Olhando-a através de lágrimas turvas, ele pôde ver que o sorriso da mulher era radiante.	o'La~.du a a.tra'vEjs Di 'la.gri~.mas 'tuR.vas, 'e.li 'po.Di 'veX ki u so'Ri.zu da mu'LEr 'E.ra Ra.Di'a~.Ti
Agora você está falando como Jesus.	a'gO.ra vo'se es'ta fa'la~.du 'ko~.mu Ze'zujs
Você julgou bem, Mackenzie.	vo'se Zuw'gow 'be~j~, ma'ke~.zi
Estou orgulhosa!	es'tow oR.gu'LO.za
Mas eu não julguei nada, disse Mack, confuso.	majz ew 'na~w~ Zuw'gej 'na.da, 'Di.si 'mE.ki, ko~'fu.zu
Ah, julgou sim.	'a, Zuw'gow 'si~
Você julgou que eles são merecedores de amor, mesmo que isso lhe custe tudo.	vo'se Zuw'gow ki 'e.lis 'sa~w~ me.re.se'do.ris Di a~'moX, 'mez.mu ki 'i.su Li 'kus.Ti 'tu.du
É assim que Jesus ama.	E a'si~ ki Ze'zujz 'a~.ma
Quando Mack ouviu as palavras, pensou em seu novo amigo esperando junto do lago.	'kwa~.du 'mE.ki ow'viw as pa'la.vras, pe~'sow e~j~ 'sew 'no.vu a~'mi.gu es.pe'ra~.du 'Zu~.tu du 'la.gu
E agora você conhece o coração de Papai, acrescentou ela, que ama todos os filhos com perfeição.	i a'gO.ra vo'se ko~'JE.si u ko.ra'sa~w~ Di pa'paj, a.kre.se~'tow 'E.la, ki 'a~.ma 'to.duz us 'fi.Lus ko~ peX.fej'sa~w~
No mesmo instante a imagem de Missy chamejou em sua mente e ele ficou tenso.	nu 'mez.mu i~s'ta~.Ti a i~'ma.Ze~j~ Di 'mi.si Sa~.me'Zow e~j~ 'su.a 'me~.Ti i 'e.li fi'kow 'te~.su
Sem pensar, sentou-se de novo na cadeira.	se~j~ pe~'saX, se~'tow si Di 'no.vu na ka'dej.ra
O que aconteceu, Mackenzie? perguntou ela.	u ki a.ko~.te'sew, ma'ke~.zi, peR.gu~'tow 'E.la
Ele viu que não adiantaria esconder.	'e.li 'viw ki 'na~w~ a.Di.a~.ta'ri.a es.ko~'deX
Entendo o amor de Jesus, mas Deus é outra história.	e~'te~.du u a~'moR Di Ze'zujs, majs 'dewz E 'ow.tra is'tO.rja
Não acho que os dois sejam iguais, de modo nenhum.	'na~w~ 'a.Su ki us 'dojs 'se.Za~w~ i'gwajs, Di 'mO.du ne~'Ju~
Você não gostou do tempo que passou com Papai? perguntou ela, surpresa.	vo'se 'na~w~ gos'tow du 'te~.pu ki pa'sow ko~ pa'paj, peR.gu~'tow 'E.la, suX'pre.za
Não, eu amo Papai, quem quer que ela seja.	'na~w~, ew 'a~.mu pa'paj, 'ke~j~ 'kEX ki 'E.la 'se.Za
Ela é incrível, mas não é nem um pouco como o Deus que eu conheço.	'E.la E i~'kri.vew, majs 'na~w~ E ne~j~ u~ 'pow.ku 'ko~.mu u 'dews ki ew ko~'Je.su
Talvez sua idéia de Deus esteja errada.	taw'vejs 'su.a i'dEj.a Di 'dewz es'te.Za e'Ra.da
Talvez. Simplesmente não vejo como Deus pudesse amar Missy com perfeição.	taw'vejs, si~.pliz'me~.Ti 'na~w~ 've.Zu 'ko~.mu 'dews pu'dE.si a~'maR 'mi.si ko~ peX.fej'sa~w~
Então o julgamento continua? disse ela com tristeza na voz.	e~'ta~w~ u Zuw.ga~'me~.tu ko~.Ti~'nu.a, 'Di.si 'E.la ko~ tris'te.za na 'vOjs
Isso fez Mack parar, mas apenas por um momento.	'i.su 'fejz 'mE.ki pa'raX, majz a'pe~.nas pur u~ mo~'me~.tu
O que eu deveria pensar?	u ki ew de.ve'ri.a pe~'saX
Simplesmente não entendo como Deus poderia amar Missy e deixar que ela passasse por aquele horror.	si~.pliz'me~.Ti 'na~w~ e~'te~.du 'ko~.mu 'dews po.de'ri.a a~'maR 'mi.si i dej'SaX ki 'E.la pa'sa.si pur a'ke.li o'RoX
Era uma menininha inocente.	'E.ra u~.ma me~.ni~'ni~.Ja i~.no'se~.Ti
Não fez nada para merecer aquilo.	'na~w~ 'fejz 'na.da 'pa.ra me.re'ser a'ki.lu
Mack prosseguiu: Deus usou-a para me castigar pelo que eu fiz com o meu pai?	'mE.ki pro.se'giw, 'dewz u'zow a 'pa.ra mi kas.Ti'gaX 'pe.lu ki ew 'fis ko~ u 'mew 'paj
Isso não é justo.	'i.su 'na~w~ E 'Zus.tu
Ela não merecia.	'E.la 'na~w~ me.re'si.a
Nan não merecia.	'na~ 'na~w~ me.re'si.a
Lágrimas escorreram pelo rosto dele.	'la.gri~.maz es.ko'Re.ra~w~ 'pe.lu 'Ros.tu 'de.li
Eu poderia merecer, mas elas, não.	ew po.de'ri.a me.re'seX, majz 'E.las, 'na~w~
É esse o seu Deus, Mackenzie?	E 'e.si u 'sew 'dews, ma'ke~.zi
Não é de espantar que você esteja afogado na tristeza.	'na~w~ E Di es.pa~'taX ki vo'se es'te.Za a.fo'ga.du na tris'te.za
Papai não é assim, Mackenzie.	pa'paj 'na~w~ E a'si~, ma'ke~.zi
Ele não está castigando você, nem Missy, nem Nan.	'e.li 'na~w~ es'ta kas.Ti'ga~.du vo'se, ne~j~ 'mi.si, ne~j~ 'na~
Isso não foi feito por ele.	'i.su 'na~w~ 'foj 'fej.tu pur 'e.li
Mas ele não impediu.	majz 'e.li 'na~w~ i~.pe'Diw
Não, não impediu.	'na~w~, 'na~w~ i~.pe'Diw
Ele não impede um monte de coisas que lhe causam dor.	'e.li 'na~w~ i~'pE.Di u~ 'mo~.Ti Di 'koj.zas ki Li 'kaw.za~w~ 'doX
O mundo de vocês está seriamente deturpado.	u 'mu~.du Di vo'sejz es'ta sE.ri.a~'me~.Ti de.tuX'pa.du
Vocês exigiram a independência e agora têm raiva daquele que os amou o bastante para lhes dar o mundo.	vo'sejz e.zi'Zi.ra~w~ a i~.de.pe~'de~.sja i a'gO.ra 'te~j~ 'Raj.va da'ke.li ki uz a~'mow u bas'ta~.Ti 'pa.ra Lis 'dar u 'mu~.du
Nada é como deveria ser, como Papai deseja que seja e como será um dia.	'na.da E 'ko~.mu de.ve'ri.a 'seX, 'ko~.mu pa'paj de'ze.Za ki 'se.Za i 'ko~.mu se'ra u~ 'Di.a
Neste momento seu mundo está perdido na escuridão e no caos, e coisas horríveis acontecem com aqueles de quem ele gosta especialmente.	'nes.Ti mo~'me~.tu 'sew 'mu~.du es'ta peR'Di.du na es.ku.ri'da~w~ i nu 'kaws, i 'koj.zaz o'Ri.vejz a.ko~'tE.se~j~ ko~ a'ke.lis Di 'ke~j~ 'e.li 'gOs.ta es.pe.si.aw'me~.Ti
Então por que ele não faz algo a respeito?	e~'ta~w~ puX 'ke 'e.li 'na~w~ 'fajz 'aw.gu a Res'pej.tu
Ele já fez...	'e.li 'Za 'fejs
Quer dizer, o que Jesus fez?	'kER Di'zeX, u ki Ze'zujs 'fejs
Você não viu os ferimentos em Papai também?	vo'se 'na~w~ 'viw us fe.ri~'me~.tuz e~j~ pa'paj ta~'be~j~
Não entendi os ferimentos.	'na~w~ e~.te~'Di us fe.ri~'me~.tus
Como ele pôde...	'ko~.mu 'e.li 'po.Di
Por amor. Ele escolheu o caminho da cruz, onde a misericórdia triunfa sobre a justiça por causa do amor.	pur a~'moX, 'e.li es.ko'Lew u ka~'mi~.Ju da 'krujs, 'o~.Di a mi.ze.ri'kOR.Dja tri'u~.fa 'so.bri a Zus'Ti.sa puX 'kaw.za du a~'moX
Você preferiria que ele tivesse escolhido a justiça para todo mundo?	vo'se pre.fe.ri'ri.a ki 'e.li Ti'vE.si es.ko'Li.du a Zus'Ti.sa 'pa.ra 'to.du 'mu~.du
Você quer justiça, Meritíssimo Juiz? Ela sorriu ao dizer isso.	vo'se 'kER Zus'Ti.sa, me.ri'Ti.si~.mu Zu'is, 'E.la so'Riw aw Di'zer 'i.su
Não, não quero, ele respondeu, baixando a cabeça.	'na~w~, 'na~w~ 'kE.ru, 'e.li Res.po~'dew, baj'Sa~.du a ka'be.sa
Não para mim e não para meus filhos.	'na~w~ 'pa.ra 'mi~ i 'na~w~ 'pa.ra 'mews 'fi.Lus
Ela esperou.	'E.la es.pe'row
Mas ainda não entendo por que Missy teve de morrer.	majz a'i~.da 'na~w~ e~'te~.du puX 'ke 'mi.si 'te.vi Di mo'ReX
Ela não teve, Mackenzie.	'E.la 'na~w~ 'te.vi, ma'ke~.zi
Isso não foi nenhum plano de Papai.	'i.su 'na~w~ 'foj ne~'Ju~ 'pla~.nu Di pa'paj
Papai nunca precisou do mal para realizar seus bons propósitos.	pa'paj 'nu~.ka pre.si'zow du 'maw 'pa.ra Re.a.li'zaX 'sews 'bo~s pro'pO.zi.tus
Foram vocês, humanos, que abraçaram o mal, e Papai respondeu com bondade.	'fo.ra~w~ vo'sejs, u~'ma~.nus, ki a.bra'sa.ra~w~ u 'maw, i pa'paj Res.po~'dew ko~ bo~'da.Di
O que aconteceu com Missy foi trabalho do mal e ninguém no seu mundo está imune a ele.	u ki a.ko~.te'sew ko~ 'mi.si 'foj tra'ba.Lu du 'maw i ni~'ge~j~ nu 'sew 'mu~.du es'ta i~'mu~.ni a 'e.li
Mas dói demais.	majs 'dOj de~'majs
Deve haver um modo melhor.	'dE.vi a'ver u~ 'mO.du me'LOX
Há. Você simplesmente não consegue ver agora.	'a, vo'se si~.pliz'me~.Ti 'na~w~ ko~'sE.gi ver.a.gO.ra
Retorne de sua independência, Mackenzie.	Re'tOR.ni Di 'su.a i~.de.pe~'de~.sja, ma'ke~.zi
Desista de ser juiz de Papai e conheça-o como ele é.	de'zis.ta Di 'seR Zu'iz Di pa'paj i ko~'Je.sa u 'ko~.mu 'e.li E
Então, no meio de sua dor, você poderá abraçar o amor dele, em vez de castigá-lo com sua percepção egocêntrica de como você acha que o universo deveria ser.	e~'ta~w~, nu 'mej.u Di 'su.a 'doX, vo'se po.de'ra a.bra'sar u a~'moR 'de.li, e~j~ 'vejz Di kas.Ti'ga lu ko~ 'su.a peX.sep'sa~w~ e.go'se~.tri.ka Di 'ko~.mu vo'se 'a.Sa ki u u~.ni'vEX.su de.ve'ri.a 'seX
Papai se arrastou para dentro de seu mundo para estar com vocês, para estar com Missy.	pa'paj si a.Ras'tow 'pa.ra 'de~.tru Di 'sew 'mu~.du 'pa.ra es'taX ko~ vo'sejs, 'pa.ra es'taX ko~ 'mi.si
Mack se levantou da cadeira.	'mE.ki si le.va~'tow da ka'dej.ra
Não quero mais ser juiz.	'na~w~ 'kE.ru 'majs 'seR Zu'is
Realmente quero confiar em Papai.	Re.aw'me~.Ti 'kE.ru ko~.fi'ar e~j~ pa'paj
Sem que Mack notasse, a sala se iluminou de novo enquanto ele se movia ao redor da mesa em direção à cadeira simples onde tudo havia começado.	se~j~ ki 'mE.ki no'ta.si, a 'sa.la si i.lu~.mi~'now Di 'no.vu e~'kwa~.tu 'e.li si mo'vi.a aw Re'dOR da 'me.za e~j~ Di.re'sa~w~ a ka'dej.ra 'si~.pliz 'o~.Di 'tu.du a'vi.a ko~.me'sa.du
Mas vou precisar de ajuda.	majs 'vow pre.si'zaR Di a'Zu.da
Ela aproximou-se dele e o abraçou.	'E.la a.pro.si~'mow si 'de.li i u a.bra'sow
Agora isso parece o início da viagem para casa, Mackenzie.	a'gO.ra 'i.su pa'rE.si u i~'ni.sju da vi'a.Ze~j~ 'pa.ra 'ka.za, ma'ke~.zi
Parece mesmo.	pa'rE.si 'mez.mu
O silêncio da caverna foi subitamente rompido pelo som de risos de crianças.	u si'le~.sju da ka'vER.na 'foj su.bi.ta~'me~.Ti Ro~'pi.du 'pe.lu 'so~ Di 'Ri.zus Di kri'a~.sas
Parecia vir de uma das paredes que agora Mack podia ver claramente à medida que a sala continuava a clarear.	pa.re'si.a 'viR Di u~.ma das pa're.Dis ki a'gO.ra 'mE.ki po'Di.a 'veX kla.ra~'me~.Ti a me'Di.da ki a 'sa.la ko~.Ti~.nu'a.va a kla.re'aX
Enquanto olhava naquela direção, a superfície da pedra foi ficando cada vez mais translúcida e a luz do dia penetrou na caverna.	e~'kwa~.tu o'La.va na'kE.la Di.re'sa~w~, a su.peX'fi.si da 'pE.dra 'foj fi'ka~.du 'ka.da 'vejz 'majs tra~z'lu.si.da i a 'lujz du 'Di.a pe~.ne'trow na ka'vER.na
Espantado, Mack olhou pela névoa e finalmente conseguiu vislumbrar as formas vagas de crianças brincando à distância.	es.pa~'ta.du, 'mE.ki o'Low 'pe.la 'nE.vo.a i fi~.naw'me~.Ti ko~.se'giw viz.lu~'brar as 'fOR.mas 'va.gas Di kri'a~.sas bri~'ka~.du a Dis'ta~.sja
O som parece ser dos meus filhos! exclamou perplexo.	u 'so~ pa'rE.si 'seR dus 'mews 'fi.Lus, es.kla~'mow peX'plEk.su
Enquanto ia em direção à parede, a névoa se dividiu, como se alguém tivesse aberto uma cortina, e ele estava inesperadamente olhando para uma campina, na direção do lago.	e~'kwa~.tu 'i.a e~j~ Di.re'sa~w~ a pa're.Di, a 'nE.vo.a si Di.vi'Diw, 'ko~.mu si aw'ge~j~ Ti'vE.si a'bEX.tu u~.ma koX'Ti~.na, i 'e.li es'ta.va i~.nes.pe.ra.da~'me~.Ti o'La~.du 'pa.ra u~.ma ka~'pi~.na, na Di.re'sa~w~ du 'la.gu
Na sua frente estava o pano de fundo das montanhas nevadas, perfeitas em sua majestade, vestidas com florestas densas.	na 'su.a 'fre~.Ti es'ta.va u 'pa~.nu Di 'fu~.du das mo~'ta~.Jas ne'va.das, peX'fej.taz e~j~ 'su.a ma.Zes'ta.Di, ves'Ti.das ko~ flo'rEs.tas 'de~.sas
E, aninhada ao pé, a cabana onde ele sabia que Papai e Sarayu estariam à sua espera.	i, a~.ni~'Ja.da aw 'pE, a ka'ba~.na 'o~.Di 'e.li sa'bi.a ki pa'paj i sa.ra'ju es.ta'ri.a~w~ a 'su.a es'pE.ra
Um riacho largo surgia bem à sua frente e desaguava no lago junto de campos de flores.	u~ Ri'a.Su 'laR.gu suR'Zi.a 'be~j~ a 'su.a 'fre~.Ti i de.za'gwa.va nu 'la.gu 'Zu~.tu Di 'ka~.pus Di 'flo.ris
Os sons de pássaros estavam em toda parte e o perfume doce do verão pairava intenso no ar.	us 'so~s Di 'pa.sa.ruz es'ta.va~w~ e~j~ 'to.da 'paX.Ti i u peX'fu~.mi 'do.si du ve'ra~w~ paj'ra.va i~'te~.su nu 'aX
Tudo isso Mack viu, ouviu e cheirou num instante, mas então seu olhar foi atraído para o grupo brincando perto do lugar onde o rio desaguava no lago, a menos de 50 metros dali.	'tu.du 'i.su 'mE.ki 'viw, ow'viw i Sej'row nu~ i~s'ta~.Ti, majz e~'ta~w~ 'sew o'LaX 'foj a.tra'i.du 'pa.ra u 'gru.pu bri~'ka~.du 'pEX.tu du lu'gar 'o~.Di u 'Ri.u de.za'gwa.va nu 'la.gu, a 'me~.nus Di si~'kwe~.ta 'mE.trus da'li
Viu seus filhos: Jon, Tyler, Josh e Kate.	'viw 'sews 'fi.Lus, 'Zo~w~, 'taj.leX, 'ZOS i 'kej.Ti
Mas espere!	majz es'pE.ri
Havia mais alguém!	a'vi.a 'majz aw'ge~j~
Ofegante, tentou focalizar melhor.	o.fe'ga~.Ti, te~'tow fo.ka.li'zaR me'LOX
Moveu-se na direção deles, mas foi pressionado contra uma força que não via, como se a parede de pedra ainda estivesse ali à sua frente, invisível.	mo'vew si na Di.re'sa~w~ 'de.lis, majs 'foj pre.si.o~'na.du 'ko~.tra u~.ma 'foX.sa ki 'na~w~ 'vi.a, 'ko~.mu si a pa're.Di Di 'pE.dra a'i~.da es.Ti'vE.si a'li a 'su.a 'fre~.Ti, i~.vi'zi.vew
Então ficou claro.	e~'ta~w~ fi'kow 'kla.ru
Lá estava ela, chutando a água com os pés descalços.	'la es'ta.va 'E.la, Su'ta~.du a 'a.gwa ko~ us 'pEjs des'kaw.sus
Como se tivesse escutado, Missy se separou do grupo e veio correndo pela trilha que terminava diretamente diante dele.	'ko~.mu si Ti'vE.si es.ku'ta.du, 'mi.si si se.pa'row du 'gru.pu i 'vej.u ko'Re~.du 'pe.la 'tri.La ki teR.mi~'na.va Di.rE.ta~'me~.Ti Di'a~.Ti 'de.li
Ah, meu Deus! Missy! gritou Mack e tentou avançar através do véu que os separava.	'a, 'mew 'dews, 'mi.si, gri'tow 'mE.ki i te~'tow a.va~'sar a.tra'vEjs du 'vEw ki us se.pa'ra.va
Para sua consternação, bateu contra a força que não lhe permitia chegar mais perto, como se algum magnetismo aumentasse em oposição ao seu esforço, mandando-o de volta para a sala.	'pa.ra 'su.a ko~s.teR.na'sa~w~, ba'tew 'ko~.tra a 'foX.sa ki 'na~w~ Li peR.mi'Ti.a Se'gaR 'majs 'pEX.tu, 'ko~.mu si aw'gu~ ma.gi~.ne'Tiz.mu aw~.me~'ta.si e~j~ o.po.zi'sa~w~ aw 'sew es'foX.su, ma~'da~.du u Di 'vOw.ta 'pa.ra a 'sa.la
Ela não pode ouvi-lo.	'E.la 'na~w~ 'pO.Di ow'vi lu
Mack não se importava.	'mE.ki 'na~w~ si i~.poX'ta.va
Missy! gritou.	'mi.si, gri'tow
Ela estava tão perto!	'E.la es'ta.va 'ta~w~ 'pEX.tu
A lembrança que estivera se esforçando tanto para não perder, mas que sentia lentamente se esvair agora, saltou de volta.	a le~'bra~.sa ki es.Ti'vE.ra si es.foX'sa~.du 'ta~.tu 'pa.ra 'na~w~ peR'deX, majs ki se~'Ti.a le~.ta~'me~.Ti si ez.va'ir a'gO.ra, saw'tow Di 'vOw.ta
Procurou algum tipo de maçaneta, como se pudesse abrir alguma coisa e encontrar um modo de chegar à filha.	pro.ku'row aw'gu~ 'Ti.pu Di ma.sa~'ne.ta, 'ko~.mu si pu'dE.si a'brir aw'gu~.ma 'koj.za i e~.ko~'trar u~ 'mO.du Di Se'gar a 'fi.La
Mas não havia nada.	majs 'na~w~ a'vi.a 'na.da
Enquanto isso, Missy havia chegado e estava parada bem diante dele.	e~'kwa~.tu 'i.su, 'mi.si a'vi.a Se'ga.du i es'ta.va pa'ra.da 'be~j~ Di'a~.Ti 'de.li
O olhar dela se fixava em algo no meio, maior e obviamente visível para ela, mas não para ele.	u o'LaR 'dE.la si fik'sa.va e~j~ 'aw.gu nu 'mej.u, maj'Or i Ob.vi.a~'me~.Ti vi'zi.vew 'pa.ra 'E.la, majs 'na~w~ 'pa.ra 'e.li
Finalmente Mack parou de lutar contra o campo de força e virou-se para a mulher.	fi~.naw'me~.Ti 'mE.ki pa'row Di lu'taX 'ko~.tra u 'ka~.pu Di 'foX.sa i vi'row si 'pa.ra a mu'LEX
Ela pode me ver?	'E.la 'pO.Di mi 'veX
Ela sabe que estou aqui? perguntou desesperado.	'E.la 'sa.bi ki es'tow a'ki, peR.gu~'tow de.zes.pe'ra.du
Ela sabe que você está aqui, mas não pode vê-lo.	'E.la 'sa.bi ki vo'se es'ta a'ki, majs 'na~w~ 'pO.Di 've lu
Do lado onde se encontra, Missy está olhando para a linda cachoeira e nada mais.	du 'la.du 'o~.Di si e~'ko~.tra, 'mi.si es'ta o'La~.du 'pa.ra a 'li~.da ka.So'ej.ra i 'na.da 'majs
Porém sabe que você está atrás dela.	po're~j~ 'sa.bi ki vo'se es'ta a'trajs 'dE.la
Cachoeiras! exclamou Mack, rindo sozinho. Ela adora cachoeiras!	ka.So'ej.ras, es.kla~'mow 'mE.ki, 'Ri~.du sO'zi~.Ju, 'E.la a'dO.ra ka.So'ej.ras
Agora Mack se concentrou na filha, tentando memorizar de novo cada detalhe de sua expressão, do cabelo e das mãos.	a'gO.ra 'mE.ki si ko~.se~'trow na 'fi.La, te~'ta~.du me~.mo.ri'zaR Di 'no.vu 'ka.da de'ta.Li Di 'su.a es.pre'sa~w~, du ka'be.lu i das 'ma~w~s
Enquanto ele fazia isso, o rosto de Missy se abriu num sorriso enorme, com as covinhas se destacando.	e~'kwa~.tu 'e.li fa'zi.a 'i.su, u 'Ros.tu Di 'mi.si si a'briw nu~ so'Ri.zu e~'nOR.mi, ko~ as ko'vi~.Jas si des.ta'ka~.du
Era demais e Mack chorou de alegria.	'E.ra de~'majz i 'mE.ki So'row Di a.le'gri.a
Mesmo assim não conseguia parar de olhá-la, observando-a através de sua cachoeira de lágrimas.	'mez.mu a'si~ 'na~w~ ko~.se'gi.a pa'raR Di o'La la, ob.seR'va~.du a a.tra'vEjs Di 'su.a ka.So'ej.ra Di 'la.gri~.mas
Estar tão perto assim era doloroso, vê-la ali, com aquele jeito tão característico de Missy.	es'taX 'ta~w~ 'pEX.tu a'si~ 'E.ra do.lo'ro.zu, 've la a'li, ko~ a'ke.li 'Zej.tu 'ta~w~ ka.rak.te'ris.Ti.ku Di 'mi.si
Ela está realmente bem, não está?	'E.la es'ta Re.aw'me~.Ti 'be~j~, 'na~w~ es'ta
Mais do que você imagina.	'majs du ki vo'se i~.ma'Zi~.na
Esta vida é apenas a ante-sala para uma realidade maior que virá.	'Es.ta 'vi.da E a'pe~.naz a 'a~.Ti 'sa.la 'pa.ra u~.ma Re.a.li'da.Di maj'OX ki vi'ra
Ninguém realiza plenamente seu próprio potencial no seu mundo.	ni~'ge~j~ Re.a'li.za ple~.na~'me~.Ti 'sew 'prO.prju po.te~.si'aw nu 'sew 'mu~.du
É apenas um preparativo que Papai tinha em mente o tempo todo.	E a'pe~.naz u~ pre.pa.ra'Ti.vu ki pa'paj 'Ti~.Ja e~j~ 'me~.Ti u 'te~.pu 'to.du
Posso ir até ela?	'pO.su 'ir a'tE 'E.la
Não. É assim que ela queria.	'na~w~, E a'si~ ki 'E.la ke'ri.a
Ela queria assim? Mack ficou confuso.	'E.la ke'ri.a a'si~, 'mE.ki fi'kow ko~'fu.zu
É. A nossa Missy é uma criança muito sábia.	E, a 'nO.sa 'mi.si E u~.ma kri'a~.sa 'mu~j~.tu 'sa.bja
Gosto especialmente dela.	'gOs.tu es.pe.si.aw'me~.Ti 'dE.la
Tem certeza de que ela sabe que estou aqui?	te~j~ seX'te.za Di ki 'E.la 'sa.bi ki es'tow a'ki
Sim, tenho certeza, garantiu a mulher.	'si~, 'te~.Ju seX'te.za, ga.ra~'Tiw a mu'LEX
Ela estava muito empolgada esperando este dia para brincar com os irmãos e a irmã e estar perto de você.	'E.la es'ta.va 'mu~j~.tu e~.pow'ga.da es.pe'ra~.du 'es.Ti 'Di.a 'pa.ra bri~'kaX ko~ uz iR'ma~w~z i a iR'ma~ i es'taX 'pEX.tu Di vo'se
Ela gostaria que a mãe também estivesse aqui, mas isso terá de esperar outra ocasião.	'E.la gos.ta'ri.a ki a 'ma~j~ ta~'be~j~ es.Ti'vE.si a'ki, majz 'i.su te'ra Di es.pe'rar 'ow.tra o.ka.zi'a~w~
Mack se virou para a mulher.	'mE.ki si vi'row 'pa.ra a mu'LEX
Meus outros filhos estão realmente aqui?	'mewz 'ow.trus 'fi.Luz es'ta~w~ Re.aw'me~.Ti a'ki
Estão e não estão.	es'ta~w~ i 'na~w~ es'ta~w~
Só Missy está realmente aqui.	'sO 'mi.si es'ta Re.aw'me~.Ti a'ki
Os outros estão sonhando e cada um terá uma vaga lembrança, alguns com mais detalhes do que outros.	uz 'ow.truz es'ta~w~ so~'Ja~.du i 'ka.da 'u~ te'ra u~.ma 'va.ga le~'bra~.sa, aw'gu~s ko~ 'majs de'ta.Lis du ki 'ow.trus
Este é um momento muito pacífico de sono para cada um, menos para Kate.	'es.Ti E u~ mo~'me~.tu 'mu~j~.tu pa'si.fi.ku Di 'so~.nu 'pa.ra 'ka.da 'u~, 'me~.nus 'pa.ra 'kej.Ti
Este sonho não será fácil para ela.	'es.Ti 'so~.Ju 'na~w~ se'ra 'fa.siw 'pa.ra 'E.la
Mas Missy está totalmente acordada.	majs 'mi.si es'ta to.taw'me~.Ti a.koR'da.da
Mack ficou olhando cada movimento feito por sua preciosa Missy.	'mE.ki fi'kow o'La~.du 'ka.da mo.vi~'me~.tu 'fej.tu puX 'su.a pre.si'O.za 'mi.si
Ela me perdoou? perguntou.	'E.la mi peR.do'ow, peR.gu~'tow
Perdoou o quê?	peR.do'ow u 'ke
Eu falhei com ela, sussurrou ele.	ew fa'Lej ko~ 'E.la, su.su'Row 'e.li
Mas eu não impedi que ele a levasse.	majz ew 'na~w~ i~.pe'Di ki 'e.li a le'va.si
Se você se lembra, você estava salvando seu filho.	si vo'se si 'le~.bra, vo'se es'ta.va saw'va~.du 'sew 'fi.Lu
Só você, em todo o universo, acredita que tem alguma culpa.	'sO vo'se, e~j~ 'to.du u u~.ni'vEX.su, a.kre'Di.ta ki te~j~ aw'gu~.ma 'kuw.pa
Missy não acredita nisso, nem Nan, nem Papai.	'mi.si 'na~w~ a.kre'Di.ta 'ni.su, ne~j~ 'na~, ne~j~ pa'paj
Talvez seja hora de abandonar essa mentira.	taw'vejs 'se.Za 'O.ra Di a.ba~.do~'nar 'E.sa me~'Ti.ra
E, Mackenzie, mesmo que você fosse culpado, o amor dela é muito mais forte do que a sua falha jamais poderia ser.	i, ma'ke~.zi, 'mez.mu ki vo'se 'fo.si kuw'pa.du, u a~'moR 'dE.la E 'mu~j~.tu 'majs 'fOX.Ti du ki a 'su.a 'fa.La Za~'majs po.de'ri.a 'seX
Nesse momento alguém chamou o nome de Missy e Mack reconheceu a voz.	'ne.si mo~'me~.tu aw'ge~j~ Sa~'mow u 'no~.mi Di 'mi.si i 'mE.ki Re.ko~.Je'sew a 'vOjs
A menina gritou de prazer e começou a correr em direção aos outros.	a me~'ni~.na gri'tow Di pra'zer i ko~.me'sow a ko'Rer e~j~ Di.re'sa~w~ awz 'ow.trus
De repente parou e correu de volta para o pai.	Di Re'pe~.Ti pa'row i ko'Rew Di 'vOw.ta 'pa.ra u 'paj
Fez o gesto de um grande abraço e, com os olhos fechados, simulou um grande beijo.	'fejz u 'ZEs.tu Di u~ 'gra~.Di a'bra.su i, ko~ uz 'O.Lus fe'Sa.dus, si~.mu'low u~ 'gra~.Di 'bej.Zu
De trás da barreira ele a abraçou também.	Di 'trajs da ba'Rej.ra 'e.li a a.bra'sow ta~'be~j~
Por um instante ela ficou totalmente imóvel, como se soubesse que estava lhe dando um presente.	pur u~ i~s'ta~.Ti 'E.la fi'kow to.taw'me~.Ti i~'mO.vew, 'ko~.mu si sow'bE.si ki es'ta.va Li 'da~.du u~ pre'ze~.Ti
Depois acenou, virou-se e correu para os outros.	de'pojz a.se~'now, vi'row si i ko'Rew 'pa.ra uz 'ow.trus
E agora Mack pôde ouvir claramente a voz que havia chamado sua Missy.	i a'gO.ra 'mE.ki 'po.Di ow'viX kla.ra~'me~.Ti a 'vOjs ki a'vi.a Sa~'ma.du 'su.a 'mi.si
Era Jesus brincando no meio de seus filhos.	'E.ra Ze'zujs bri~'ka~.du nu 'mej.u Di 'sews 'fi.Lus
Sem hesitar, Missy pulou no colo dele.	se~j~ e.zi'taX, 'mi.si pu'low nu 'kO.lu 'de.li
Ele girou-a no ar duas vezes antes de colocá-la de volta no chão, depois todo mundo riu e saíram procurando pedras lisas para jogar ricocheteando na superfície do lago.	'e.li Zi'row a nu 'aR 'du.as 've.ziz 'a~.Tis Di ko.lo'ka la Di 'vOw.ta nu 'Sa~w~, de'pojs 'to.du 'mu~.du 'Riw i sa'i.ra~w~ pro.ku'ra~.du 'pE.dras 'li.zas 'pa.ra Zo'ga.Ri.ko.Se.te'a~.du na su.peX'fi.si du 'la.gu
Os sons de exuberante alegria eram uma sinfonia nos ouvidos de Mack e suas lágrimas correram livremente.	us 'so~s Di e.zu.be'ra~.Ti a.le'gri.a 'E.ra~w~ u~.ma si~.fo~'ni.a nuz ow'vi.dus Di 'mE.ki i 'su.as 'la.gri~.mas ko'Re.ra~w~ li.vri~'me~.Ti
Instintivamente ele saltou para trás.	i~s.Ti~.Ti.va~'me~.Ti 'e.li saw'tow 'pa.ra 'trajs
Então percebeu que as paredes da caverna haviam se dissolvido ao redor e ele estava numa gruta atrás da cachoeira.	e~'ta~w~ peX.se'bew ki as pa're.Dis da ka'vER.na a'vi.a~w~ si Di.sow'vi.du aw Re'dOr i 'e.li es'ta.va 'nu~.ma 'gru.ta a'trajs da ka.So'ej.ra
Mack sentiu a mão da mulher nos ombros.	'mE.ki se~'Tiw a 'ma~w~ da mu'LER nuz 'o~.brus
Acabou? perguntou ele.	a.ka'bow, peR.gu~'tow 'e.li
Por enquanto, respondeu ela com ternura.	pur e~'kwa~.tu, Res.po~'dew 'E.la ko~ teR'nu.ra
Mackenzie, julgar não é destruir, mas consertar as coisas.	ma'ke~.zi, Zuw'gaR 'na~w~ E des.tru'iX, majs ko~.seX'tar as 'koj.zas
Não estou mais me sentindo travado.	'na~w~ es'tow 'majs mi se~'Ti~.du tra'va.du
Ela o guiou gentilmente para a lateral da cachoeira, até que ele pôde ver de novo, Jesus na margem do lago ainda jogando pedras.	'E.la u gi'ow Ze~.Tiw'me~.Ti 'pa.ra a la.te'raw da ka.So'ej.ra, a'tE ki 'e.li 'po.Di 'veR Di 'no.vu, Ze'zujs na 'maR.Ze~j~ du 'la.gu a'i~.da Zo'ga~.du 'pE.dras
Acho que alguém está esperando você.	'a.Su ki aw'ge~j~ es'ta es.pe'ra~.du vo'se
As mãos dela apertaram seus ombros com suavidade, depois ela o soltou e, sem olhar, Mack soube que ela fora embora.	as 'ma~w~s 'dE.la a.peX'ta.ra~w~ 'sewz 'o~.brus ko~ su.a.vi'da.Di, de'pojz 'E.la u sow'tow i, se~j~ o'LaX, 'mE.ki 'sow.bi ki 'E.la 'fo.ra e~'bO.ra
Ele passou cuidadosamente sobre pedras escorregadias e rochas molhadas até encontrar um caminho pela borda da cachoeira.	'e.li pa'sow kuj.da.dO.za~'me~.Ti 'so.bri 'pE.draz es.ko.Re.ga'Di.az i 'RO.Sas mo'La.daz a'tE e~.ko~'trar u~ ka~'mi~.Ju 'pe.la 'bOR.da da ka.So'ej.ra
Atravessou a névoa revigorante da água que despencava e retornou à luz do dia.	a.tra.ve'sow a 'nE.vo.a Re.vi.go'ra~.Ti da 'a.gwa ki des.pe~'ka.va i Re.toR'now a 'lujz du 'Di.a
Exausto, mas profundamente realizado, Mack parou e fechou os olhos por um momento, tentando gravar indelevelmente no pensamento os detalhes da presença de Missy, esperando que nos dias futuros pudesse trazer de volta cada momento com ela, cada nuance e cada movimento.	e'zaws.tu, majs pro.fu~.da~'me~.Ti Re.a.li'za.du, 'mE.ki pa'row i fe'Sow uz 'O.Lus pur u~ mo~'me~.tu, te~'ta~.du gra'var i~.de.lE.vew'me~.Ti nu pe~.sa~'me~.tu us de'ta.Lis da pre'ze~.sa Di 'mi.si, es.pe'ra~.du ki nus 'Di.as fu'tu.rus pu'dE.si tra'zeR Di 'vOw.ta 'ka.da mo~'me~.tu ko~ 'E.la, 'ka.da nu'a~.si i 'ka.da mo.vi~'me~.tu
E subitamente sentiu muita, muita falta de Nan.	i su.bi.ta~'me~.Ti se~'Tiw 'mu~j~.ta, 'mu~j~.ta 'faw.ta Di 'na~
Os homens jamais fazem o mal tão completamente e com tanta alegria como quando o fazem a partir de uma convicção religiosa.	uz 'o~.me~.Za~'majs 'fa.ze~j~ u 'maw 'ta~w~ ko~.plE.ta~'me~.Ti i ko~ 'ta~.ta a.le'gri.a 'ko~.mu 'kwa~.du u 'fa.ze~j~ a paX'TiR Di u~.ma ko~.vik'sa~w~ Re.li.Zi'O.za
Assim que abolimos Deus, o governo se torna Deus.	a'si~ ki a.bo'li~.mus 'dews, u go'veR.nu si 'tOR.na 'dews
Enquanto seguia pela trilha em direção ao lago, Mack percebeu subitamente que faltava alguma coisa.	e~'kwa~.tu se'gi.a 'pe.la 'tri.La e~j~ Di.re'sa~w~ aw 'la.gu, 'mE.ki peX.se'bew su.bi.ta~'me~.Ti ki faw'ta.va aw'gu~.ma 'koj.za
Sua companheira constante, a Grande Tristeza, havia sumido.	'su.a ko~.pa~'Jej.ra ko~s'ta~.Ti, a 'gra~.Di tris'te.za, a'vi.a su~'mi.du
Era como se tivesse sido lavada na névoa da cachoeira enquanto ele emergia por baixo da cortina dágua.	'E.ra 'ko~.mu si Ti'vE.si 'si.du la'va.da na 'nE.vo.a da ka.So'ej.ra e~'kwa~.tu 'e.li e~.meR'Zi.a puR 'baj.Su da koX'Ti~.na 'da.gwa
A ausência era estranha, talvez até desconfortável.	a aw'ze~.sja 'E.ra es'tra~.Ja, taw'vejz a'tE des.ko~.foX'ta.vew
Nos anos anteriores ela havia definido para ele o que era um estado normal, mas agora tinha desaparecido inesperadamente.	nuz 'a~.nuz a~.te.ri'o.riz 'E.la a'vi.a de.fi~'ni.du 'pa.ra 'e.li u ki 'E.ra u~ es'ta.du noR'maw, majz a'gO.ra 'Ti~.Ja de.za.pa.re'si.du i~.nes.pe.ra.da~'me~.Ti
O normal é um mito, pensou.	u noR'maw E u~ 'mi.tu, pe~'sow
A Grande Tristeza não faria mais parte de sua identidade.	a 'gra~.Di tris'te.za 'na~w~ fa'ri.a 'majs 'paX.Ti Di 'su.a i.de~.Ti'da.Di
Agora sabia que Missy não se importaria se ele se recusasse a usá-la.	a'gO.ra sa'bi.a ki 'mi.si 'na~w~ si i~.poX.ta'ri.a si 'e.li si Re.ku'za.si a u'za la
Na verdade, sua filha não iria querer que o pai se envolvesse naquela mortalha e certamente sofreria se ele fizesse isso.	na veR'da.Di, 'su.a 'fi.La 'na~w~ i'ri.a ke'reX ki u 'paj si e~.vow've.si na'kE.la moX'ta.La i sEX.ta~'me~.Ti so.fre'ri.a si 'e.li fi'zE.si 'i.su
Tentou imaginar quem ele passaria a ser, agora que estava se soltando de tudo aquilo, começar cada dia sem a culpa e o desespero que haviam sugado de todo as cores da vida.	te~'tow i~.ma.Zi~'naX 'ke~j~ 'e.li pa.sa'ri.a a 'seX, a'gO.ra ki es'ta.va si sow'ta~.du Di 'tu.du a'ki.lu, ko~.me'saX 'ka.da 'Di.a se~j~ a 'kuw.pa i u de.zes'pe.ru ki a'vi.a~w~ su'ga.du Di 'to.du as 'ko.ris da 'vi.da
Enquanto entrava na clareira, viu Jesus esperando, ainda jogando pedras.	e~'kwa~.tu e~'tra.va na kla'rej.ra, 'viw Ze'zujz es.pe'ra~.du, a'i~.da Zo'ga~.du 'pE.dras
Ei, acho que o máximo que consegui foram 13 ricochetes!	ej, 'a.Su ki u 'ma.si~.mu ki ko~.se'gi 'fo.ra~w~ 'tre.zi Ri.ko'Se.Tis
Disse ele rindo e vindo ao encontro de Mack.	'Di.si 'e.li 'Ri~.du i 'vi~.du aw e~'ko~.tru Di 'mE.ki
Mas Tyler conseguiu três a mais do que eu, e Josh jogou uma pedra que ricocheteou para tão longe que a perdemos de vista.	majs 'taj.leX ko~.se'giw 'trejz a 'majs du ki ew, i 'ZOS Zo'gow u~.ma 'pE.dra ki Ri.ko.Se.te'ow 'pa.ra 'ta~w~ 'lo~.Zi ki a peR'de~.mus Di 'vis.ta
Enquanto se abraçavam, Jesus acrescentou: Você têm filhos especiais, Mack.	e~'kwa~.tu si a.bra'sa.va~w~, Ze'zujz a.kre.se~'tow, vo'se 'te~j~ 'fi.Luz es.pe.si'ajs, 'mE.ki
Você e Nan os amaram muito bem.	vo'se i 'na~ uz a~'ma.ra~w~ 'mu~j~.tu 'be~j~
Kate está lutando, como você sabe, mas ainda não terminamos.	'kej.Ti es'ta lu'ta~.du, 'ko~.mu vo'se 'sa.bi, majz a'i~.da 'na~w~ teR.mi~'na~.mus
A tranquilidade e a intimidade com que Jesus falava de seus filhos tocou-o profundamente.	a tra~.kwi.li'da.Di i a i~.Ti~.mi'da.Di ko~ ki Ze'zujs fa'la.va Di 'sews 'fi.Lus to'kow u pro.fu~.da~'me~.Ti
Então eles foram embora?	e~'ta~w~ 'e.lis 'fo.ra~w~ e~'bO.ra
Jesus desfez o abraço e assentiu.	Ze'zujs des'fejz u a'bra.su i a.se~'Tiw
É, de volta para os sonhos, menos Missy, claro.	E, Di 'vOw.ta 'pa.ra us 'so~.Jus, 'me~.nus 'mi.si, 'kla.ru
Ela ficou felicíssima por estar tao perto de você e ficou empolgada em saber que você está melhor.	'E.la fi'kow fe.li'si.si~.ma pur es'taX 'taw 'pEX.tu Di vo'se i fi'kow e~.pow'ga.da e~j~ sa'beX ki vo'se es'ta me'LOX
Jesus entendeu e mudou de assunto.	Ze'zujz e~.te~'dew i mu'dow Di a'su~.tu
Como foi o tempo que você passou com Sophia?	'ko~.mu 'foj u 'te~.pu ki vo'se pa'sow ko~ so'fi.a
Sophia? Ah, então é ela! exclamou Mack.	so'fi.a, 'a, e~'ta~w~ E 'E.la, es.kla~'mow 'mE.ki
E uma expressão perplexa surgiu em seu rosto.	i u~.ma es.pre'sa~w~ peX'plEk.sa suR'Ziw e~j~ 'sew 'Ros.tu
Mas quer dizer que vocês são quatro?	majs 'kER Di'zeX ki vo'sejs 'sa~w~ 'kwa.tru
Ela é Deus também?	'E.la E 'dews ta~'be~j~
Não, Mack. Somos apenas três.	'na~w~, 'mE.ki, 'so~.muz a'pe~.nas 'trejs
Sophia é uma personificação da sabedoria de Papai.	so'fi.a E u~.ma peX.so~.ni.fi.ka'sa~w~ da sa.be.do'ri.a Di pa'paj
Ah, como nos Provérbios, onde a Sabedoria é representada como uma mulher chamando nas ruas, tentando encontrar alguém que a escute?	'a, 'ko~.mu nus pro'vER.bjus, 'o~.Di a sa.be.do'ri.a E Re.pre.ze~'ta.da 'ko~.mu u~.ma mu'LEX Sa~'ma~.du nas 'Ru.as, te~'ta~.du e~.ko~'trar aw'ge~j~ ki a es'ku.Ti
Ela mesma.	'E.la 'mez.ma
Mas, Mack parou enquanto se abaixava para desamarrar os cadarços dos sapatos, ela pareceu tão real!	majs, 'mE.ki pa'row e~'kwa~.tu si a.baj'Sa.va 'pa.ra de.za~.ma'Rar us ka'daX.sus dus sa'pa.tus, 'E.la pa.re'sew 'ta~w~ Re'aw
Ah, ela é bastante real, Em seguida Jesus olhou ao redor, como se quisesse ver se alguém estava observando, e sussurrou: Ela é parte do mistério que cerca Sarayu.	'a, 'E.la E bas'ta~.Ti Re'aw, e~j~ se'gi.da Ze'zujz o'Low aw Re'dOX, 'ko~.mu si ki'zE.si 'veX si aw'ge~j~ es'ta.va ob.seR'va~.du, i su.su'Row, 'E.la E 'paX.Ti du mis'tE.rju ki 'sEX.ka sa.ra'ju
Adoro Sarayu, exclamou Mack enquanto se levantava, meio surpreso com sua própria transparência.	a'dO.ru sa.ra'ju, es.kla~'mow 'mE.ki e~'kwa~.tu si le.va~'ta.va, 'mej.u suX'pre.zu ko~ 'su.a 'prO.prja tra~s.pa're~.sja
Eu também! declarou Jesus com ênfase.	ew ta~'be~j~, de.kla'row Ze'zujs ko~ 'e~.fa.zi
Os dois voltaram a margem e ficaram olhando em silêncio para o outro lado do lago.	us 'dojs vow'ta.ra~w~ a 'maR.Ze~j~ i fi'ka.ra~w~ o'La~.du e~j~ si'le~.sju 'pa.ra u 'ow.tru 'la.du du 'la.gu
Foi terrível e maravilhoso o tempo que passei com Sophia.	'foj te'Ri.vew i ma.ra.vi'Lo.zu u 'te~.pu ki pa'sej ko~ so'fi.a
Mack finalmente respondeu a pergunta que Jesus havia feito.	'mE.ki fi~.naw'me~.Ti Res.po~'dew a peR'gu~.ta ki Ze'zujz a'vi.a 'fej.tu
Subitamente percebeu que o sol ainda estava alto no céu.	su.bi.ta~'me~.Ti peX.se'bew ki u 'sOw a'i~.da es'ta.va 'aw.tu nu 'sEw
Exatamente quanto tempo estive lá?	e.za.ta~'me~.Ti 'kwa~.tu 'te~.pu es'Ti.vi 'la
Menos de 15 minutos, de modo que não foi muito.	'me~.nus Di 'ki~.zi mi~'nu.tus, Di 'mO.du ki 'na~w~ 'foj 'mu~j~.tu
Diante do olhar de perplexidade de Mack, Jesus acrescentou: O tempo passado com Sophia não é como o tempo normal.	Di'a~.Ti du o'LaR Di peX.plek.si'da.Di Di 'mE.ki, Ze'zujz a.kre.se~'tow, u 'te~.pu pa'sa.du ko~ so'fi.a 'na~w~ E 'ko~.mu u 'te~.pu noR'maw
Hã, grunhiu Mack.	'a~, gru~'Jiw 'mE.ki
Duvido que qualquer coisa com ela seja normal.	du'vi.du ki kwaw'kEX 'koj.za ko~ 'E.la 'se.Za noR'maw
Na verdade, Jesus começou a falar mas parou para jogar uma última pedra ricocheteando na água, com ela tudo é normal e de uma simplicidade elegante.	na veR'da.Di, Ze'zujs ko~.me'sow a fa'laR majs pa'row 'pa.ra Zo'gar u~.ma 'uw.Ti~.ma 'pE.dra Ri.ko.Se.te'a~.du na 'a.gwa, ko~ 'E.la 'tu.du E noR'maw i Di u~.ma si~.pli.si'da.Di e.le'ga~.Ti
Como você está tão perdido e independente, acaba achando que até a simplicidade dela é profunda.	'ko~.mu vo'se es'ta 'ta~w~ peR'Di.du i i~.de.pe~'de~.Ti, a'ka.ba a'Sa~.du ki a'tE a si~.pli.si'da.Di 'dE.la E pro'fu~.da
Então eu sou complexo e ela é simples.	e~'ta~w~ ew 'sow ko~'plEk.su i 'E.la E 'si~.plis
Uau! Meu mundo está mesmo de cabeça para baixo.	u'aw, 'mew 'mu~.du es'ta 'mez.mu Di ka'be.sa 'pa.ra 'baj.Su
Mack já se sentara num tronco e estava tirando os sapatos e as meias para a caminhada.	'mE.ki 'Za si se~'ta.ra nu~ 'tro~.ku i es'ta.va Ti'ra~.du us sa'pa.tuz i as 'mej.as 'pa.ra a ka~.mi~'Ja.da
Pode me dizer uma coisa?	'pO.Di mi Di'zer u~.ma 'koj.za
Estamos no meio do dia, e meus filhos estiveram aqui em sonhos?	es'ta~.mus nu 'mej.u du 'Di.a, i 'mews 'fi.Luz es.Ti'vE.ra~w~ a'ki e~j~ 'so~.Jus
Como isso funciona?	'ko~.mu 'i.su fu~.si'o~.na
Alguma coisa disso tudo é real?	aw'gu~.ma 'koj.za 'Di.su 'tu.du E Re'aw
Ou só estou sonhando também?	ow 'sO es'tow so~'Ja~.du ta~'be~j~
De novo Jesus riu.	Di 'no.vu Ze'zujs 'Riw
Não pergunte como tudo isso funciona, Mack.	'na~w~ peR'gu~.Ti 'ko~.mu 'tu.du 'i.su fu~.si'o~.na, 'mE.ki
São coisas de Sarayu.	'sa~w~ 'koj.zas Di sa.ra'ju
O tempo, como você sabe, não representa fronteiras para Aquele que o criou.	u 'te~.pu, 'ko~.mu vo'se 'sa.bi, 'na~w~ Re.pre'ze~.ta fro~'tej.ras 'pa.ra a'ke.li ki u kri'ow
Você pode perguntar a ela se quiser.	vo'se 'pO.Di peR.gu~'tar a 'E.la si ki'zEX
Não, acho que vou deixar isso esperando.	'na~w~, 'a.Su ki 'vow dej'Sar 'i.su es.pe'ra~.du
Só fiquei curioso.	'sO fi'kej ku.ri'o.zu
Mack deu um risinho.	'mE.ki 'dew u~ Ri'zi~.Ju
Você perguntou se alguma coisa disso tudo é real.	vo'se peR.gu~'tow si aw'gu~.ma 'koj.za 'Di.su 'tu.du E Re'aw
Muito mais do que você pode imaginar.	'mu~j~.tu 'majs du ki vo'se 'pO.Di i~.ma.Zi~'naX
O melhor seria perguntar: O que é real?	u me'LOX se'ri.a peR.gu~'taX, u ki E Re'aw
Estou começando a pensar que não faço idéia.	es'tow ko~.me'sa~.du a pe~'saX ki 'na~w~ 'fa.su i'dEj.a
Tudo isso seria menos real se estivesse dentro de um sonho?	'tu.du 'i.su se'ri.a 'me~.nus Re'aw si es.Ti'vE.si 'de~.tru Di u~ 'so~.Ju
Acho que eu ficaria desapontado.	'a.Su ki ew fi.ka'ri.a de.za.po~'ta.du
Mack, há muito mais coisas acontecendo aqui do que você têm condições de perceber.	'mE.ki, 'a 'mu~j~.tu 'majs 'koj.zaz a.ko~.te'se~.du a'ki du ki vo'se 'te~j~ ko~.Di'so~j~s Di peX.se'beX
Deixe-me garantir: tudo isso é real, muito mais real do que a vida que você conhece.	'dej.Si mi ga.ra~'TiX, 'tu.du 'i.su E Re'aw, 'mu~j~.tu 'majs Re'aw du ki a 'vi.da ki vo'se ko~'JE.si
Mack hesitou, mas depois decidiu se arriscar e perguntou:	'mE.ki e.zi'tow, majs de'pojs de.si'Diw si a.Ris'kar i peR.gu~'tow
Há uma coisa que ainda me incomoda com relação a Missy.	'a u~.ma 'koj.za ki a'i~.da mi i~.ko~'mO.da ko~ Re.la'sa~w~ a 'mi.si
Jesus veio e sentou-se no tronco ao lado dele.	Ze'zujs 'vej.u i se~'tow si nu 'tro~.ku aw 'la.du 'de.li
Mack inclinou-se e pôs os cotovelos nos joelhos, olhando para as pedrinhas perto dos pés.	'mE.ki i~.kli~'now si i 'pojz us ko.to've.lus nu.Zu'e.Lus, o'La~.du 'pa.ra as pe'dri~.Jas 'pEX.tu dus 'pEjs
Por fim, disse:	puX 'fi~, 'Di.si
Eu fico pensando nela, sozinha naquela picape, tão aterrorizada...	ew 'fi.ku pe~'sa~.du 'nE.la, sO'zi~.Ja na'kE.la pi'ka.pi, 'ta~w~ a.te.Ro.ri'za.da
Jesus colocou a mão sobre o ombro de Mack e o apertou.	Ze'zujs ko.lo'kow a 'ma~w~ 'so.bri u 'o~.bru Di 'mE.ki i u a.peX'tow
Falou gentilmente:	fa'low Ze~.Tiw'me~.Ti
Mack, ela jamais esteve sozinha.	'mE.ki, 'E.la Za~'majz es'te.vi sO'zi~.Ja
Eu nunca a deixei.	ew 'nu~.ka a dej'Sej
Nós não a deixamos sequer por um instante.	'nOjs 'na~w~ a dej'Sa~.mus se'kEX pur u~ i~s'ta~.Ti
Eu não poderia abandoná-la, nem você, assim como não poderia abandonar a mim mesmo.	ew 'na~w~ po.de'ri.a a.ba~.do~'na la, ne~j~ vo'se, a'si~ 'ko~.mu 'na~w~ po.de'ri.a a.ba~.do~'nar a 'mi~ 'mez.mu
Ela sabia que você estava lá?	'E.la sa'bi.a ki vo'se es'ta.va 'la
Sim, Mack, sabia.	'si~, 'mE.ki, sa'bi.a
No princípio, não.	nu pri~'si.pju, 'na~w~
O medo era avassalador e ela estava em estado de choque.	u 'me.du 'E.ra a.va.sa.la'dor i 'E.la es'ta.va e~j~ es'ta.du Di 'SO.ki
Demorou horas para chegar do acampamento até aqui.	de~.mo'row 'O.ras 'pa.ra Se'gaR du a.ka~.pa~'me~.tu a'tE a'ki
Mas, quando Sarayu se enrolou ao redor dela, Missy se acalmou.	majs, 'kwa~.du sa.ra'ju si e~.Ro'low aw Re'dOR 'dE.la, 'mi.si si a.kaw'mow
A viagem longa nos deu chance de conversar.	a vi'a.Ze~j~ 'lo~.ga nus 'dew 'Sa~.si Di ko~.veX'saX
Mack estava tentando apreender tudo aquilo.	'mE.ki es'ta.va te~'ta~.du a.pre.e~'deX 'tu.du a'ki.lu
Não se sentia capaz de falar.	'na~w~ si se~'Ti.a ka'pajz Di fa'laX
Missy podia ter apenas 6 anos, mas nós somos amigos.	'mi.si po'Di.a 'ter a'pe~.nas 'sejz 'a~.nus, majs 'nOjs 'so~.muz a~'mi.gus
Nós conversamos.	'nOjs ko~.veX'sa~.mus
Ela não tinha idéia do que iria acontecer.	'E.la 'na~w~ 'Ti~.Ja i'dEj.a du ki i'ri.a a.ko~.te'seX
Na verdade, estava mais preocupada com você e com as outras crianças, sabendo que vocês não poderiam encontrá-la.	na veR'da.Di, es'ta.va 'majs prew.ku'pa.da ko~ vo'se i ko~ az 'ow.tras kri'a~.sas, sa'be~.du ki vo'sejs 'na~w~ po.de'ri.a~w~ e~.ko~'tra la
Ela orou por vocês, pela sua paz.	'E.la o'row puR vo'sejs, 'pe.la 'su.a 'pajs
Mack chorou, lágrimas novas rolando pelo rosto.	'mE.ki So'row, 'la.gri~.mas 'nO.vas Ro'la~.du 'pe.lu 'Ros.tu
Dessa vez não se importou.	'dE.sa 'vejz 'na~w~ si i~.poX'tow
Jesus puxou-o gentilmente e o abraçou.	Ze'zujs pu'Sow u Ze~.Tiw'me~.Ti i u a.bra'sow
Mack, não creio que você queira saber todos os detalhes.	'mE.ki, 'na~w~ 'krej.u ki vo'se 'kej.ra sa'beX 'to.duz us de'ta.Lis
Tenho certeza de que eles não vão ajudá-lo.	'te~.Ju seX'te.za Di ki 'e.lis 'na~w~ 'va~w~ a.Zu'da lu
Mas posso dizer que não houve um momento em que não estivéssemos com ela.	majs 'pO.su Di'zeX ki 'na~w~ 'ow.vi u~ mo~'me~.tu e~j~ ki 'na~w~ es.Ti'vE.se~.mus ko~ 'E.la
Missy conheceu minha paz, e você ficaria orgulhoso, porque ela foi muito corajosa!	'mi.si ko~.Je'sew 'mi~.Ja 'pajs, i vo'se fi.ka'ri.a oR.gu'Lo.zu, puX'ke 'E.la 'foj 'mu~j~.tu ko.ra'ZO.za
As lágrimas escorriam soltas, mas Mack notava que agora era diferente.	as 'la.gri~.maz es.ko'Ri.a~w~ 'sow.tas, majs 'mE.ki no'ta.va ki a'gO.ra 'E.ra Di.fe're~.Ti
Não estava mais sozinho.	'na~w~ es'ta.va 'majs sO'zi~.Ju
Sem qualquer constrangimento, chorou no ombro daquele homem que ele aprendera a amar.	se~j~ kwaw'kEX ko~s.tra~.Zi~'me~.tu, So'row nu 'o~.bru da'ke.li 'o~.me~j~ ki 'e.li a.pre~'de.ra a a~'maX
A cada soluço, sua tensão ia se esvaindo, substituída por um profundo sentimento de alívio.	a 'ka.da so'lu.su, 'su.a te~'sa~w~ 'i.a si ez.va'i~.du, subs.Ti.tu'i.da pur u~ pro'fu~.du se~.Ti~'me~.tu Di a'li.vju
Por fim respirou fundo e soltou o ar enquanto levantava a cabeça.	puX 'fi~ Res.pi'row 'fu~.du i sow'tow u 'ar e~'kwa~.tu le.va~'ta.va a ka'be.sa
Então, sem dizer mais nenhuma palavra, levantou-se, pendurou os sapatos no ombro e simplesmente entrou na água.	e~'ta~w~, se~j~ Di'zeR 'majs ne~'Ju~.ma pa'la.vra, le.va~'tow si, pe~.du'row us sa'pa.tus nu 'o~.bru i si~.pliz'me~.Ti e~'trow na 'a.gwa
Ficou um pouco surpreso quando seu primeiro passo encontrou o fundo do lago abaixo dos tornozelos, mas não se importou.	fi'kow u~ 'pow.ku suX'pre.zu 'kwa~.du 'sew pri~'mej.ru 'pa.su e~.ko~'trow u 'fu~.du du 'la.gu a'baj.Su dus toR.no'ze.lus, majs 'na~w~ si i~.poX'tow
Parou, enrolou as pernas da calça acima dos joelhos e deu mais um passo na água gelada.	pa'row, e~.Ro'low as 'pER.nas da 'kaw.sa a'si~.ma du.Zu'e.Luz i 'dew 'majz u~ 'pa.su na 'a.gwa Ze'la.da
A água chegou até o meio das canelas e, no passo seguinte, logo abaixo dos joelhos.	a 'a.gwa Se'gow a'tE u 'mej.u das ka~'nE.laz i, nu 'pa.su se'gi~.Ti, 'lO.gu a'baj.Su du.Zu'e.Lus
Olhou para trás e viu Jesus parado na margem com os braços cruzados diante do peito, olhando-o.	o'Low 'pa.ra 'trajz i 'viw Ze'zujs pa'ra.du na 'maR.Ze~j~ ko~ us 'bra.sus kru'za.dus Di'a~.Ti du 'pej.tu, o'La~.du u
Mack virou-se e olhou para a margem oposta.	'mE.ki vi'row si i o'Low 'pa.ra a 'maR.Ze~j~ o'pOs.ta
Não sabia por que dessa vez não tinha funcionado, mas decidiu continuar tentando.	'na~w~ sa'bi.a puX 'ke 'dE.sa 'vejz 'na~w~ 'Ti~.Ja fu~.si.o~'na.du, majs de.si'Diw ko~.Ti~.nu'aX te~'ta~.du
Jesus estava ali, por isso ele não tinha com que se preocupar.	Ze'zujz es'ta.va a'li, pur 'i.su 'e.li 'na~w~ 'Ti~.Ja ko~ ki si prew.ku'paX
A perspectiva de nadar por um espaço longo e gelado não era nada empolgante, porém Mack tinha certeza de que conseguiria atravessar se fosse necessário.	a peXs.pek'Ti.va Di na'daX pur u~ es'pa.su 'lo~.gu i Ze'la.du 'na~w~ 'E.ra 'na.da e~.pow'ga~.Ti, po're~j~ 'mE.ki 'Ti~.Ja seX'te.za Di ki ko~.se.gi'ri.a a.tra.ve'saX si 'fo.si ne.se'sa.rju
Felizmente, quando deu o próximo passo, em vez de afundar mais ainda, subiu um pouco e, a cada passo seguinte, subiu mais, até estar de novo andando sobre a água.	fe.liz'me~.Ti, 'kwa~.du 'dew u 'prO.si~.mu 'pa.su, e~j~ 'vejz Di a.fu~'daR 'majz a'i~.da, su'biw u~ 'pow.ku i, a 'ka.da 'pa.su se'gi~.Ti, su'biw 'majs, a'tE es'taR Di 'no.vu a~'da~.du 'so.bri a 'a.gwa
Jesus se reuniu a ele e os dois continuaram em direção à cabana.	Ze'zujs si Re.u~'niw a 'e.li i us 'dojs ko~.Ti~.nu'a.ra~w~ e~j~ Di.re'sa~w~ a ka'ba~.na
Isso sempre funciona melhor quando a gente faz junto, não acha?	'i.su 'se~.pri fu~.si'o~.na me'LOX 'kwa~.du a 'Ze~.Ti 'fajz 'Zu~.tu, 'na~w~ 'a.Sa
Perguntou Jesus, sorrindo.	peR.gu~'tow Ze'zujs, so'Ri~.du
Estou vendo que ainda tenho mais coisas para aprender.	es'tow 've~.du ki a'i~.da 'te~.Ju 'majs 'koj.zas 'pa.ra a.pre~'deX
Mack devolveu o sorriso.	'mE.ki de.vow'vew u so'Ri.zu
Pouco importava que tivesse de atravessar o lago a nado ou andar sobre a agua, por mais maravilhoso que isso fosse.	'pow.ku i~.poX'ta.va ki Ti'vE.si Di a.tra.ve'sar u 'la.gu a 'na.du ow a~'daX 'so.bri a 'a.gwa, puR 'majs ma.ra.vi'Lo.zu ki 'i.su 'fo.si
O que importava era ter Jesus ao seu lado.	u ki i~.poX'ta.va 'E.ra 'teR Ze'zujz aw 'sew 'la.du
Talvez estivesse começando a confiar nele.	taw'vejz es.Ti'vE.si ko~.me'sa~.du a ko~.fi'aR 'ne.li
Obrigado por estar comigo, por falar comigo sobre Missy.	o.bri'ga.du pur es'taX ko~'mi.gu, puX fa'laX ko~'mi.gu 'so.bri 'mi.si
Na verdade, não tenho falado sobre esse assunto com ninguém.	na veR'da.Di, 'na~w~ 'te~.Ju fa'la.du 'so.bri 'e.si a'su~.tu ko~ ni~'ge~j~
É uma história apavorante demais.	E u~.ma is'tO.rja a.pa.vo'ra~.Ti de~'majs
Agora já não está com a mesma força.	a'gO.ra 'Za 'na~w~ es'ta ko~ a 'mez.ma 'foX.sa
A escuridão esconde o verdadeiro tamanho dos medos, das mentiras e dos arrependimentos, explicou Jesus.	a es.ku.ri'da~w~ es'ko~.Di u veR.da'dej.ru ta~'ma~.Ju dus 'me.dus, das me~'Ti.raz i duz a.Re.pe~.Di~'me~.tus, es.pli'kow Ze'zujs
A verdade é que eles são mais sombra do que realidade, por isso parecem maiores no escuro.	a veR'da.Di E ki 'e.lis 'sa~w~ 'majs 'so~.bra du ki Re.a.li'da.Di, pur 'i.su pa'rE.se~j~ maj'O.ris nu es'ku.ru
Quando a luz brilha nos lugares onde eles vivem no seu interior, você começa a ver o que são realmente.	'kwa~.du a 'lujz 'bri.La nus lu'ga.riz 'o~.Di 'e.lis 'vi.ve~j~ nu 'sew i~.te.ri'oX, vo'se ko~'mE.sa a 'ver u ki 'sa~w~ Re.aw'me~.Ti
Porque acreditamos que ela está mais segura ali.	puX'ke a.kre.Di'ta~.mus ki 'E.la es'ta 'majs se'gu.ra a'li
E algumas vezes, quando você é uma criança tentando sobreviver...	i aw'gu~.mas 've.zis, 'kwa~.du vo'se E u~.ma kri'a~.sa te~'ta~.du so.bre.vi'veX
Ela fica realmente mais segura no seu interior.	'E.la 'fi.ka Re.aw'me~.Ti 'majs se'gu.ra nu 'sew i~.te.ri'oX
Depois você cresce por fora, mas por dentro ainda é aquela criança na caverna escura, rodeada de monstros, e, como se habituou, continua aumentando sua coleção.	de'pojs vo'se 'krE.si puX 'fO.ra, majs puR 'de~.tru a'i~.da E a'kE.la kri'a~.sa na ka'vER.na es'ku.ra, Ro.de'a.da Di 'mo~s.trus, i, 'ko~.mu si a.bi.tu'ow, ko~.Ti~'nu.a aw~.me~'ta~.du 'su.a ko.le'sa~w~
Isso fez Mack sorrir. Sabia que Jesus estava se referindo a algo que Sarayu havia dito sobre colecionar lágrimas.	'i.su 'fejz 'mE.ki so'RiX, sa'bi.a ki Ze'zujz es'ta.va si Re.fe'ri~.du a 'aw.gu ki sa.ra'ju a'vi.a 'Di.tu 'so.bri ko.le.si.o~'naR 'la.gri~.mas
Então como é que isso muda para alguém que está perdido no escuro como eu?	e~'ta~w~ 'ko~.mu E ki 'i.su 'mu.da 'pa.ra aw'ge~j~ ki es'ta peR'Di.du nu es'ku.ru 'ko~.mu ew
Na maioria das vezes, muito devagar.	na maj.o'ri.a das 've.zis, 'mu~j~.tu de.va'gaX
Lembre-se, você não pode fazer isso sozinho.	'le~.bri si, vo'se 'na~w~ 'pO.Di fa'zer 'i.su sO'zi~.Ju
Algumas pessoas tentam todo tipo de mecanismos de enfrentamento e de jogos mentais.	aw'gu~.mas pe'so.as 'te~.ta~w~ 'to.du 'Ti.pu Di me.ka~'niz.mus Di e~.fre~.ta~'me~.tu i Di 'ZO.gus me~'tajs
Mas os monstros continuam lá, só esperando a chance de sair.	majz us 'mo~s.trus ko~.Ti~'nu.a~w~ 'la, 'sO es.pe'ra~.du a 'Sa~.si Di sa'iX
O que faço agora, então?	u ki 'fa.su a'gO.ra, e~'ta~w~
O que já está fazendo, Mack: aprendendo a viver sendo amado.	u ki 'Za es'ta fa'ze~.du, 'mE.ki, a.pre~'de~.du a vi'veX 'se~.du a~'ma.du
Não é um conceito fácil para os humanos.	'na~w~ E u~ ko~'sej.tu 'fa.siw 'pa.ra uz u~'ma~.nus
Você tinha dificuldade para compartilhar qualquer coisa.	vo'se 'Ti~.Ja Di.fi.kuw'da.Di 'pa.ra ko~.paX.Ti'LaX kwaw'kEX 'koj.za
Deu um risinho e continuou...	'dew u~ Ri'zi~.Ju i ko~.Ti~.nu'ow
Portanto, sim, o que desejamos é que você retorne para nós.	poX'ta~.tu, 'si~, u ki de.ze'Za~.muz E ki vo'se Re'tOR.ni 'pa.ra 'nOjs
Então iremos fazer nossa casa dentro de você e vamos compartilhar.	e~'ta~w~ i're~.mus fa'zeR 'nO.sa 'ka.za 'de~.tru Di vo'se i 'va~.mus ko~.paX.Ti'LaX
A amizade é real e não meramente imaginada.	a a~.mi'za.Di E Re'aw i 'na~w~ mE.ra~'me~.Ti i~.ma.Zi~'na.da
Nós fomos destinados a experimentar esta vida, a sua vida, juntos, num diálogo, compartilhando a jornada.	'nOjs 'fo~.mus des.Ti~'na.duz a es.pe.ri~.me~'tar 'Es.ta 'vi.da, a 'su.a 'vi.da, 'Zu~.tus, nu~ Di'a.lo.gu, ko~.paX.Ti'La~.du a ZoR'na.da
Mack riu alto e empurrou Jesus de lado.	'mE.ki 'Riw 'aw.tu i e~.pu'Row Ze'zujs Di 'la.du
Pare! gritou Jesus e se imobilizou.	'pa.ri, gri'tow Ze'zujz i si i~.mo.bi.li'zow
À princípio Mack achou que poderia tê-lo ofendido, mas Jesus estava olhando atentamente para a água.	a pri~'si.pju 'mE.ki a'Sow ki po.de'ri.a 'te lu o.fe~'Di.du, ma.Ze'zujz es'ta.va o'La~.du a.te~.ta~'me~.Ti 'pa.ra a 'a.gwa
Você viu?	vo'se 'viw
Olhe, aí vem de novo.	'O.Li, a'i 've~j~ Di 'no.vu
Mack chegou mais perto e protegeu os olhos na tentativa de ver o que Jesus estava olhando.	'mE.ki Se'gow 'majs 'pEX.tu i pro.te'Zew uz 'O.Lus na te~.ta'Ti.va Di 'ver u ki Ze'zujz es'ta.va o'La~.du
Olhe! Olhe! falou Jesus meio que sussurrando.	'O.Li, 'O.Li, fa'low Ze'zujs 'mej.u ki su.su'Ra~.du
É uma beleza! Deve ter uns 60 centímetros!	E u~.ma be'le.za, 'dE.vi 'ter u~s se'se~.ta se~'Ti~.me.trus
E então Mack viu uma enorme truta do lago deslizando a apenas uns 50 ou 60 centímetros abaixo da superfície, sem notar a agitação que estava provocando acima.	i e~'ta~w~ 'mE.ki 'viw u~.ma e~'nOR.mi 'tru.ta du 'la.gu dez.li'za~.du a a'pe~.naz u~s si~'kwe~.ta ow se'se~.ta se~'Ti~.me.truz a'baj.Su da su.peX'fi.si, se~j~ no'tar a a.Zi.ta'sa~w~ ki es'ta.va pro.vo'ka~.du a'si~.ma
Estive tentando pegá-la durante semanas e aí ela vem, só para me provocar.	es'Ti.vi te~'ta~.du pe'ga la du'ra~.Ti se~'ma~.naz i a'i 'E.la 've~j~, 'sO 'pa.ra mi pro.vo'kaX
Ele riu.	'e.li 'Riw
Mack ficou olhando, pasmo, enquanto Jesus começava a saltar para um lado e para outro, tentando acompanhar o peixe.	'mE.ki fi'kow o'La~.du, 'paz.mu, e~'kwa~.tu Ze'zujs ko~.me'sa.va a saw'taX 'pa.ra u~ 'la.du i 'pa.ra 'ow.tru, te~'ta~.du a.ko~.pa~'Jar u 'pej.Si
Finalmente desistiu e olhou para Mack, empolgado como um menininho.	fi~.naw'me~.Ti de.zis'Tiw i o'Low 'pa.ra 'mE.ki, e~.pow'ga.du 'ko~.mu u~ me~.ni~'ni~.Ju
Não é fantástica? Provavelmente nunca vou conseguir pegá-la.	'na~w~ E fa~'tas.Ti.ka, pro.va.vew'me~.Ti 'nu~.ka 'vow ko~.se'giX pe'ga la
Mack ficou perplexo com aquela cena.	'mE.ki fi'kow peX'plEk.su ko~ a'kE.la 'se~.na
Você não é o Senhor da Criação?	vo'se 'na~w~ E u se~'JoR da kri.a'sa~w~
Claro, disse Jesus, abaixando-se e passando a mão sobre a água.	'kla.ru, 'Di.si Ze'zujs, a.baj'Sa~.du si i pa'sa~.du a 'ma~w~ 'so.bri a 'a.gwa
Mas qual seria a diversão, hein?	majs 'kwaw se'ri.a a Di.veX'sa~w~, 'e~j~
Ele ergueu os olhos e riu.	'e.li eR'gew uz 'O.Luz i 'Riw
Mack não sabia se ria ou chorava.	'mE.ki 'na~w~ sa'bi.a si 'Ri.a ow So'ra.va
Percebia o quanto havia passado a amar aquele homem, aquele homem que também era Deus.	peX.se'bi.a u 'kwa~.tu a'vi.a pa'sa.du a a~'mar a'ke.li 'o~.me~j~, a'ke.li 'o~.me~j~ ki ta~'be~j~ 'E.ra 'dews
Jesus se levantou de novo e juntos continuaram andando para o cais.	Ze'zujs si le.va~'tow Di 'no.vu i 'Zu~.tus ko~.Ti~.nu'a.ra~w~ a~'da~.du 'pa.ra u 'kajs
Mack se aventurou mais uma vez:	'mE.ki si a.ve~.tu'row 'majz u~.ma 'vejs
Se é que posso perguntar, por quê você não me falou sobre Missy antes?	si E ki 'pO.su peR.gu~'taX, puX 'ke vo'se 'na~w~ mi fa'low 'so.bri 'mi.si 'a~.Tis
Por exemplo, ontem a noite, ou há um ano, ou...	pur e'ze~.plu, 'o~.te~j~ a 'noj.Ti, ow 'a 'u~ 'a~.nu, ow
Não pense que não tentamos.	'na~w~ 'pe~.si ki 'na~w~ te~'ta~.mus
Você já notou que, em sua dor, presume sempre o pior a meu respeito?	vo'se 'Za no'tow ki, e~j~ 'su.a 'doX, pre'zu~.mi 'se~.pri u pi'Or a 'mew Res'pej.tu
Estive falando com você durante um longo tempo, mas hoje foi a primeira vez que você pôde ouvir.	es'Ti.vi fa'la~.du ko~ vo'se du'ra~.Ti u~ 'lo~.gu 'te~.pu, majz 'o.Zi 'foj a pri~'mej.ra 'vejs ki vo'se 'po.Di ow'viX
Como pequenas rachaduras na parede, uma de cada vez, mas entrelaçadas, elas o prepararam para hoje.	'ko~.mu pe'ke~.nas Ra.Sa'du.ras na pa're.Di, u~.ma Di 'ka.da 'vejs, majz e~.tre.la'sa.das, 'E.laz u pre.pa'ra.ra~w~ 'pa.ra 'o.Zi
