Parecia um longo saco de dormir, amarrado com uma tira presa em cada ponta para ser carregado facilmente.	pa.re'si.a u~ 'lo~.gu 'sa.ku Di doR'miX, a~.ma'Ra.du ko~ u~.ma 'Ti.ra 'pre.za e~j~ 'ka.da 'po~.ta 'pa.ra 'seX ka.Re'ga.du fa.siw'me~.Ti
Entregou-o a Mack e ele sentiu imediatamente um perfume maravilhoso que vinha do embrulho.	e~.tre'gow u a 'mE.ki i 'e.li se~'Tiw i~.me.Di.a.ta~'me~.Ti u~ peX'fu~.mi ma.ra.vi'Lo.zu ki 'vi~.Ja du e~'bru.Lu
Era uma mistura de ervas e flores aromáticas que ele pensou reconhecer.	'E.ra u~.ma mis'tu.ra Di 'ER.vaz i 'flo.riz a.ro~'ma.Ti.kas ki 'e.li pe~'sow Re.ko~.Je'seX
Pôde sentir um cheiro de canela e de hortelã junto com sais e frutas.	'po.Di se~'Tir u~ 'Sej.ru Di ka~'nE.la i Di oX.te'la~ 'Zu~.tu ko~ 'sajz i 'fru.tas
Isso é um presente para mais tarde.	'i.su E u~ pre'ze~.Ti 'pa.ra 'majs 'taR.Di
Papai vai lhe mostrar como usá-lo.	pa'paj 'vaj Li mos'traX 'ko~.mu u'za lu
Ela sorriu e ele sentiu uma espécie de abraço.	'E.la so'Riw i 'e.li se~'Tiw u~.ma es'pE.si Di a'bra.su
Você pode carregar, acrescentou Papai.	vo'se 'pO.Di ka.Re'gaX, a.kre.se~'tow pa'paj
Você colheu essas plantas com Sarayu ontem.	vo'se ko'Lew 'E.sas 'pla~.tas ko~ sa.ra'ju 'o~.te~j~
Meu presente vai esperar aqui até sua volta, sorriu Jesus e também abraçou Mack.	'mew pre'ze~.Ti 'vaj es.pe'rar a'ki a'tE 'su.a 'vOw.ta, so'Riw Ze'zujz i ta~'be~j~ a.bra'sow 'mE.ki
Os dois saíram pelos fundos e Mack ficou sozinho com Papai, que estava fritando ovos com bacon.	us 'dojs sa'i.ra~w~ 'pe.lus 'fu~.duz i 'mE.ki fi'kow sO'zi~.Ju ko~ pa'paj, ki es'ta.va fri'ta~.du 'O.vus ko~ 'bej.ko~
Papai, perguntou Mack, surpreso ao ver como havia ficado fácil chamá-lo assim.	pa'paj, peR.gu~'tow 'mE.ki, suX'pre.zu aw 'veX 'ko~.mu a'vi.a fi'ka.du 'fa.siw Sa~'ma lu a'si~
Não vai comer?	'na~w~ 'vaj ko~'meX
Nada é um ritual, Mackenzie.	'na.da E u~ Ri.tu'aw, ma'ke~.zi
Você precisa disso, eu, não.	vo'se pre'si.za 'Di.su, ew, 'na~w~
Ele sorriu.	'e.li so'Riw
Mastigue devagar.	mas'Ti.gi de.va'gaX
Você tem bastante tempo e comer depressa demais não é bom para a digestão.	vo'se te~j~ bas'ta~.Ti 'te~.pu i ko~'meR de'prE.sa de~'majs 'na~w~ E 'bo~ 'pa.ra a Di.Zes'ta~w~
Mack comeu devagar e em silêncio, simplesmente desfrutando a presença de Papai.	'mE.ki ko~'mew de.va'gar i e~j~ si'le~.sju, si~.pliz'me~.Ti des.fru'ta~.du a pre'ze~.sa Di pa'paj
Num determinado momento, Jesus apareceu para informar que havia posto as ferramentas de que precisariam do lado de fora da porta.	nu~ de.teR.mi~'na.du mo~'me~.tu, Ze'zujz a.pa.re'sew 'pa.ra i~.foR'maX ki a'vi.a 'pos.tu as fe.Ra~'me~.tas Di ki pre.si.za'ri.a~w~ du 'la.du Di 'fO.ra da 'pOX.ta
Papai agradeceu, Jesus lhe deu um beijo nos lábios e saiu pela porta dos fundos.	pa'paj a.gra.de'sew, Ze'zujs Li 'dew u~ 'bej.Zu nus 'la.bjuz i sa'iw 'pe.la 'pOX.ta dus 'fu~.dus
Mack estava ajudando a limpar os poucos pratos quando perguntou: Você realmente o ama, não é?	'mE.ki es'ta.va a.Zu'da~.du a li~'par us 'pow.kus 'pra.tus 'kwa~.du peR.gu~'tow, vo'se Re.aw'me~.Ti u 'a~.ma, 'na~w~ E
Quero dizer, Jesus.	'kE.ru Di'zeX, Ze'zujs
Sei de quem você está falando, respondeu Papai, rindo.	'sej Di 'ke~j~ vo'se es'ta fa'la~.du, Res.po~'dew pa'paj, 'Ri~.du
Parou de lavar a frigideira.	pa'row Di la'var a fri.Zi'dej.ra
De todo o coração!	Di 'to.du u ko.ra'sa~w~
Imagino que haja algo muito especial num filho unigênito.	i~.ma'Zi~.nu ki 'a.Za 'aw.gu 'mu~j~.tu es.pe.si'aw nu~ 'fi.Lu u~.ni'Ze~.ni.tu
Papai piscou para Mack e continuou:	pa'paj pis'kow 'pa.ra 'mE.ki i ko~.Ti~.nu'ow
Isso faz parte do modo único pelo qual o conheço.	'i.su 'fajs 'paX.Ti du 'mO.du 'u~.ni.ku 'pe.lu 'kwaw u ko~'Je.su
Quando acabaram, Mack acompanhou Papai para fora.	'kwa~.du a.ka'ba.ra~w~, 'mE.ki a.ko~.pa~'Jow pa'paj 'pa.ra 'fO.ra
O alvorecer se anunciava nos picos das montanhas, as cores do nascer do sol invadindo o cinza da noite.	u aw.vo.re'seX si a~.nu~.si'a.va nus 'pi.kus das mo~'ta~.Jas, as 'ko.ris du na'seR du 'sOw i~.va'Di~.du u 'si~.za da 'noj.Ti
Mack pegou o presente de Sarayu e o pendurou no ombro.	'mE.ki pe'gow u pre'ze~.Ti Di sa.ra'ju i u pe~.du'row nu 'o~.bru
Papai lhe entregou uma pequena picareta e pôs uma mochila às costas.	pa'paj Li e~.tre'gow u~.ma pe'ke~.na pi.ka're.ta i 'pojz u~.ma mo'Si.la as 'kOs.tas
Em seguida pegou uma pá com uma das mãos, uma bengala com a outra e, sem dizer uma palavra, passou pelo jardim e pelo pomar indo na direção do lado direito do lago.	e~j~ se'gi.da pe'gow u~.ma 'pa ko~ u~.ma das 'ma~w~s, u~.ma be~'ga.la ko~ a 'ow.tra i, se~j~ Di'zer u~.ma pa'la.vra, pa'sow 'pe.lu ZaR'Di~ i 'pe.lu po~'mar 'i~.du na Di.re'sa~w~ du 'la.du Di'rej.tu du 'la.gu
Quando chegaram ao início da trilha havia luz suficiente para andar com facilidade.	'kwa~.du Se'ga.ra~w~ aw i~'ni.sju da 'tri.La a'vi.a 'lujs su.fi.si'e~.Ti 'pa.ra a~'daX ko~ fa.si.li'da.Di
Ali Papai parou e apontou a bengala para uma árvore fora do caminho.	a'li pa'paj pa'row i a.po~'tow a be~'ga.la 'pa.ra u~.ma 'aR.vo.ri 'fO.ra du ka~'mi~.Ju
Mack pôde ver que alguém marcara a árvore com um pequeno arco vermelho quase imperceptível.	'mE.ki 'po.Di 'veX ki aw'ge~j~ maX'ka.ra a 'aR.vo.ri ko~ u~ pe'ke~.nu 'aX.ku veR'me.Lu 'kwa.zi i~.peX.sep'Ti.vew
Aquilo não significava nada para ele e Papai não deu explicação.	a'ki.lu 'na~w~ si.gi~.ni.fi'ka.va 'na.da 'pa.ra 'e.li i pa'paj 'na~w~ 'dew es.pli.ka'sa~w~
Em vez disso, virou-se e seguiu pelo caminho, andando com facilidade.	e~j~ 'vejz 'Di.su, vi'row si i se'giw 'pe.lu ka~'mi~.Ju, a~'da~.du ko~ fa.si.li'da.Di
O presente de Sarayu era relativamente leve e Mack usou o cabo da picareta como bengala.	u pre'ze~.Ti Di sa.ra'ju 'E.ra Re.la.Ti.va~'me~.Ti 'lE.vi i 'mE.ki u'zow u 'ka.bu da pi.ka're.ta 'ko~.mu be~'ga.la
O caminho levou-os a atravessar um dos riachos e a entrar mais fundo na floresta.	u ka~'mi~.Ju le'vow uz a a.tra.ve'sar 'u~ dus Ri'a.Suz i a e~'traR 'majs 'fu~.du na flo'rEs.ta
Mack podia ouvir Papai trauteando uma cantiga, mas não a reconheceu.	'mE.ki po'Di.a ow'viX pa'paj traw.te'a~.du u~.ma ka~'Ti.ga, majs 'na~w~ a Re.ko~.Je'sew
Enquanto andavam, Mack pensou na miríade de coisas que experimentara nos dias anteriores.	e~'kwa~.tu a~'da.va~w~, 'mE.ki pe~'sow na mi'ri.a.Di Di 'koj.zas ki es.pe.ri~.me~'ta.ra nus 'Di.az a~.te.ri'o.ris
As conversas com cada um dos três, juntos e separados, o tempo passado com Sophia, as orações de que havia participado, a contemplação do céu estrelado com Jesus, a caminhada pelo lago.	as ko~'vEX.sas ko~ 'ka.da 'u~ dus 'trejs, 'Zu~.tuz i se.pa'ra.dus, u 'te~.pu pa'sa.du ko~ so'fi.a, az o.ra'so~j~s Di ki a'vi.a paX.Ti.si'pa.du, a ko~.te~.pla'sa~w~ du 'sEw es.tre'la.du ko~ Ze'zujs, a ka~.mi~'Ja.da 'pe.lu 'la.gu
A comemoração da noite anterior completara tudo, até mesmo a reconciliação com seu pai, tanta cura com tão poucas palavras.	a ko~.me~.mo.ra'sa~w~ da 'noj.Ti a~.te.ri'oX ko~.ple'ta.ra 'tu.du, a'tE 'mez.mu a Re.ko~.si.li.a'sa~w~ ko~ 'sew 'paj, 'ta~.ta 'ku.ra ko~ 'ta~w~ 'pow.kas pa'la.vras
Era difícil absorver tal quantidade de experiências e informações.	'E.ra Di'fi.siw ab.soR'veX 'taw kwa~.Ti'da.Di Di es.pe.ri'e~.sjaz i i~.foR.ma'so~j~s
Enquanto pensava e avaliava o que havia aprendido...	e~'kwa~.tu pe~'sa.va i a.va.li'a.va u ki a'vi.a a.pre~'Di.du
Mack percebeu quantas perguntas ainda tinha para fazer.	'mE.ki peX.se'bew 'kwa~.tas peR'gu~.taz a'i~.da 'Ti~.Ja 'pa.ra fa'zeX
Mas sentia que ainda não era hora.	majs se~'Ti.a ki a'i~.da 'na~w~ 'E.ra 'O.ra
Sabia apenas que nunca mais seria o mesmo e se perguntava o que significariam essas mudanças para Nan e seus filhos, especialmente Kate.	sa'bi.a a'pe~.nas ki 'nu~.ka 'majs se'ri.a u 'mez.mu i si peR.gu~'ta.va u ki si.gi~.ni.fi.ka'ri.a~w~ 'E.sas mu'da~.sas 'pa.ra 'na~ i 'sews 'fi.Lus, es.pe.si.aw'me~.Ti 'kej.Ti
Mas havia uma coisa que o estava incomodando.	majz a'vi.a u~.ma 'koj.za ki u es'ta.va i~.ko~.mo'da~.du
Por fim rompeu o silêncio.	puX 'fi~ Ro~'pew u si'le~.sju
Sophia me ajudou a entender muita coisa sobre Missy ontem.	so'fi.a mi a.Zu'dow a e~.te~'deR 'mu~j~.ta 'koj.za 'so.bri 'mi.si 'o~.te~j~
E realmente foi útil conversar com Papai.	i Re.aw'me~.Ti 'foj 'u.Tiw ko~.veX'saX ko~ pa'paj
Ah, quero dizer, com você.	'a, 'kE.ru Di'zeX, ko~ vo'se
Mack estava confuso, mas Papai parou e sorriu como se entendesse.	'mE.ki es'ta.va ko~'fu.zu, majs pa'paj pa'row i so'Riw 'ko~.mu si e~.te~'de.si
Mack prosseguiu:	'mE.ki pro.se'giw
É estranho eu precisar falar sobre isso com você também.	E es'tra~.Ju ew pre.si'zaX fa'laX 'so.bri 'i.su ko~ vo'se ta~'be~j~
Quero dizer, você é muito mais do que um pai, se é que isso faz sentido.	'kE.ru Di'zeX, vo'se E 'mu~j~.tu 'majs du ki u~ 'paj, si E ki 'i.su 'fajs se~'Ti.du
Entendo, Mackenzie.	e~'te~.du, ma'ke~.zi
Estamos completando o círculo.	es'ta~.mus ko~.ple'ta~.du u 'siX.ku.lu
Perdoar seu pai ontem foi extremamente importante para você poder me conhecer como pai hoje.	peR.do'aX 'sew 'paj 'o~.te~j~ 'foj es.tre~.ma~'me~.Ti i~.poX'ta~.Ti 'pa.ra vo'se po'deR mi ko~.Je'seX 'ko~.mu 'paj 'o.Zi
Não precisa explicar mais.	'na~w~ pre'si.za es.pli'kaR 'majs
De algum modo Mack sabia que estavam chegando ao fim de uma jornada e que Papai estava trabalhando para ajudá-lo a dar os últimos passos.	Di aw'gu~ 'mO.du 'mE.ki sa'bi.a ki es'ta.va~w~ Se'ga~.du aw 'fi~ Di u~.ma ZoR'na.da i ki pa'paj es'ta.va tra.ba'La~.du 'pa.ra a.Zu'da lu a 'dar uz 'uw.Ti~.mus 'pa.sus
Papai prosseguiu:	pa'paj pro.se'giw
Não havia possibilidade de criar a liberdade sem um custo, como você sabe.	'na~w~ a'vi.a po.si.bi.li'da.Di Di kri'ar a li.beR'da.Di se~j~ u~ 'kus.tu, 'ko~.mu vo'se 'sa.bi
Papai olhou para baixo, com as cicatrizes visíveis marcadas indelevelmente nos pulsos.	pa'paj o'Low 'pa.ra 'baj.Su, ko~ as si.ka'tri.zis vi'zi.vejs maX'ka.daz i~.de.lE.vew'me~.Ti nus 'puw.sus
Eu sabia que minha Criação iria se rebelar, que escolheria a independência e a morte, e sabia o que me custaria abrir um caminho para a reconciliação.	ew sa'bi.a ki 'mi~.Ja kri.a'sa~w~ i'ri.a si Re.be'laX, ki es.ko.Le'ri.a a i~.de.pe~'de~.sja i a 'mOX.Ti, i sa'bi.a u ki mi kus.ta'ri.a a'brir u~ ka~'mi~.Ju 'pa.ra a Re.ko~.si.li.a'sa~w~
A independência do ser humano liberou o que parece a você um mundo de caos aleatório e apavorante.	a i~.de.pe~'de~.sja du 'ser u~'ma~.nu li.be'row u ki pa'rE.si a vo'se u~ 'mu~.du Di 'kawz a.le.a'tO.rju i a.pa.vo'ra~.Ti
Eu poderia ter impedido o que aconteceu com Missy?	ew po.de'ri.a 'ter i~.pe'Di.du u ki a.ko~.te'sew ko~ 'mi.si
A resposta é sim.	a Res'pOs.ta E 'si~
Mack olhou para Papai, os olhos fazendo a pergunta que não precisava ser verbalizada.	'mE.ki o'Low 'pa.ra pa'paj, uz 'O.Lus fa'ze~.du a peR'gu~.ta ki 'na~w~ pre.si'za.va 'seR veR.ba.li'za.da
Ele continuou:	'e.li ko~.Ti~.nu'ow
Primeiro, se não tivesse havido a Criação, não haveria essas questões.	pri~'mej.ru, si 'na~w~ Ti'vE.si a'vi.du a kri.a'sa~w~, 'na~w~ a.ve'ri.a 'E.sas kes'to~j~s
Em segundo lugar, eu poderia ter optado por interferir ativamente no que aconteceu com ela.	e~j~ se'gu~.du lu'gaX, ew po.de'ri.a 'ter op'ta.du pur i~.teX.fe'rir a.Ti.va~'me~.Ti nu ki a.ko~.te'sew ko~ 'E.la
Jamais considerei a possibilidade de deixar de criar, e interferir no caso de Missy não era uma opção, por causa de propósitos que você não pode entender agora.	Za~'majs ko~.si.de'rej a po.si.bi.li'da.Di Di dej'SaR Di kri'aX, i i~.teX.fe'riR nu 'ka.zu Di 'mi.si 'na~w~ 'E.ra u~.ma op'sa~w~, puX 'kaw.za Di pro'pO.zi.tus ki vo'se 'na~w~ 'pO.Di e~.te~'der a'gO.ra
Nesse ponto tudo o que tenho a lhe oferecer como resposta é meu amor, minha bondade e meu relacionamento com você.	'ne.si 'po~.tu 'tu.du u ki 'te~.Ju a Li o.fe.re'seX 'ko~.mu Res'pOs.ta E 'mew a~'moX, 'mi~.Ja bo~'da.Di i 'mew Re.la.si.o~.na~'me~.tu ko~ vo'se
Eu não tive a intenção de fazer Missy morrer, mas isso não significa que não possa usar a morte dela para o bem.	ew 'na~w~ 'Ti.vi a i~.te~'sa~w~ Di fa'zeR 'mi.si mo'ReX, majz 'i.su 'na~w~ si.gi~.ni'fi.ka ki 'na~w~ 'pO.sa u'zar a 'mOX.Ti 'dE.la 'pa.ra u 'be~j~
Está certo.	es'ta 'sEX.tu
Não entendo direito.	'na~w~ e~'te~.du Di'rej.tu
Mas confio em você...	majs ko~'fi.u e~j~ vo'se
De repente irrompeu esse novo pensamento, surpreendente e maravilhoso.	Di Re'pe~.Ti i.Ro~'pew 'e.si 'no.vu pe~.sa~'me~.tu, suX.pre.e~'de~.Ti i ma.ra.vi'Lo.zu
Papai, eu confio em você!	pa'paj, ew ko~'fi.u e~j~ vo'se
Papai sorriu de volta para ele.	pa'paj so'Riw Di 'vOw.ta 'pa.ra 'e.li
Eu sei, filho, eu sei.	ew 'sej, 'fi.Lu, ew 'sej
Virou-se e voltou a caminhar pela trilha, seguido por Mack, agora com o coração mais leve e apaziguado.	vi'row si i vow'tow a ka~.mi~'JaX 'pe.la 'tri.La, se'gi.du puR 'mE.ki, a'gO.ra ko~ u ko.ra'sa~w~ 'majs 'lE.vi i a.pa.zi'gwa.du
Logo começaram uma subida relativamente fácil e o ritmo diminuiu.	'lO.gu ko~.me'sa.ra~w~ u~.ma su'bi.da Re.la.Ti.va~'me~.Ti 'fa.siw i u 'Ri.Ti~.mu Di~.mi~.nu'iw
Ocasionalmente Papai parava e batia numa pedra ou numa árvore grande do caminho, indicando em cada uma a presença do pequeno arco vermelho.	o.ka.zi.o~.naw'me~.Ti pa'paj pa'ra.va i ba'Ti.a 'nu~.ma 'pE.dra ow 'nu~.ma 'aR.vo.ri 'gra~.Di du ka~'mi~.Ju, i~.Di'ka~.du e~j~ 'ka.da u~.ma a pre'ze~.sa du pe'ke~.nu 'aX.ku veR'me.Lu
Antes que Mack pudesse fazer a pergunta óbvia, Papai se virava e continuava pela trilha.	'a~.Tis ki 'mE.ki pu'dE.si fa'zer a peR'gu~.ta 'Ob.vja, pa'paj si vi'ra.va i ko~.Ti~.nu'a.va 'pe.la 'tri.La
À medida que avançavam, as árvores iam rareando e Mack pôde vislumbrar campos rochosos onde deslizamentos de terra haviam tirado trechos da floresta algum tempo antes de a trilha ser aberta.	a me'Di.da ki a.va~'sa.va~w~, az 'aR.vo.riz 'i.a~w~ Ra.re'a~.du i 'mE.ki 'po.Di viz.lu~'braX 'ka~.pus Ro'SO.zuz 'o~.Di dez.li.za~'me~.tus Di 'tE.Ra a'vi.a~w~ Ti'ra.du 'tre.Sus da flo'rEs.ta aw'gu~ 'te~.pu 'a~.Tis Di a 'tri.La 'ser a'bEX.ta
Pararam uma vez para um rápido descanso e Mack aproveitou para beber um pouco da água fresca que Papai colocara nos cantis.	pa'ra.ra~w~ u~.ma 'vejs 'pa.ra u~ 'Ra.pi.du des'ka~.su i 'mE.ki a.pro.vej'tow 'pa.ra be'ber u~ 'pow.ku da 'a.gwa 'fres.ka ki pa'paj ko.lo'ka.ra nus ka~'Tis
Pouco depois da parada, o caminho ficou bem íngreme e o ritmo da caminhada diminuiu ainda mais.	'pow.ku de'pojs da pa'ra.da, u ka~'mi~.Ju fi'kow 'be~j~ 'i~.gre~.mi i u 'Ri.Ti~.mu da ka~.mi~'Ja.da Di~.mi~.nu'iw a'i~.da 'majs
Mack achou que deviam ter andado por quase duas horas quando saíram do meio das árvores.	'mE.ki a'Sow ki de'vi.a~w~ 'ter a~'da.du puX 'kwa.zi 'du.az 'O.ras 'kwa~.du sa'i.ra~w~ du 'mej.u daz 'aR.vo.ris
Para chegar à trilha delineada na encosta adiante teriam de passar por uma grande área de rochas e pedregulhos.	'pa.ra Se'gar a 'tri.La de.li~.ne'a.da na e~'kOs.ta a.Di'a~.Ti te'ri.a~w~ Di pa'saX pur u~.ma 'gra~.Di 'a.rja Di 'RO.Saz i pe.dre'gu.Lus
De novo Papai parou, pousou sua mochila e enfiou a mão dentro.	Di 'no.vu pa'paj pa'row, pow'zow 'su.a mo'Si.la i e~.fi'ow a 'ma~w~ 'de~.tru
Estamos quase chegando, filho, falou, entregando um cantil a Mack.	es'ta~.mus 'kwa.zi Se'ga~.du, 'fi.Lu, fa'low, e~.tre'ga~.du u~ ka~'Tiw a 'mE.ki
Estamos? perguntou Mack, olhando para o solitário e desolado terreno rochoso à frente.	es'ta~.mus, peR.gu~'tow 'mE.ki, o'La~.du 'pa.ra u so.li'ta.rju i de.zo'la.du te'Re~.nu Ro'So.zu a 'fre~.Ti
Papai escolheu uma pequena pedra perto do caminho e, colocando a mochila e a pá ao lado, sentou-se.	pa'paj es.ko'Lew u~.ma pe'ke~.na 'pE.dra 'pEX.tu du ka~'mi~.Ju i, ko.lo'ka~.du a mo'Si.la i a 'pa aw 'la.du, se~'tow si
Parecia perturbado.	pa.re'si.a peX.tuR'ba.du
Quero mostrar uma coisa que vai ser muito dolorosa para você.	'kE.ru mos'trar u~.ma 'koj.za ki 'vaj 'seR 'mu~j~.tu do.lo'rO.za 'pa.ra vo'se
Está bem.	es'ta 'be~j~
O estômago de Mack começou a se revirar enquanto ele se sentava e pousava a picareta e o presente de Sarayu sobre os joelhos.	u es'to~.ma.gu Di 'mE.ki ko~.me'sow a si Re.vi'rar e~'kwa~.tu 'e.li si se~'ta.va i pow'za.va a pi.ka're.ta i u pre'ze~.Ti Di sa.ra'ju 'so.bri u.Zu'e.Lus
Os aromas, reforçados pelo sol da manhã, preencheram seus sentidos com beleza e trouxeram alguma paz.	uz a'ro~.mas, Re.foX'sa.dus 'pe.lu 'sOw da ma~'Ja~, pre.e~'Se.ra~w~ 'sews se~'Ti.dus ko~ be'le.za i trow'sE.ra~w~ aw'gu~.ma 'pajs
O que é?	u ki E
Para ajudá-lo a ver, quero tirar mais uma coisa que obscurece seu coração.	'pa.ra a.Zu'da lu a 'veX, 'kE.ru Ti'raR 'majz u~.ma 'koj.za ki obs.ku'rE.si 'sew ko.ra'sa~w~
Mack soube imediatamente o que era e olhou para o chão entre seus pés.	'mE.ki 'sow.bi i~.me.Di.a.ta~'me~.Ti u ki 'E.ra i o'Low 'pa.ra u 'Sa~w~ 'e~.tri 'sews 'pEjs
Papai falou gentilmente, tranquilizando-o.	pa'paj fa'low Ze~.Tiw'me~.Ti, tra~.kwi.li'za~.du u
Filho, isso não é para envergonhar você.	'fi.Lu, 'i.su 'na~w~ E 'pa.ra e~.veR.go~'JaR vo'se
Não uso humilhação, nem culpa, nem condenação.	'na~w~ 'u.zu u~.mi.La'sa~w~, ne~j~ 'kuw.pa, ne~j~ ko~.de~.na'sa~w~
Elas não produzem uma fagulha de plenitude ou de justiça e por isso foram pregadas em Jesus na cruz.	'E.las 'na~w~ pro'du.ze~j~ u~.ma fa'gu.La Di ple~.ni'tu.Di ow Di Zus'Ti.sa i pur 'i.su 'fo.ra~w~ pre'ga.daz e~j~ Ze'zujs na 'krujs
Esperou, deixando que esse pensamento penetrasse em Mack e lavasse parte do sentimento de vergonha que ele sentia.	es.pe'row, dej'Sa~.du ki 'e.si pe~.sa~'me~.tu pe~.ne'tra.si e~j~ 'mE.ki i la'va.si 'paX.Ti du se~.Ti~'me~.tu Di veR'go~.Ja ki 'e.li se~'Ti.a
Depois continuou:	de'pojs ko~.Ti~.nu'ow
Hoje estamos na trilha da cura para encerrar essa parte da sua jornada.	'o.Zi es'ta~.mus na 'tri.La da 'ku.ra 'pa.ra e~.se'Rar 'E.sa 'paX.Ti da 'su.a ZoR'na.da
Não só para você, mas para outras pessoas também.	'na~w~ 'sO 'pa.ra vo'se, majs 'pa.ra 'ow.tras pe'so.as ta~'be~j~
Hoje vamos jogar uma pedra grande no lago e as ondulações vão chegar a lugares que você não imagina.	'o.Zi 'va~.mu.Zo'gar u~.ma 'pE.dra 'gra~.Di nu 'la.gu i az o~.du.la'so~j~s 'va~w~ Se'gar a lu'ga.ris ki vo'se 'na~w~ i~.ma'Zi~.na
Você já sabe o que eu quero, não sabe?	vo'se 'Za 'sa.bi u ki ew 'kE.ru, 'na~w~ 'sa.bi
Acho que sim, murmurou Mack, sentindo emoções que subiam aceleradas, saindo de um cômodo trancado em seu coração.	'a.Su ki 'si~, muR.mu'row 'mE.ki, se~'Ti~.du e~.mo'so~j~s ki su'bi.a~w~ a.se.le'ra.das, sa'i~.du Di u~ 'ko~.mo.du tra~'ka.du e~j~ 'sew ko.ra'sa~w~
Filho, você precisa falar, precisa verbalizar isso.	'fi.Lu, vo'se pre'si.za fa'laX, pre'si.za veR.ba.li'zar 'i.su
Agora não havia como se conter e, enquanto lágrimas quentes jorravam de seus olhos, Mack, soluçando, começou a confessar.	a'gO.ra 'na~w~ a'vi.a 'ko~.mu si ko~'ter i, e~'kwa~.tu 'la.gri~.mas 'ke~.Ti.Zo'Ra.va~w~ Di 'sewz 'O.Lus, 'mE.ki, so.lu'sa~.du, ko~.me'sow a ko~.fe'saX
Papai, ele disse chorando.	pa'paj, 'e.li 'Di.si So'ra~.du
Como posso perdoar aquele filho da puta que matou minha Missy?	'ko~.mu 'pO.su peR.do'ar a'ke.li 'fi.Lu da 'pu.ta ki ma'tow 'mi~.Ja 'mi.si
Se ele estivesse aqui hoje, não sei o que eu faria.	si 'e.li es.Ti'vE.si a'ki 'o.Zi, 'na~w~ 'sej u ki ew fa'ri.a
Sei que não é certo, mas quero feri-lo como ele me feriu...	'sej ki 'na~w~ E 'sEX.tu, majs 'kE.ru fe'ri lu 'ko~.mu 'e.li mi fe'riw
Se eu não puder ter justiça, ainda quero vingança.	si ew 'na~w~ pu'dEX 'teR Zus'Ti.sa, a'i~.da 'kE.ru vi~'ga~.sa
Papai simplesmente deixou a torrente sair de Mack, esperando que a onda passasse.	pa'paj si~.pliz'me~.Ti dej'Sow a to'Re~.Ti sa'iR Di 'mE.ki, es.pe'ra~.du ki a 'o~.da pa'sa.si
Mack, perdoar esse homem é entregá-lo a mim e permitir que eu o redima.	'mE.ki, peR.do'ar 'e.si 'o~.me~j~ E e~.tre'ga lu a 'mi~ i peR.mi'TiX ki ew u Re'Di~.ma
De novo Mack sentiu o fogo da raiva e da dor.	Di 'no.vu 'mE.ki se~'Tiw u 'fo.gu da 'Raj.va i da 'doX
Não quero que você o redima!	'na~w~ 'kE.ru ki vo'se u Re'Di~.ma
Quero que o machuque, castigue, mande para o inferno...	'kE.ru ki u ma'Su.ki, kas'Ti.gi, 'ma~.Di 'pa.ra u i~'fER.nu
Sua voz ficou no ar.	'su.a 'vOjs fi'kow nu 'aX
Papai esperou com paciência que as emoções passassem.	pa'paj es.pe'row ko~ pa.si'e~.sja ki az e~.mo'so~j~s pa'sa.se~j~
Estou travado, Papai.	es'tow tra'va.du, pa'paj
Simplesmente não posso esquecer o que ele fez, posso?	si~.pliz'me~.Ti 'na~w~ 'pO.su es.ke'ser u ki 'e.li 'fejs, 'pO.su
Implorou Mack.	i~.plo'row 'mE.ki
Perdoar não significa esquecer, Mack.	peR.do'aR 'na~w~ si.gi~.ni'fi.ka es.ke'seX, 'mE.ki
Significa soltar a garganta da outra pessoa.	si.gi~.ni'fi.ka sow'tar a gaR'ga~.ta da 'ow.tra pe'so.a
Mas eu achava que você esquecia os nossos pecados.	majz ew a'Sa.va ki vo'se es.ke'si.a us 'nO.sus pe'ka.dus
Mack, eu sou Deus.	'mE.ki, ew 'sow 'dews
Não esqueço nada.	'na~w~ es'ke.su 'na.da
Sei de tudo.	'sej Di 'tu.du
Para mim, esquecer é optar por me limitar.	'pa.ra 'mi~, es.ke'ser E op'taX puR mi li~.mi'taX
Filho, a voz de Papai ficou baixa e Mack olhou-o diretamente nos olhos profundos e castanhos, por cause de Jesus, não há agora nenhuma lei exiginto que eu traga seus pecados à mente.	'fi.Lu, a 'vOjz Di pa'paj fi'kow 'baj.Sa i 'mE.ki o'Low u Di.rE.ta~'me~.Ti nuz 'O.Lus pro'fu~.duz i kas'ta~.Jus, puX 'kaw.zi Di Ze'zujs, 'na~w~ 'a a'gO.ra ne~'Ju~.ma 'lej e.zi'Zi~.tu ki ew 'tra.ga 'sews pe'ka.duz a 'me~.Ti
Eles se foram e não interferem no nosso relacionamento.	'e.lis si 'fo.ra~w~ i 'na~w~ i~.teX'fE.re~j~ nu 'nO.su Re.la.si.o~.na~'me~.tu
Mas esse homem...	majz 'e.si 'o~.me~j~
Ele também é meu filho.	'e.li ta~'be~j~ E 'mew 'fi.Lu
Quero redimi-lo.	'kE.ru Re.Di~'mi lu
E depois?	i de'pojs
E depois? Você quer que eu simplesmente o perdoe, que fique tudo bem e que nós nos tornemos amigos? disse Mack baixinho, mas com sarcasmo.	i de'pojs, vo'se 'kEX ki ew si~.pliz'me~.Ti u peR'do.i, ki 'fi.ki 'tu.du 'be~j~ i ki 'nOjs nus toR'ne~.muz a~'mi.gus, 'Di.si 'mE.ki baj'Si~.Ju, majs ko~ saX'kaz.mu
Você não tem relacionamento com esse homem, pelo menos ainda não tem.	vo'se 'na~w~ te~j~ Re.la.si.o~.na~'me~.tu ko~ 'e.si 'o~.me~j~, 'pe.lu 'me~.nuz a'i~.da 'na~w~ te~j~
O perdão não estabelece um relacionamento.	u peR'da~w~ 'na~w~ es.ta.be'lE.si u~ Re.la.si.o~.na~'me~.tu
Em Jesus eu perdoei todos os humanos por seus pecados contra mim, mas só alguns escolheram relacionar-se comigo.	e~j~ Ze'zujz ew peR.do'ej 'to.duz uz u~'ma~.nus puX 'sews pe'ka.dus 'ko~.tra 'mi~, majs 'sO aw'gu~z es.ko'Le.ra~w~ Re.la.si.o~'naX si ko~'mi.gu
Mackenzie, você não vê que o perdão é um poder incrível, um poder que você compartilha conosco, um poder que Jesus dá a todos em quem ele reside, para que a reconciliação possa crescer?	ma'ke~.zi, vo'se 'na~w~ 've ki u peR'da~w~ E u~ po'der i~'kri.vew, u~ po'deX ki vo'se ko~.paX'Ti.La ko~'nos.ku, u~ po'deX ki Ze'zujs 'da a 'to.duz e~j~ 'ke~j~ 'e.li Re'zi.Di, 'pa.ra ki a Re.ko~.si.li.a'sa~w~ 'pO.sa kre'seX
Quando Jesus perdoou os que o pregaram à cruz, eles deixaram de dever qualquer coisa, tanto a ele quanto a mim.	'kwa~.du Ze'zujs peR.do'ow us ki u pre'ga.ra~w~ a 'krujs, 'e.lis dej'Sa.ra~w~ Di de'veX kwaw'kEX 'koj.za, 'ta~.tu a 'e.li 'kwa~.tu a 'mi~
No meu relacionamento com aqueles homens, jamais falarei do que eles fizeram nem irei envergonhá-los ou constrangê-los.	nu 'mew Re.la.si.o~.na~'me~.tu ko~ a'ke.liz 'o~.me~s, Za~'majs fa.la'rej du ki 'e.lis fi'zE.ra~w~ ne~j~ i'rej e~.veR.go~'Ja luz ow ko~s.tra~'Ze lus
Não creio que eu seja capaz de fazer isso, respondeu Mack baixinho.	'na~w~ 'krej.u ki ew 'se.Za ka'pajz Di fa'zer 'i.su, Res.po~'dew 'mE.ki baj'Si~.Ju
Quero que você faça.	'kE.ru ki vo'se 'fa.sa
O perdão existe em primeiro lugar para aquele que perdoa, para liberá-lo de algo que vai destruí-lo, que vai acabar com sua alegria e capacidade de amar integral e abertamente.	u peR'da~w~ e'zis.Ti e~j~ pri~'mej.ru lu'gaX 'pa.ra a'ke.li ki peR'do.a, 'pa.ra li.be'ra lu Di 'aw.gu ki 'vaj des.tru'i lu, ki 'vaj a.ka'baX ko~ 'su.a a.le'gri.a i ka.pa.si'da.Di Di a~'mar i~.te'graw i a.bEX.ta~'me~.Ti
Você acha que esse homem se importa com a dor e o tormento que lhe causou?	vo'se 'a.Sa ki 'e.si 'o~.me~j~ si i~'pOX.ta ko~ a 'dor i u toR'me~.tu ki Li kaw'zow
No mínimo ele se alimenta com seu sofrimento.	nu 'mi~.ni~.mu 'e.li si a.li~'me~.ta ko~ 'sew so.fri~'me~.tu
Você não quer cortar isso?	vo'se 'na~w~ 'kEX koX'tar 'i.su
Ao fazê-lo, irá libertar o homem de um fardo que ele carrega, quer saiba ou não, quer reconheça ou não.	aw fa'ze lu, i'ra li.beX'tar u 'o~.me~j~ Di u~ 'faR.du ki 'e.li ka'RE.ga, 'kEX 'saj.ba ow 'na~w~, 'kE.Re.ko~'Je.sa ow 'na~w~
Quando você opta por perdoar o outro, você o ama melhor.	'kwa~.du vo'se 'Op.ta puX peR.do'ar u 'ow.tru, vo'se u 'a~.ma me'LOX
Eu não o amo.	ew 'na~w~ u 'a~.mu
Hoje não, você não o ama.	'o.Zi 'na~w~, vo'se 'na~w~ u 'a~.ma
Mas eu amo, Mack, não pelo que ele se tornou, mas pela criança mutilada e deformada pela dor.	majz ew 'a~.mu, 'mE.ki, 'na~w~ 'pe.lu ki 'e.li si toR'now, majs 'pe.la kri'a~.sa mu.Ti'la.da i de.foR'ma.da 'pe.la 'doX
Quero ajudá-lo a assumir a natureza que encontra mais poder no amor e no perdão do que no ódio.	'kE.ru a.Zu'da lu a a.su~'mir a na.tu're.za ki e~'ko~.tra 'majs po'deR nu a~'mor i nu peR'da~w~ du ki nu 'O.Dju
Então isso significa, de novo Mack sentia um pouco de raiva pela direção que a conversa havia tomado, que, se eu perdoar esse homem, estarei deixando que ele brinque com Kate ou com minha primeira neta?	e~'ta~w~ 'i.su si.gi~.ni'fi.ka, Di 'no.vu 'mE.ki se~'Ti.a u~ 'pow.ku Di 'Raj.va 'pe.la Di.re'sa~w~ ki a ko~'vEX.sa a'vi.a to~'ma.du, ki, si ew peR.do'ar 'e.si 'o~.me~j~, es.ta'rej dej'Sa~.du ki 'e.li 'bri~.ki ko~ 'kej.Ti ow ko~ 'mi~.Ja pri~'mej.ra 'nE.ta
Mackenzie, Papai foi forte e firme.	ma'ke~.zi, pa'paj 'foj 'fOX.Ti i 'fiR.mi
Eu já lhe disse que o perdão não cria um relacionamento.	ew 'Za Li 'Di.si ki u peR'da~w~ 'na~w~ 'kri.a u~ Re.la.si.o~.na~'me~.tu
A não ser que as pessoas falem a verdade sobre o que fizeram e mudem a mente e o comportamento, não é possível um relacionamento de confiança.	a 'na~w~ 'seX ki as pe'so.as 'fa.le~j~ a veR'da.Di 'so.bri u ki fi'zE.ra~w~ i 'mu.de~j~ a 'me~.Ti i u ko~.poX.ta~'me~.tu, 'na~w~ E po'si.vew u~ Re.la.si.o~.na~'me~.tu Di ko~.fi'a~.sa
Quando você perdoa alguém, certamente liberta essa pessoa do julgamento, mas, se não houver uma verdadeira mudança, não pode ser estabelecido nenhum relacionamento verdadeiro.	'kwa~.du vo'se peR'do.a aw'ge~j~, sEX.ta~'me~.Ti li'bEX.ta 'E.sa pe'so.a du Zuw.ga~'me~.tu, majs, si 'na~w~ ow'vEr u~.ma veR.da'dej.ra mu'da~.sa, 'na~w~ 'pO.Di 'ser es.ta.be.le'si.du ne~'Ju~ Re.la.si.o~.na~'me~.tu veR.da'dej.ru
Então o perdão não exige que eu finja que o que ele fez nunca aconteceu?	e~'ta~w~ u peR'da~w~ 'na~w~ e'zi.Zi ki ew 'fi~.Za ki u ki 'e.li 'fejz 'nu~.ka a.ko~.te'sew
Como seria possível?	'ko~.mu se'ri.a po'si.vew
Você perdoou seu pai ontem à noite.	vo'se peR.do'ow 'sew 'paj 'o~.te~j~ a 'noj.Ti
Algum dia você vai esquecer o que ele lhe fez?	aw'gu~ 'Di.a vo'se 'vaj es.ke'ser u ki 'e.li Li 'fejs
Acho que não.	'a.Su ki 'na~w~
Mas agora você pode amá-lo, apesar disso.	majz a'gO.ra vo'se 'pO.Di a~'ma lu, a.pe'zaR 'Di.su
A mudança dele permite.	a mu'da~.sa 'de.li peR'mi.Ti
O perdão não exige de modo algum que você confie naquele a quem perdoou.	u peR'da~w~ 'na~w~ e'zi.Zi Di 'mO.du aw'gu~ ki vo'se ko~'fi.i na'ke.li a 'ke~j~ peR.do'ow
Mas, caso essa pessoa finalmente confesse e se arrependa, você descobrirá em seu coração um milagre que irá lhe permitir estender a mão e começar a construir uma ponte de reconciliação entre os dois.	majs, 'ka.zu 'E.sa pe'so.a fi~.naw'me~.Ti ko~'fE.si i si a.Re'pe~.da, vo'se des.ko.bri'ra e~j~ 'sew ko.ra'sa~w~ u~ mi'la.gri ki i'ra Li peR.mi'Tir es.te~'der a 'ma~w~ i ko~.me'sar a ko~s.tru'ir u~.ma 'po~.Ti Di Re.ko~.si.li.a'sa~w~ 'e~.tri us 'dojs
Algumas vezes, e isso talvez pareça incompreensível para você agora, essa estrada pode até mesmo levar ao milagre da confiança totalmente restaurada.	aw'gu~.mas 've.zis, i 'i.su taw'vejs pa're.sa i~.ko~.pre.e~'si.vew 'pa.ra vo'se a'gO.ra, 'E.sa es'tra.da 'pO.Di a'tE 'mez.mu le'var aw mi'la.gri da ko~.fi'a~.sa to.taw'me~.Ti Res.taw'ra.da
Mack escorregou para o chão e se recostou na pedra onde estivera sentado.	'mE.ki es.ko.Re'gow 'pa.ra u 'Sa~w~ i si Re.kos'tow na 'pE.dra 'o~.Di es.Ti'vE.ra se~'ta.du
Examinou a terra sob seus pés.	e.za~.mi~'now a 'tE.Ra sob 'sews 'pEjs
Papai, acho que entendo o que você está dizendo.	pa'paj, 'a.Su ki e~'te~.du u ki vo'se es'ta Di'ze~.du
Mas parece que, se eu perdoar esse sujeito, ele vai ficar livre.	majs pa'rE.si ki, si ew peR.do'ar 'e.si su'Zej.tu, 'e.li 'vaj fi'kaR 'li.vri
Como posso desculpá-lo pelo que fez?	'ko~.mu 'pO.su des.kuw'pa lu 'pe.lu ki 'fejs
É justo para Missy deixar de ficar com raiva dele?	E 'Zus.tu 'pa.ra 'mi.si dej'SaR Di fi'kaX ko~ 'Raj.va 'de.li
Mackenzie, o perdão não desculpa nada.	ma'ke~.zi, u peR'da~w~ 'na~w~ des'kuw.pa 'na.da
Acredite, esse homem pode ser qualquer coisa, menos livre.	a.kre'Di.Ti, 'e.si 'o~.me~j~ 'pO.Di 'seX kwaw'kEX 'koj.za, 'me~.nus 'li.vri
E você não tem o dever de fazer justiça nesse caso.	i vo'se 'na~w~ te~j~ u de'veR Di fa'zeR Zus'Ti.sa 'ne.si 'ka.zu
Eu cuidarei disso.	ew kuj.da'rej 'Di.su
E, quanto a Missy, ela já o perdoou.	i, 'kwa~.tu a 'mi.si, 'E.la 'Za u peR.do'ow
Já? Mack nem levantou os olhos.	'Za, 'mE.ki ne~j~ le.va~'tow uz 'O.Lus
Como pôde?	'ko~.mu 'po.Di
Por causa de minha presença nela.	puX 'kaw.za Di 'mi~.Ja pre'ze~.sa 'nE.la
É o único modo pelo qual o verdadeiro perdão é possível.	E u 'u~.ni.ku 'mO.du 'pe.lu 'kwaw u veR.da'dej.ru peR'da~w~ E po'si.vew
Mack sentiu Papai sentar-se ao seu lado, no chão, mas não olhou para cima.	'mE.ki se~'Tiw pa'paj se~'taX si aw 'sew 'la.du, nu 'Sa~w~, majs 'na~w~ o'Low 'pa.ra 'si~.ma
Enquanto os braços de Papai o envolviam, começou a chorar.	e~'kwa~.tu us 'bra.sus Di pa'paj u e~.vow'vi.a~w~, ko~.me'sow a So'raX
Deixe isso tudo sair.	'dej.Si 'i.su 'tu.du sa'iX
Ouviu o sussurro de Papai e finalmente se entregou.	ow'viw u su'su.Ru Di pa'paj i fi~.naw'me~.Ti si e~.tre'gow
Fechou os olhos enquanto as lágrimas jorravam.	fe'Sow uz 'O.Luz e~'kwa~.tu as 'la.gri~.ma.Zo'Ra.va~w~
As lembranças de Missy inundaram de novo sua mente: visões de livros de colorir, lápis de cor, vestido rasgado e ensanguentado.	as le~'bra~.sas Di 'mi.si i~.nu~'da.ra~w~ Di 'no.vu 'su.a 'me~.Ti, vi'zo~j~s Di 'li.vrus Di ko.lo'riX, 'la.pis Di 'koX, ves'Ti.du Raz'ga.du i e~.sa~.gwe~'ta.du
Com os olhos fechados, balançando para trás e para a frente, implorou:	ko~ uz 'O.Lus fe'Sa.dus, ba.la~'sa~.du 'pa.ra 'trajz i 'pa.ra a 'fre~.Ti, i~.plo'row
Ajude-me papai. Ajude-me!	a'Zu.Di mi pa'paj, a'Zu.Di mi
O que eu faço?	u ki ew 'fa.su
Como posso perdoá-lo?	'ko~.mu 'pO.su peR.do'a lu
Diga a ele.	'Di.ga a 'e.li
Mack levantou os olhos, como que esperando ver um homem que nunca havia encontrado.	'mE.ki le.va~'tow uz 'O.Lus, 'ko~.mu ki es.pe'ra~.du 'ver u~ 'o~.me~j~ ki 'nu~.ka a'vi.a e~.ko~'tra.du
Mas não havia ninguém.	majs 'na~w~ a'vi.a ni~'ge~j~
Como, Papai?	'ko~.mu, pa'paj
Só diga em voz alta.	'sO 'Di.ga e~j~ 'vOjz 'aw.ta
Há poder no que meus filhos declaram.	'a po'deR nu ki 'mews 'fi.Lus de'kla.ra~w~
Mack começou a sussurrar, primeiro hesitante, depois com convicção crescente:	'mE.ki ko~.me'sow a su.su'RaX, pri~'mej.ru e.zi'ta~.Ti, de'pojs ko~ ko~.vik'sa~w~ kre'se~.Ti
Eu perdoo.	ew peR'do.u
Papai o abraçou com força.	pa'paj u a.bra'sow ko~ 'foX.sa
Mackenzie, você é uma alegria enorme.	ma'ke~.zi, vo'se E u~.ma a.le'gri.a e~'nOR.mi
Quando ele finalmente se controlou, Papai lhe entregou um lenço umedecido para limpar o rosto.	'kwa~.du 'e.li fi~.naw'me~.Ti si ko~.tro'low, pa'paj Li e~.tre'gow u~ 'le~.su u~.me.de'si.du 'pa.ra li~'par u 'Ros.tu
Depois Mack se levantou, a princípio meio inseguro.	de'pojs 'mE.ki si le.va~'tow, a pri~'si.pju 'mej.u i~.se'gu.ru
Uau! disse, rouco, tentando encontrar uma palavra capaz de descrever a jornada emocional por que havia passado.	u'aw, 'Di.si, 'Row.ku, te~'ta~.du e~.ko~'trar u~.ma pa'la.vra ka'pajz Di des.kre'ver a ZoR'na.da e~.mo.si.o~'naw puX 'ke a'vi.a pa'sa.du
Sentia-se vivo.	se~'Ti.a si 'vi.vu
Entregou o lenço de volta a Papai e perguntou:	e~.tre'gow u 'le~.su Di 'vOw.ta a pa'paj i peR.gu~'tow
Então, tudo bem se eu ainda sentir raiva?	e~'ta~w~, 'tu.du 'be~j~ si ew a'i~.da se~'Ti'Raj.va
Papai foi rápido em responder:	pa'paj 'foj 'Ra.pi.du e~j~ Res.po~'deX
Sem dúvida! O que ele fez foi terrível.	se~j~ 'du.vi.da, u ki 'e.li 'fejs 'foj te'Ri.vew
Ele causou uma dor tremenda a muitas pessoas.	'e.li kaw'zow u~.ma 'doX tre~'me~.da a 'mu~j~.tas pe'so.as
Isso é errado e a raiva é a resposta certa para algo tão errado.	'i.su E e'Ra.du i a 'Raj.va E a Res'pOs.ta 'sEX.ta 'pa.ra 'aw.gu 'ta~w~ e'Ra.du
Mas não deixe que a raiva, a dor e a perda que você sente o impeçam de perdoar e de tirar as mãos do pescoço dele.	majs 'na~w~ 'dej.Si ki a 'Raj.va, a 'dor i a 'peR.da ki vo'se 'se~.Ti u i~'pE.sa~w~ Di peR.do'ar i Di Ti'rar as 'ma~w~s du pes'ko.su 'de.li
Papai pegou sua mochila e a colocou no ombro.	pa'paj pe'gow 'su.a mo'Si.la i a ko.lo'kow nu 'o~.bru
Filho, talvez você tenha de declarar seu perdão uma centena de vezes no primeiro e no segundo dia, mas a cada dia serão menos vezes, até que um dia você perceberá que perdoou completamente.	'fi.Lu, taw'vejz vo'se 'te~.Ja Di de.kla'raX 'sew peR'da~w~ u~.ma se~'te~.na Di 've.zis nu pri~'mej.ru i nu se'gu~.du 'Di.a, majz a 'ka.da 'Di.a se'ra~w~ 'me~.nus 've.zis, a'tE ki u~ 'Di.a vo'se peX.se.be'ra ki peR.do'ow ko~.plE.ta~'me~.Ti
E vai chegar o momento em que estará orando pela plenitude dele e o entregará a mim, para que meu amor queime na vida dele qualquer vestígio de corrupção.	i 'vaj Se'gar u mo~'me~.tu e~j~ ki es.ta'ra o'ra~.du 'pe.la ple~.ni'tu.Di 'de.li i u e~.tre.ga'ra a 'mi~, 'pa.ra ki 'mew a~'moX 'kej.mi na 'vi.da 'de.li kwaw'kER ves'Ti.Zju Di ko.Rup'sa~w~
Por mais incompreensível que possa parecer no momento, talvez um dia você conheça esse homem num contexto diferente.	puR 'majz i~.ko~.pre.e~'si.vew ki 'pO.sa pa.re'seR nu mo~'me~.tu, taw'vejz u~ 'Di.a vo'se ko~'Je.sa 'e.si 'o~.me~j~ nu~ ko~'tes.tu Di.fe're~.Ti
Mack gemeu.	'mE.ki Ze~'mew
Por mais que tudo o que escutava lhe revirasse o estômago, no coração ele sabia que era verdade.	puR 'majs ki 'tu.du u ki es.ku'ta.va Li Re.vi'ra.si u es'to~.ma.gu, nu ko.ra'sa~w~ 'e.li sa'bi.a ki 'E.ra veR'da.Di
Os dois se levantaram e Mack se virou na trilha para voltar na direção de onde tinham vindo.	us 'dojs si le.va~'ta.ra~w~ i 'mE.ki si vi'row na 'tri.La 'pa.ra vow'taR na Di.re'sa~w~ Di 'o~.Di 'Ti~.Ja~w~ 'vi~.du
Mack, nós não terminamos.	'mE.ki, 'nOjs 'na~w~ teR.mi~'na~.mus
Mack parou.	'mE.ki pa'row
Achei que era por isso que você me trouxe aqui.	a'Sej ki 'E.ra pur 'i.su ki vo'se mi 'trow.si a'ki
Era, mas eu lhe disse que tinha uma coisa para mostrar, uma coisa que você me pediu para fazer.	'E.ra, majz ew Li 'Di.si ki 'Ti~.Ja u~.ma 'koj.za 'pa.ra mos'traX, u~.ma 'koj.za ki vo'se mi pe'Diw 'pa.ra fa'zeX
Estamos aqui para levar Missy para casa.	es'ta~.muz a'ki 'pa.ra le'vaR 'mi.si 'pa.ra 'ka.za
De repente tudo fez sentido.	Di Re'pe~.Ti 'tu.du 'fejs se~'Ti.du
Ele olhou o presente de Sarayu e percebeu para que servia.	'e.li o'Low u pre'ze~.Ti Di sa.ra'ju i peX.se'bew 'pa.ra ki seR'vi.a
Em algum lugar naquela paisagem desolada o assassino havia escondido o corpo de Missy, e eles tinham vindo recuperá-lo.	e~j~ aw'gu~ lu'gaR na'kE.la paj'za.Ze~j~ de.zo'la.da u a.sa'si~.nu a'vi.a es.ko~'Di.du u 'koX.pu Di 'mi.si, i 'e.lis 'Ti~.Ja~w~ 'vi~.du Re.ku.pe'ra lu
Obrigado, foi tudo o que pôde dizer enquanto de novo uma cascata de lágrimas rolava por seu rosto, como se viesse de um reservatório infinito.	o.bri'ga.du, 'foj 'tu.du u ki 'po.Di Di'zer e~'kwa~.tu Di 'no.vu u~.ma kas'ka.ta Di 'la.gri~.mas Ro'la.va puX 'sew 'Ros.tu, 'ko~.mu si vi'E.si Di u~ Re.zeR.va'tO.rju i~.fi~'ni.tu
Ah, filho, disse Papai com ternura.	'a, 'fi.Lu, 'Di.si pa'paj ko~ teR'nu.ra
Jamais desconsidere a maravilha das suas lágrimas.	Za~'majs des.ko~.si'dE.ri a ma.ra'vi.La das 'su.as 'la.gri~.mas
Elas podem ser águas curativas e uma fonte de alegria.	'E.las 'pO.de~j~ 'ser 'a.gwas ku.ra'Ti.vaz i u~.ma 'fo~.Ti Di a.le'gri.a
Algumas vezes são as melhores palavras que o coração pode falar.	aw'gu~.mas 've.zis 'sa~w~ as me'LO.ris pa'la.vras ki u ko.ra'sa~w~ 'pO.Di fa'laX
Mack parou e encarou Papai.	'mE.ki pa'row i e~.ka'row pa'paj
Jamais havia olhado para um amor, uma delicadeza, uma esperança e uma alegria tão puros.	Za~'majz a'vi.a o'La.du 'pa.ra u~ a~'moX, u~.ma de.li.ka'de.za, u~.ma es.pe'ra~.sa i u~.ma a.le'gri.a 'ta~w~ 'pu.rus
Mas você prometeu que um dia não haverá mais lágrimas.	majs vo'se pro~.me'tew ki u~ 'Di.a 'na~w~ a.ve'ra 'majs 'la.gri~.mas
Estou ansioso por isso.	es'tow a~.si'o.zu pur 'i.su
Papai sorriu, encostou os dedos no rosto de Mack e gentilmente enxugou as faces marcadas pelas lágrimas.	pa'paj so'Riw, e~.kos'tow us 'de.dus nu 'Ros.tu Di 'mE.ki i Ze~.Tiw'me~.Ti e~.Su'gow as 'fa.sis maX'ka.das 'pe.las 'la.gri~.mas
Mackenzie, este mundo está cheio de lágrimas, mas, se você lembra, prometi que seria eu quem iria enxugá-las de seus olhos.	ma'ke~.zi, 'es.Ti 'mu~.du es'ta 'Sej.u Di 'la.gri~.mas, majs, si vo'se 'le~.bra, pro~.me'Ti ki se'ri.a ew 'ke~j~ i'ri.a e~.Su'ga las Di 'sewz 'O.Lus
Mack conseguiu sorrir enquanto sua alma continuava a se derreter e se curar no amor desse Pai.	'mE.ki ko~.se'giw so'Rir e~'kwa~.tu 'su.a 'aw.ma ko~.Ti~.nu'a.va a si de.Re'ter i si ku'raR nu a~'moR 'de.si 'paj
Aqui, disse Papai e lhe entregou um cantil.	a'ki, 'Di.si pa'paj i Li e~.tre'gow u~ ka~'Tiw
Tome um bom gole.	'to~.mi u~ 'bo~ 'gO.li
Não quero ver você se encolhendo como uma ameixa seca antes de tudo isso acabar.	'na~w~ 'kE.ru 'veR vo'se si e~.ko'Le~.du 'ko~.mu u~.ma a~'mej.Sa 'se.ka 'a~.Tis Di 'tu.du 'i.su a.ka'baX
Mack não conseguiu evitar uma gargalhada que a princípio pareceu deslocada, mas que depois, pensando bem, soube que era perfeita.	'mE.ki 'na~w~ ko~.se'giw e.vi'tar u~.ma gaR.ga'La.da ki a pri~'si.pju pa.re'sew dez.lo'ka.da, majs ki de'pojs, pe~'sa~.du 'be~j~, 'sow.bi ki 'E.ra peX'fej.ta
Papai foi à frente.	pa'paj 'foj a 'fre~.Ti
Antes de deixar o caminho principal e seguir por uma trilha que penetrava na massa de pedras espalhadas, parou e com sua bengala bateu numa pedra grande.	'a~.Tis Di dej'Sar u ka~'mi~.Ju pri~.si'paw i se'giX pur u~.ma 'tri.La ki pe~.ne'tra.va na 'ma.sa Di 'pE.draz es.pa'La.das, pa'row i ko~ 'su.a be~'ga.la ba'tew 'nu~.ma 'pE.dra 'gra~.Di
Indicou para Mack o mesmo arco vermelho.	i~.Di'kow 'pa.ra 'mE.ki u 'mez.mu 'aX.ku veR'me.Lu
E Mack descobriu que o caminho que estavam seguindo fora marcado pelo homem que levara sua filha.	i 'mE.ki des.ko'briw ki u ka~'mi~.Ju ki es'ta.va~w~ se'gi~.du 'fo.ra maX'ka.du 'pe.lu 'o~.me~j~ ki le'va.ra 'su.a 'fi.La
Enquanto caminhavam, Papai explicou a Mack que nenhum corpo fora encontrado porque esse homem procurava lugares para escondê-los meses antes de sequestrar as meninas.	e~'kwa~.tu ka~.mi~'Ja.va~w~, pa'paj es.pli'kow a 'mE.ki ki ne~'Ju~ 'koX.pu 'fo.ra e~.ko~'tra.du puX'ke 'e.si 'o~.me~j~ pro.ku'ra.va lu'ga.ris 'pa.ra es.ko~'de lus 'me.ziz 'a~.Tis Di se'kwes'trar as me~'ni~.nas
No meio da área pedregosa, Papai saiu do caminho e entrou num labirinto de pedras e paredões da montanha, não sem antes apontar novamente para a marca, agora familiar, numa face de rocha próxima.	nu 'mej.u da 'a.rja pe.dre'gO.za, pa'paj sa'iw du ka~'mi~.Ju i e~'trow nu~ la.bi'ri~.tu Di 'pE.draz i pa.re'do~j~s da mo~'ta~.Ja, 'na~w~ se~j~ 'a~.Tiz a.po~'taR nO.va~'me~.Ti 'pa.ra a 'maX.ka, a'gO.ra fa~.mi.li'aX, 'nu~.ma 'fa.si Di 'RO.Sa 'prO.si~.ma
Mack podia ver que, a não ser que a pessoa soubesse o que estava procurando, as marcas passariam facilmente despercebidas.	'mE.ki po'Di.a 'veX ki, a 'na~w~ 'seX ki a pe'so.a sow'bE.si u ki es'ta.va pro.ku'ra~.du, as 'maX.kas pa.sa'ri.a~w~ fa.siw'me~.Ti des.peX.se'bi.das
Dez minutos depois Papai parou diante de uma fenda onde dois afloramentos de pedra se encontravam.	'dEjz mi~'nu.tus de'pojs pa'paj pa'row Di'a~.Ti Di u~.ma 'fe~.da 'o~.Di 'dojz a.flo.ra~'me~.tus Di 'pE.dra si e~.ko~'tra.va~w~
Havia uma pequena pilha de pedregulhos na base, um deles com o símbolo do assassino.	a'vi.a u~.ma pe'ke~.na 'pi.La Di pe.dre'gu.Lus na 'ba.zi, 'u~ 'de.lis ko~ u 'si~.bo.lu du a.sa'si~.nu
Pode me ajudar? pediu a Mack e começou a retirar as pedras maiores.	'pO.Di mi a.Zu'daX, pe'Diw a 'mE.ki i ko~.me'sow a Re.Ti'rar as 'pE.dras maj'O.ris
Isso esconde a entrada de uma caverna.	'i.su es'ko~.Di a e~'tra.da Di u~.ma ka'vER.na
Assim que a entrada ficou livre, eles tiraram com a picareta e a pá a terra endurecida e o cascalho que bloqueavam a passagem.	a'si~ ki a e~'tra.da fi'kow 'li.vri, 'e.lis Ti'ra.ra~w~ ko~ a pi.ka're.ta i a 'pa a 'tE.Ra e~.du.re'si.da i u kas'ka.Lu ki blo.ke'a.va~w~ a pa'sa.Ze~j~
De repente o resto de entulho cedeu e apareceu a entrada de uma pequena caverna que provavelmente já fora a toca de algum animal durante a hibernação.	Di Re'pe~.Ti u 'REs.tu Di e~'tu.Lu se'dew i a.pa.re'sew a e~'tra.da Di u~.ma pe'ke~.na ka'vER.na ki pro.va.vew'me~.Ti 'Za 'fo.ra a 'tO.ka Di aw'gu~ a~.ni~'maw du'ra~.Ti a i.beR.na'sa~w~
Um odor rançoso de podridão saiu, deixando Mack engasgado.	u~ o'do.Ra~'so.zu Di po.dri'da~w~ sa'iw, dej'Sa~.du 'mE.ki e~.gaz'ga.du
Papai enfiou a mão na extremidade do rolo dado por Sarayu e tirou um pedaço de pano do tamanho de um lenço de cabeça.	pa'paj e~.fi'ow a 'ma~w~ na es.tre~.mi'da.Di du 'Ro.lu 'da.du puX sa.ra'ju i Ti'row u~ pe'da.su Di 'pa~.nu du ta~'ma~.Ju Di u~ 'le~.su Di ka'be.sa
Amarrou-o em volta da boca e do nariz de Mack e imediatamente um cheiro doce cortou o fedor da caverna.	a~.ma'Row u e~j~ 'vOw.ta da 'bo.ka i du na'riz Di 'mE.ki i i~.me.Di.a.ta~'me~.Ti u~ 'Sej.ru 'do.si koX'tow u fe'doR da ka'vER.na
Só havia espaço suficiente para entrarem se arrastando.	'sO a'vi.a es'pa.su su.fi.si'e~.Ti 'pa.ra e~'tra.re~j~ si a.Ras'ta~.du
Tirando uma poderosa lanterna da mochila, Papai se enfiou primeiro no buraco, com Mack logo atrás, ainda levando o presente de Sarayu.	Ti'ra~.du u~.ma po.de'rO.za la~'tER.na da mo'Si.la, pa'paj si e~.fi'ow pri~'mej.ru nu bu'ra.ku, ko~ 'mE.ki 'lO.gu a'trajs, a'i~.da le'va~.du u pre'ze~.Ti Di sa.ra'ju
Só demoraram alguns minutos para encontrar o tesouro agridoce.	'sO de~.mo'ra.ra~w~ aw'gu~s mi~'nu.tus 'pa.ra e~.ko~'trar u te'zow.ru a.gri'do.si
Num pequeno afloramento de rocha, Mack viu o corpo que ele presumiu ser o de Missy, de rosto para cima, coberto por um pano sujo e apodrecido.	nu~ pe'ke~.nu a.flo.ra~'me~.tu Di 'RO.Sa, 'mE.ki 'viw u 'koX.pu ki 'e.li pre.zu~'miw 'ser u Di 'mi.si, Di 'Ros.tu 'pa.ra 'si~.ma, ko'bEX.tu pur u~ 'pa~.nu 'su.Zu i a.po.dre'si.du
No mesmo instante soube que a verdadeira Missy não estava ali.	nu 'mez.mu i~s'ta~.Ti 'sow.bi ki a veR.da'dej.ra 'mi.si 'na~w~ es'ta.va a'li
Papai desembrulhou o que Sarayu lhes dera e no mesmo instante a toca se encheu de maravilhosos perfumes vivos.	pa'paj de.ze~.bru'Low u ki sa.ra'ju Lis 'dE.ra i nu 'mez.mu i~s'ta~.Ti a 'tO.ka si e~'Sew Di ma.ra.vi'LO.zus peX'fu~.mis 'vi.vus
Então Papai a enrolou com ternura e levou-a até a entrada.	e~'ta~w~ pa'paj a e~.Ro'low ko~ teR'nu.ra i le'vow a a'tE a e~'tra.da
Mack saiu primeiro e Papai lhe passou o tesouro.	'mE.ki sa'iw pri~'mej.ru i pa'paj Li pa'sow u te'zow.ru
Nenhuma palavra fora dita, a não ser as de Mack, que murmurava baixinho:	ne~'Ju~.ma pa'la.vra 'fo.ra 'Di.ta, a 'na~w~ 'ser as Di 'mE.ki, ki muR.mu'ra.va baj'Si~.Ju
Antes de deixarem o local, Papai pegou a rocha com o arco vermelho e colocou-a sobre a entrada.	'a~.Tis Di dej'Sa.re~j~ u lo'kaw, pa'paj pe'gow a 'RO.Sa ko~ u 'aX.ku veR'me.Lu i ko.lo'kow a 'so.bri a e~'tra.da
Mack não prestou muita atenção, pois estava absorvido pelos próprios pensamentos, enquanto segurava com ternura o corpo da filha junto ao coração.	'mE.ki 'na~w~ pres'tow 'mu~j~.ta a.te~'sa~w~, 'pojz es'ta.va ab.soR'vi.du 'pe.lus 'prO.prjus pe~.sa~'me~.tus, e~'kwa~.tu se.gu'ra.va ko~ teR'nu.ra u 'koX.pu da 'fi.La 'Zu~.tu aw ko.ra'sa~w~
Não há sofrimento na Terra que o Céu não possa curar.	'na~w~ 'a so.fri~'me~.tu na 'tE.Ra ki u 'sEw 'na~w~ 'pO.sa ku'raX
Chegaram de volta ao chalé em pouco tempo.	Se'ga.ra~w~ Di 'vOw.ta aw Sa'lE e~j~ 'pow.ku 'te~.pu
Jesus e Sarayu esperavam perto da porta dos fundos.	Ze'zujz i sa.ra'ju es.pe'ra.va~w~ 'pEX.tu da 'pOX.ta dus 'fu~.dus
Jesus aliviou Mack gentilmente do fardo e juntos foram à carpintaria onde ele estivera trabalhando.	Ze'zujz a.li.vi'ow 'mE.ki Ze~.Tiw'me~.Ti du 'faR.du i 'Zu~.tus 'fo.ra~w~ a kaX.pi~.ta'ri.a 'o~.Di 'e.li es.Ti'vE.ra tra.ba'La~.du
Mack não entrava ali desde que chegara e ficou surpreso com a simplicidade do lugar.	'mE.ki 'na~w~ e~'tra.va a'li 'dez.Di ki Se'ga.ra i fi'kow suX'pre.zu ko~ a si~.pli.si'da.Di du lu'gaX
A luz, atravessando grandes janelas, captava e refletia o pó de madeira que ainda pairava no ar.	a 'lujs, a.tra.ve'sa~.du 'gra~.Di.Za~'nE.las, kap'ta.va i Re.fle'Ti.a u 'pO Di ma'dej.ra ki a'i~.da paj'ra.va nu 'aX
As paredes e as bancadas, cobertas com todo tipo de ferramentas, estavam dispostas para facilitar as atividades da carpintaria.	as pa're.Diz i as ba~'ka.das, ko'bEX.tas ko~ 'to.du 'Ti.pu Di fe.Ra~'me~.tas, es'ta.va~w~ Dis'pOs.tas 'pa.ra fa.si.li'tar az a.Ti.vi'da.Dis da kaX.pi~.ta'ri.a
Este era claramente o santuário de um mestre artesão.	'es.Ti 'E.ra kla.ra~'me~.Ti u sa~.tu'a.rju Di u~ 'mEs.tri aX.te'za~w~
À frente deles estava o trabalho que Jesus estivera fazendo, uma obra de arte para guardar os restos de Missy.	a 'fre~.Ti 'de.liz es'ta.va u tra'ba.Lu ki Ze'zujz es.Ti'vE.ra fa'ze~.du, u~.ma 'O.bra Di 'aX.Ti 'pa.ra gwaR'dar us 'REs.tus Di 'mi.si
Ao examinar a caixa, Mack reconheceu imediatamente os relevos na madeira.	aw e.za~.mi~'nar a 'kaj.Sa, 'mE.ki Re.ko~.Je'sew i~.me.Di.a.ta~'me~.Ti us Re'le.vus na ma'dej.ra
Detalhes da vida de Missy estavam nela esculpidos.	de'ta.Lis da 'vi.da Di 'mi.si es'ta.va~w~ 'nE.la es.kuw'pi.dus
Havia um relevo de Missy com seu gato, Judas, e outro com Mack sentado numa cadeira lendo uma história para ela.	a'vi.a u~ Re'le.vu Di 'mi.si ko~ 'sew 'ga.tu, 'Zu.das, i 'ow.tru ko~ 'mE.ki se~'ta.du 'nu~.ma ka'dej.ra 'le~.du u~.ma is'tO.rja 'pa.ra 'E.la
Nan e Missy fazendo bolinhos, a viagem ao lago Wallowa com o teleférico subindo a montanha e até Missy colorindo o livro na mesa do acampamento, com uma representação caprichada do broche de joaninha que o assassino deixara.	'na~ i 'mi.si fa'ze~.du bo'li~.Jus, a vi'a.Ze~j~ aw 'la.gu 'wa.lo.wa ko~ u te.le'fE.ri.ku su'bi~.du a mo~'ta~.Ja i a'tE 'mi.si ko.lo'ri~.du u 'li.vru na 'me.za du a.ka~.pa~'me~.tu, ko~ u~.ma Re.pre.ze~.ta'sa~w~ ka.pri'Sa.da du 'brO.Si Di Zo.a~'ni~.Ja ki u a.sa'si~.nu dej'Sa.ra
Havia também um relevo exato de Missy de pé sorrindo e olhando para a cachoeira, ciente de que seu pai estava do outro lado.	a'vi.a ta~'be~j~ u~ Re'le.vu e'za.tu Di 'mi.si Di 'pE so'Ri~.du i o'La~.du 'pa.ra a ka.So'ej.ra, si'e~.Ti Di ki 'sew 'paj es'ta.va du 'ow.tru 'la.du
Entremeados com as cenas estavam as flores e os animais prediletos de Missy.	e~.tre~.me'a.dus ko~ as 'se~.naz es'ta.va~w~ as 'flo.riz i uz a~.ni~'majs pre.Di'lE.tus Di 'mi.si
Mack abraçou Jesus e este lhe sussurrou ao ouvido:	'mE.ki a.bra'sow Ze'zujz i 'es.Ti Li su.su'Row aw ow'vi.du
Foi Missy quem ajudou a escolher as cenas.	'foj 'mi.si 'ke~j~ a.Zu'dow a es.ko'Ler as 'se~.nas
O abraço de Mack ficou mais forte e demorado.	u a'bra.su Di 'mE.ki fi'kow 'majs 'fOX.Ti i de~.mo'ra.du
Temos o lugar perfeito preparado para o corpo dela, disse Sarayu, que se aproximara.	'te~.muz u lu'gaX peX'fej.tu pre.pa'ra.du 'pa.ra u 'koX.pu 'dE.la, 'Di.si sa.ra'ju, ki si a.pro.si~'ma.ra
Mackenzie, é no nosso jardim.	ma'ke~.zi, E nu 'nO.su ZaR'Di~
Com grande cuidado puseram os restos de Missy na caixa, colocando-a num leito de grama e musgo macios, e depois encheram com as flores e especiarias do embrulho de Sarayu.	ko~ 'gra~.Di kuj'da.du pu'zE.ra~w~ us 'REs.tus Di 'mi.si na 'kaj.Sa, ko.lo'ka~.du a nu~ 'lej.tu Di 'gra~.ma i 'muz.gu ma'si.us, i de'pojz e~'Se.ra~w~ ko~ as 'flo.riz i es.pe.si.a'ri.as du e~'bru.Lu Di sa.ra'ju
Fecharam a tampa, Jesus e Mack pegaram as extremidades e levaram o caixão para fora, seguindo Sarayu até o local do pomar que Mack ajudara a limpar.	fe'Sa.ra~w~ a 'ta~.pa, Ze'zujz i 'mE.ki pe'ga.ra~w~ az es.tre~.mi'da.Diz i le'va.ra~w~ u kaj'Sa~w~ 'pa.ra 'fO.ra, se'gi~.du sa.ra'ju a'tE u lo'kaw du po~'maX ki 'mE.ki a.Zu'da.ra a li~'paX
Ali, entre cerejeiras e pessegueiros, rodeado por orquídeas e lírios, fora aberto um buraco no lugar onde Mack havia desenraizado os arbustos floridos na véspera.	a'li, 'e~.tri se.re'Zej.raz i pe.se'gej.rus, Ro.de'a.du pur oX'ki.Daz i 'li.rjus, 'fo.ra a'bEX.tu u~ bu'ra.ku nu lu'gar 'o~.Di 'mE.ki a'vi.a de.ze~.Raj'za.du uz aR'bus.tus flo'ri.dus na 'vEs.pe.ra
Papai esperava-os.	pa'paj es.pe'ra.va us
Assim que a caixa enfeitada foi posta gentilmente no chão, ele deu um grande abraço em Mack, que retribuiu com a mesma intensidade.	a'si~ ki a 'kaj.Sa e~.fej'ta.da 'foj 'pOs.ta Ze~.Tiw'me~.Ti nu 'Sa~w~, 'e.li 'dew u~ 'gra~.Di a'bra.su e~j~ 'mE.ki, ki Re.tri.bu'iw ko~ a 'mez.ma i~.te~.si'da.Di
Sarayu se adiantou e disse com um floreio e uma reverência:	sa.ra'ju si a.Di.a~'tow i 'Di.si ko~ u~ flo'rej.u i u~.ma Re.ve're~.sja
Sinto-me honrada em cantar a canção que Missy compôs exatamente para esta ocasião.	'si~.tu mi o~'Ra.da e~j~ ka~'tar a ka~'sa~w~ ki 'mi.si ko~'pojz e.za.ta~'me~.Ti 'pa.ra 'Es.ta o.ka.zi'a~w~
E começou a cantar com uma voz que parecia vento de outono:	i ko~.me'sow a ka~'taX ko~ u~.ma 'vOjs ki pa.re'si.a 've~.tu Di ow'to~.nu
Um som de folhas balançando e florestas adormecendo lentamente, tons da noite chegando e uma promessa de novos dias.	u~ 'so~ Di 'fo.Las ba.la~'sa~.du i flo'rEs.taz a.doR.me'se~.du le~.ta~'me~.Ti, 'to~s da 'noj.Ti Se'ga~.du i u~.ma pro~'mE.sa Di 'nO.vus 'Di.as
Era a cantiga insistente que ele ouvira Sarayu e Papai cantarolarem antes.	'E.ra a ka~'Ti.ga i~.sis'te~.Ti ki 'e.li ow'vi.ra sa.ra'ju i pa'paj ka~.ta.ro'la.re~j~ 'a~.Tis
Agora Mack escutava as palavras de sua filha:	a'gO.ra 'mE.ki es.ku'ta.va as pa'la.vras Di 'su.a 'fi.La
E me abrace apertado para eu dormir	i mi a'bra.si a.peX'ta.du 'pa.ra ew doR'miX
Suavemente segura por tudo o que você dá.	su.a.ve~'me~.Ti se'gu.ra puX 'tu.du u ki vo'se 'da
Venha me beijar, vento, e tire meu fôlego	've~.Ja mi bej'ZaX, 've~.tu, i 'Ti.ri 'mew 'fo.le.gu
Até que você e eu sejamos um só,	a'tE ki vo'se i 'ew se'Za~.muz 'u~ 'sO
E dançaremos entre os túmulos até que toda a morte se vá.	i da~.sa're~.muz 'e~.tri us 'tu~.mu.luz a'tE ki 'to.da a 'mOX.Ti si 'va
E ninguém saiba que existimos nos braços um do outro,	i ni~'ge~j~ 'saj.ba ki e.zis'Ti~.mus nus 'bra.suz 'u~ du 'ow.tru
A não ser Aquele que soprou o hálito	a 'na~w~ 'ser a'ke.li ki so'prow u 'a.li.tu
Que me esconde livre do mal	ki mi es'ko~.Di 'li.vri du 'maw
Até que eu e você sejamos um só,	a'tE ki 'ew i vo'se se'Za~.muz 'u~ 'sO
Quando ela terminou houve silêncio, e depois Deus, todos os três, disseram simultaneamente:	'kwa~.du 'E.la teR.mi~'now 'ow.vi si'le~.sju, i de'pojs 'dews, 'to.duz us 'trejs, Di'sE.ra~w~ si~.muw.ta~.ne.a~'me~.Ti
Mack ecoou o amém, pegou uma das pás e, com a ajuda de Jesus, começou a encher o buraco, cobrindo o caixão onde descansava o corpo de Missy.	'mE.ki e.ko'ow u a~'me~j~, pe'gow u~.ma das 'pajz i, ko~ a a'Zu.da Di Ze'zujs, ko~.me'sow a e~'Ser u bu'ra.ku, ko'bri~.du u kaj'Sa~w~ 'o~.Di des.ka~'sa.va u 'koX.pu Di 'mi.si
Quando a tarefa terminou, Sarayu enfiou a mão dentro da roupa e pegou seu frasco pequeno e frágil.	'kwa~.du a ta'rE.fa teR.mi~'now, sa.ra'ju e~.fi'ow a 'ma~w~ 'de~.tru da 'Row.pa i pe'gow 'sew 'fras.ku pe'ke~.nu i 'fra.Ziw
Derramou algumas gotas da preciosa coleção na mão e começou a espalhar as lágrimas de Mack no solo rico e preto sob o qual dormia o corpo de Missy.	de.Ra~'mow aw'gu~.mas 'go.tas da pre.si'O.za ko.le'sa~w~ na 'ma~w~ i ko~.me'sow a es.pa'Lar as 'la.gri~.mas Di 'mE.ki nu 'sO.lu 'Ri.ku i 'pre.tu sob u 'kwaw doR'mi.a u 'koX.pu Di 'mi.si
As gotas caíram como diamantes e rubis, e onde pousavam brotavam flores instantaneamente, abrindo-se ao sol luminoso.	as 'go.tas ka'i.ra~w~ 'ko~.mu Di.a~'ma~.Tiz i Ru'bis, i 'o~.Di pow'za.va~w~ bro'ta.va~w~ 'flo.riz i~s.ta~.ta~.ne.a~'me~.Ti, a'bri~.du si aw 'sOw lu~.mi~'no.zu
Então Sarayu parou um momento, olhando com intensidade uma pérola que repousava em sua mão, uma lágrima especial, e depois deixou-a cair no centro do terreno.	e~'ta~w~ sa.ra'ju pa'row u~ mo~'me~.tu, o'La~.du ko~ i~.te~.si'da.Di u~.ma 'pE.ro.la ki Re.pow'za.va e~j~ 'su.a 'ma~w~, u~.ma 'la.gri~.ma es.pe.si'aw, i de'pojs dej'Sow a ka'iR nu 'se~.tru du te'Re~.nu
Imediatamente uma pequena árvore rompeu a terra e começou a se desdobrar, jovem, luxuriante e espantosa, crescendo e amadurecendo até se abrir em brotos e flores.	i~.me.Di.a.ta~'me~.Ti u~.ma pe'ke~.na 'aR.vo.ri Ro~'pew a 'tE.Ra i ko~.me'sow a si dez.do'braX, 'ZO.ve~j~, lu.Su.ri'a~.Ti i es.pa~'tO.za, kre'se~.du i a~.ma.du.re'se~.du a'tE si a'brir e~j~ 'bro.tuz i 'flo.ris
Então Sarayu, no seu modo de brisa sussurrante, virou-se e sorriu para Mack, que estivera olhando hipnotizado.	e~'ta~w~ sa.ra'ju, nu 'sew 'mO.du Di 'bri.za su.su'Ra~.Ti, vi'row si i so'Riw 'pa.ra 'mE.ki, ki es.Ti'vE.ra o'La~.du ip.no.Ti'za.du
É uma árvore da vida, Mack, crescendo no jardim do seu coração.	E u~.ma 'aR.vo.ri da 'vi.da, 'mE.ki, kre'se~.du nu ZaR'Di~ du 'sew ko.ra'sa~w~
Papai chegou perto e pôs o braço em seu ombro.	pa'paj Se'gow 'pEX.tu i 'pojz u 'bra.su e~j~ 'sew 'o~.bru
Missy é incrível, você sabe.	'mi.si E i~'kri.vew, vo'se 'sa.bi
Ela o ama muitíssimo.	'E.la u 'a~.ma mu~j~'Ti.si~.mu
Eu sei Mackenzie. Eu sei.	ew 'sej ma'ke~.zi, ew 'sej
Era pouco mais de meio-dia quando os quatro retornaram do jardim e entraram de novo no chalé.	'E.ra 'pow.ku 'majs Di 'mej.u 'Di.a 'kwa~.du us 'kwa.tru Re.toR'na.ra~w~ du ZaR'Di~ i e~'tra.ra~w~ Di 'no.vu nu Sa'lE
Não havia nada preparado na cozinha nem qualquer comida sobre a mesa de jantar.	'na~w~ a'vi.a 'na.da pre.pa'ra.du na ko'zi~.Ja ne~j~ kwaw'kEX ko~'mi.da 'so.bri a 'me.za Di Za~'taX
Papai levou-os para a sala de estar, onde sobre a mesinha de centro havia uma taça de vinho e um pão recém-assado.	pa'paj le'vow us 'pa.ra a 'sa.la Di es'taX, 'o~.Di 'so.bri a me'zi~.Ja Di 'se~.tru a'vi.a u~.ma 'ta.sa Di 'vi~.Ju i u~ 'pa~w~ Re'se~j~ a'sa.du
Sentaram-se todos, menos Papai, que permaneceu de pé.	se~'ta.ra~w~ si 'to.dus, 'me~.nus pa'paj, ki peR.ma~.ne'sew Di 'pE
Ele dirigiu suas palavras a Mack.	'e.li Di.ri'Ziw 'su.as pa'la.vraz a 'mE.ki
Mackenzie, temos uma coisa para você refletir.	ma'ke~.zi, 'te~.muz u~.ma 'koj.za 'pa.ra vo'se Re.fle'TiX
Enquanto esteve conosco, você foi curado e aprendeu muito.	e~'kwa~.tu es'te.vi ko~'nos.ku, vo'se 'foj ku'ra.du i a.pre~'dew 'mu~j~.tu
Acho que isso é um eufemismo, riu Mack.	'a.Su ki 'i.su E u~ ew.fe~'miz.mu, 'Riw 'mE.ki
Papai sorriu.	pa'paj so'Riw
Você sabe quanto nós gostamos de você.	vo'se 'sa.bi 'kwa~.tu 'nOjs gos'ta~.mus Di vo'se
Mas agora há uma escolha a ser feita.	majz a'gO.ra 'a u~.ma es'ko.La a 'seX 'fej.ta
Você pode permanecer conosco e continuar a crescer e aprender ou pode retornar à sua outra casa, a Nan, seus filhos e amigos.	vo'se 'pO.Di peR.ma~.ne'seX ko~'nos.ku i ko~.Ti~.nu'ar a kre'ser i a.pre~'der ow 'pO.Di Re.toR'nar a 'su.a 'ow.tra 'ka.za, a 'na~, 'sews 'fi.Luz i a~'mi.gus
De qualquer modo, prometo que sempre estarei com você.	Di kwaw'kER 'mO.du, pro~'me.tu ki 'se~.pri es.ta'rej ko~ vo'se
Mack se recostou e pensou.	'mE.ki si Re.kos'tow i pe~'sow
E Missy? perguntou.	i 'mi.si, peR.gu~'tow
Bom, se você optar por ficar, irá vê-la esta tarde.	'bo~, si vo'se op'taX puX fi'kaX, i'ra 've la 'Es.ta 'taR.Di
Ela virá também.	'E.la vi'ra ta~'be~j~
Mas, se escolher deixar este lugar, também estará escolhendo deixar Missy para trás.	majs, si es.ko'LeR dej'Sar 'es.Ti lu'gaX, ta~'be~j~ es.ta'ra es.ko'Le~.du dej'SaR 'mi.si 'pa.ra 'trajs
Essa não é uma escolha fácil, Mack suspirou.	'E.sa 'na~w~ E u~.ma es'ko.La 'fa.siw, 'mE.ki sus.pi'row
A sala ficou em silêncio durante vários minutos enquanto Papai dava a Mack espaço para lutar com seus próprios pensamentos e desejos.	a 'sa.la fi'kow e~j~ si'le~.sju du'ra~.Ti 'va.rjus mi~'nu.tuz e~'kwa~.tu pa'paj 'da.va a 'mE.ki es'pa.su 'pa.ra lu'taX ko~ 'sews 'prO.prjus pe~.sa~'me~.tuz i de'ze.Zus
Por fim, ele perguntou:	puX 'fi~, 'e.li peR.gu~'tow
O que Missy iria querer?	u ki 'mi.si i'ri.a ke'reX
Embora adorasse ficar com você hoje, ela vive onde não há impaciência.	e~'bO.ra a.do'ra.si fi'kaX ko~ vo'se 'o.Zi, 'E.la 'vi.vi 'o~.Di 'na~w~ 'a i~.pa.si'e~.sja
Ela não se incomoda em esperar.	'E.la 'na~w~ si i~.ko~'mO.da e~j~ es.pe'raX
Eu adoraria ficar com ela.	ew a.do.ra'ri.a fi'kaX ko~ 'E.la
Mack sorriu diante do pensamento.	'mE.ki so'Riw Di'a~.Ti du pe~.sa~'me~.tu
Mas seria muito duro para Nan e meus outros filhos.	majs se'ri.a 'mu~j~.tu 'du.ru 'pa.ra 'na~ i 'mewz 'ow.trus 'fi.Lus
Deixe-me perguntar uma coisa. O que eu faço lá em casa é importante?	'dej.Si mi peR.gu~'tar u~.ma 'koj.za, u ki ew 'fa.su 'la e~j~ 'ka.za E i~.poX'ta~.Ti
Eu apenas trabalho e cuido de minha família e dos amigos...	ew a'pe~.nas tra'ba.Lu i 'kuj.du Di 'mi~.Ja fa~'mi.lja i duz a~'mi.gus
Sarayu o interrompeu:	sa.ra'ju u i~.te.Ro~'pew
Mack, se alguma coisa importa, tudo importa.	'mE.ki, si aw'gu~.ma 'koj.za i~'pOX.ta, 'tu.du i~'pOX.ta
Como você é importante, tudo o que faz é importante.	'ko~.mu vo'se E i~.poX'ta~.Ti, 'tu.du u ki 'fajz E i~.poX'ta~.Ti
Cada vez que estende a mão e toca um coração ou uma vida, o mundo se transforma; a cada gentileza e serviço, visto ou não visto, meus propósitos são realizados e nada jamais será igual.	'ka.da 'vejs ki es'te~.Di a 'ma~w~ i 'tO.ka u~ ko.ra'sa~w~ ow u~.ma 'vi.da, u 'mu~.du si tra~s'fOR.ma, a 'ka.da Ze~.Ti'le.za i seR'vi.su, 'vis.tu ow 'na~w~ 'vis.tu, 'mews pro'pO.zi.tus 'sa~w~ Re.a.li'za.duz i 'na.da Za~'majs se'ra i'gwaw
Certo, disse Mack em tom decidido.	'sEX.tu, 'Di.si 'mE.ki e~j~ 'to~ de.si'Di.du
Então vou voltar.	e~'ta~w~ 'vow vow'taX
Não creio que ninguém vá acreditar na minha história, mas, se eu voltar, sei que posso fazer alguma diferença, mesmo que seja pequena.	'na~w~ 'krej.u ki ni~'ge~j~ 'va a.kre.Di'taR na 'mi~.Ja is'tO.rja, majs, si ew vow'taX, 'sej ki 'pO.su fa'zer aw'gu~.ma Di.fe're~.sa, 'mez.mu ki 'se.Za pe'ke~.na
Ele parou e olhou para cada um.	'e.li pa'row i o'Low 'pa.ra 'ka.da 'u~
Vocês sabem...	vo'sejs 'sa.be~j~
E realmente acredito que vocês nunca vão me deixar nem me abandonar, por isso não estou com medo de voltar.	i Re.aw'me~.Ti a.kre'Di.tu ki vo'sejs 'nu~.ka 'va~w~ mi dej'SaR ne~j~ mi a.ba~.do~'naX, pur 'i.su 'na~w~ es'tow ko~ 'me.du Di vow'taX
Bom, talvez um pouquinho.	'bo~, taw'vejz u~ pow'ki~.Ju
É uma escolha muito boa, disse Papai.	E u~.ma es'ko.La 'mu~j~.tu 'bo.a, 'Di.si pa'paj
Em seguida deu um sorriso luminoso e sentou-se ao lado dele.	e~j~ se'gi.da 'dew u~ so'Ri.zu lu~.mi~'no.zu i se~'tow si aw 'la.du 'de.li
Sarayu parou diante de Mack e falou:	sa.ra'ju pa'row Di'a~.Ti Di 'mE.ki i fa'low
Mackenzie, agora que você vai voltar, tenho mais um presente para você levar.	ma'ke~.zi, a'gO.ra ki vo'se 'vaj vow'taX, 'te~.Ju 'majz 'u~ pre'ze~.Ti 'pa.ra vo'se le'vaX
O que é? perguntou Mack, curioso.	u ki E, peR.gu~'tow 'mE.ki, ku.ri'o.zu
É para Kate.	E 'pa.ra 'kej.Ti
Kate? exclamou Mack, percebendo que ainda a levava como um fardo no coração.	'kej.Ti, es.kla~'mow 'mE.ki, peX.se'be~.du ki a'i~.da a le'va.va 'ko~.mu u~ 'faR.du nu ko.ra'sa~w~
Por favor, diga.	puX fa'voX, 'Di.ga
Kate acredita que é culpada pela morte de Missy.	'kej.Ti a.kre'Di.ta ki E kuw'pa.da 'pe.la 'mOX.Ti Di 'mi.si
Mack ficou pasmo.	'mE.ki fi'kow 'paz.mu
O que Sarayu acabava de dizer era óbvio demais.	u ki sa.ra'ju a.ka'ba.va Di Di'zer 'E.ra 'Ob.vju de~'majs
Fazia sentido que Kate se culpasse.	fa'zi.a se~'Ti.du ki 'kej.Ti si kuw'pa.si
Ela havia erguido o remo que provocara a sequência de acontecimentos, permitindo que Missy fosse sequestrada.	'E.la a'vi.a eR'gi.du u 'Re~.mu ki pro.vo'ka.ra a se'kwe~.sja Di a.ko~.te.si~'me~.tus, peR.mi'Ti~.du ki 'mi.si 'fo.si se.kwes'tra.da
Ele não podia acreditar que esse pensamento nunca lhe tivesse passado pela cabeça.	'e.li 'na~w~ po'Di.a a.kre.Di'taX ki 'e.si pe~.sa~'me~.tu 'nu~.ka Li Ti'vE.si pa'sa.du 'pe.la ka'be.sa
Num instante as palavras de Sarayu abriram uma nova perspectiva na luta de Kate.	nu~ i~s'ta~.Ti as pa'la.vras Di sa.ra'ju a'bri.ra~w~ u~.ma 'nO.va peXs.pek'Ti.va na 'lu.ta Di 'kej.Ti
Muito obrigado! disse, com o coração cheio de gratidão.	'mu~j~.tu o.bri'ga.du, 'Di.si, ko~ u ko.ra'sa~w~ 'Sej.u Di gra.Ti'da~w~
Agora tinha certeza de que precisava voltar, nem que fosse somente por Kate.	a'gO.ra 'Ti~.Ja seX'te.za Di ki pre.si'za.va vow'taX, ne~j~ ki 'fo.si sO~'me~.Ti puX 'kej.Ti
Sarayu concordou e sorriu.	sa.ra'ju ko~.koR'dow i so'Riw
Por fim Jesus se levantou, foi até uma das prateleiras e apanhou a latinha de Mack.	puX 'fi~ Ze'zujs si le.va~'tow, 'foj a'tE u~.ma das pra.te'lej.raz i a.pa~'Jow a la'Ti~.Ja Di 'mE.ki
Mack, achei que você iria querer...	'mE.ki, a'Sej ki vo'se i'ri.a ke'reX
Mack a pegou e a manteve nas mãos por um momento.	'mE.ki a pe'gow i a ma~'te.vi nas 'ma~w~s pur u~ mo~'me~.tu
Na verdade, acho que não vou precisar mais disso.	na veR'da.Di, 'a.Su ki 'na~w~ 'vow pre.si'zaR 'majs 'Di.su
Pode guardar para mim?	'pO.Di gwaR'daX 'pa.ra 'mi~
Todos os meus melhores tesouros estão escondidos em você, de qualquer modo.	'to.duz us 'mews me'LO.ris te'zow.ruz es'ta~w~ es.ko~'Di.duz e~j~ vo'se, Di kwaw'kER 'mO.du
Quero que você seja a minha vida.	'kE.ru ki vo'se 'se.Za a 'mi~.Ja 'vi.da
Eu sou, disse a clara e verdadeira voz da confirmação.	ew 'sow, 'Di.si a 'kla.ra i veR.da'dej.ra 'vOjz da ko~.fiR.ma'sa~w~
Sem qualquer ritual nem cerimônia, eles saborearam o pão quente, compartilharam o vinho e riram lembrando os momentos mais estranhos do fim de semana.	se~j~ kwaw'kE.Ri.tu'aw ne~j~ se.ri~'mo~.nja, 'e.lis sa.bo.re'a.ra~w~ u 'pa~w~ 'ke~.Ti, ko~.paX.Ti'La.ra~w~ u 'vi~.Ju i 'Ri.ra~w~ le~'bra~.du us mo~'me~.tus 'majz es'tra~.Jus du 'fi~ Di se~'ma~.na
Mack sabia que o tempo havia acabado, que era hora de voltar e pensar num modo de contar tudo a Nan.	'mE.ki sa'bi.a ki u 'te~.pu a'vi.a a.ka'ba.du, ki 'E.ra 'O.ra Di vow'tar i pe~'saR nu~ 'mO.du Di ko~'taX 'tu.du a 'na~
Não tinha nada para guardar na bagagem.	'na~w~ 'Ti~.Ja 'na.da 'pa.ra gwaR'daR na ba'ga.Ze~j~
Seus poucos pertences presumivelmente estavam de volta no carro.	'sews 'pow.kus peX'te~.sis pre.zu~.mi.vew'me~.Ti es'ta.va~w~ Di 'vOw.ta nu 'ka.Ru
Tirou a roupa de caminhada e vestiu aquelas com as quais tinha vindo, recém-lavadas e muito bem dobradas.	Ti'row a 'Row.pa Di ka~.mi~'Ja.da i ves'Tiw a'kE.las ko~ as 'kwajs 'Ti~.Ja 'vi~.du, Re'se~j~ la'va.daz i 'mu~j~.tu 'be~j~ do'bra.das
Quando terminou de se vestir, pegou o casaco e deu uma última olhada em seu quarto antes de sair.	'kwa~.du teR.mi~'now Di si ves'TiX, pe'gow u ka'za.ku i 'dew u~.ma 'uw.Ti~.ma o'La.da e~j~ 'sew 'kwaX.tu 'a~.Tis Di sa'iX
Deus, o servidor, ele riu, mas depois sentiu algo crescendo por dentro de novo, enquanto o pensamento o fazia parar.	'dews, u seR.vi'doX, 'e.li 'Riw, majs de'pojs se~'Tiw 'aw.gu kre'se~.du puR 'de~.tru Di 'no.vu, e~'kwa~.tu u pe~.sa~'me~.tu u fa'zi.a pa'raX
É mais verdadeiramente Deus, meu servidor.	E 'majs veR.da.dej.ra~'me~.Ti 'dews, 'mew seR.vi'doX
Quando Mack retornou à sala, os três haviam sumido.	'kwa~.du 'mE.ki Re.toR'now a 'sa.la, us 'trejz a'vi.a~w~ su~'mi.du
Uma xícara de café fumegante o esperava perto da lareira.	u~.ma 'Si.ka.ra Di ka'fE fu~.me'ga~.Ti u es.pe'ra.va 'pEX.tu da la'rej.ra
Sentado no chão, de costas para a lareira e tomando um gole de café, sorriu.	se~'ta.du nu 'Sa~w~, Di 'kOs.tas 'pa.ra a la'rej.ra i to~'ma~.du u~ 'gO.li Di ka'fE, so'Riw
Era maravilhoso e ele pôde sentir o calor descendo pelo peito.	'E.ra ma.ra.vi'Lo.zu i 'e.li 'po.Di se~'Tir u ka'loR de'se~.du 'pe.lu 'pej.tu
De repente estava exausto com a infinidade de emoções.	Di Re'pe~.Ti es'ta.va e'zaws.tu ko~ a i~.fi~.ni'da.Di Di e~.mo'so~j~s
Como se tivessem vontade própria, seus olhos se fecharam e Mack escorregou suavemente para um sono reconfortante.	'ko~.mu si Ti'vE.se~j~ vo~'ta.Di 'prO.prja, 'sewz 'O.Lus si fe'Sa.ra~w~ i 'mE.ki es.ko.Re'gow su.a.ve~'me~.Ti 'pa.ra u~ 'so~.nu Re.ko~.foX'ta~.Ti
A sensação seguinte foi de frio, dedos endurecidos se enfiando pela roupa e gelando a pele.	a se~.sa'sa~w~ se'gi~.Ti 'foj Di 'fri.u, 'de.duz e~.du.re'si.dus si e~.fi'a~.du 'pe.la 'Row.pa i Ze'la~.du a 'pE.li
Acordou de um salto e levantou-se desajeitadamente, com os músculos doloridos e rígidos por ter ficado deitado no chão.	a.koR'dow Di u~ 'saw.tu i le.va~'tow si de.za.Zej.ta.da~'me~.Ti, ko~ us 'mus.ku.lus do.lo'ri.duz i 'Ri.Zi.dus puX 'teX fi'ka.du dej'ta.du nu 'Sa~w~
Olhando ao redor, viu rapidamente que tudo estava igual ao que era dois dias antes, até a mancha de sangue perto da lareira onde estivera dormindo.	o'La~.du aw Re'dOX, 'viw Ra.pi.da~'me~.Ti ki 'tu.du es'ta.va i'gwaw aw ki 'E.ra 'dojs 'Di.az 'a~.Tis, a'tE a 'ma~.Sa Di 'sa~.gi 'pEX.tu da la'rej.ra 'o~.Di es.Ti'vE.ra doR'mi~.du
Pulou, correu pela porta quebrada e saiu para a varanda em ruínas.	pu'low, ko'Rew 'pe.la 'pOX.ta ke'bra.da i sa'iw 'pa.ra a va'ra~.da e~j~ Ru'i~.nas
De novo a cabana era velha e feia, com portas e janelas enferrujadas e quebradas.	Di 'no.vu a ka'ba~.na 'E.ra 'vE.La i 'fej.a, ko~ 'pOX.taz i Za~'nE.laz e~.fe.Ru'Za.daz i ke'bra.das
O inverno cobria a floresta e a trilha que levava ao jipe de Willie.	u i~'vER.nu ko'bri.a a flo'rEs.ta i a 'tri.La ki le'va.va aw 'Zi.pi Di 'wi.li
Mal se via o lago através da vegetação de urzes e espinheiros que o rodeavam.	'maw si 'vi.a u 'la.gu a.tra'vEjs da ve.Ze.ta'sa~w~ Di 'uR.ziz i es.pi~'Jej.rus ki u Ro.de'a.va~w~
A maior parte do cais estava afundada e apenas algumas das pilastras maiores continuavam de pé.	a maj'OX 'paX.Ti du 'kajz es'ta.va a.fu~'da.da i a'pe~.naz aw'gu~.mas das pi'las.tras maj'O.ris ko~.Ti~.nu'a.va~w~ Di 'pE
Estava de volta ao mundo real.	es'ta.va Di 'vOw.ta aw 'mu~.du Re'aw
Então sorriu.	e~'ta~w~ so'Riw
Era mais como se estivesse de volta ao mundo irreal.	'E.ra 'majs 'ko~.mu si es.Ti'vE.si Di 'vOw.ta aw 'mu~.du i.Re'aw
Apertou o casaco contra o corpo e retornou ao carro, seguindo suas próprias pegadas ainda visíveis na neve.	a.peX'tow u ka'za.ku 'ko~.tra u 'koX.pu i Re.toR'now aw 'ka.Ru, se'gi~.du 'su.as 'prO.prjas pe'ga.daz a'i~.da vi'zi.vejs na 'nE.vi
Foi tranquila a volta até Joseph, onde chegou no escuro de um fim de tarde de inverno.	'foj tra~'kwi.la a 'vOw.ta a'tE 'Zo.zef, 'o~.Di Se'gow nu es'ku.ru Di u~ 'fi~ Di 'taR.Di Di i~'vER.nu
Encheu o tanque, comeu comida de gosto normal e tentou ligar para Nan, sem sucesso.	e~'Sew u 'ta~.ki, ko~'mew ko~'mi.da Di 'gos.tu noR'maw i te~'tow li'gaX 'pa.ra 'na~, se~j~ su'sE.su
Ela provavelmente estava na estrada, disse a si mesmo, e a cobertura do celular podia ser precária.	'E.la pro.va.vew'me~.Ti es'ta.va na es'tra.da, 'Di.si a 'si 'mez.mu, i a ko.beX'tu.ra du se.lu'laX po'Di.a 'seX pre'ka.rja
Resolveu passar pela delegacia para falar com Tommy, mas depois que um rápido exame não revelou qualquer atividade lá dentro decidiu não entrar.	Re.zow'vew pa'saX 'pe.la de.le.ga'si.a 'pa.ra fa'laX ko~ 'to~.mi, majs de'pojs ki u~ 'Ra.pi.du e'za~.mi 'na~w~ Re.ve'low kwaw'kEr a.Ti.vi'da.Di 'la 'de~.tru de.si'Diw 'na~w~ e~'traX
No cruzamento seguinte o sinal ficou vermelho e ele parou.	nu kru.za~'me~.tu se'gi~.Ti u si~'naw fi'kow veR'me.Lu i 'e.li pa'row
Estava cansado, mas em paz e estranhamente empolgado.	es'ta.va ka~'sa.du, majz e~j~ 'pajz i es.tra~.Ja~'me~.Ti e~.pow'ga.du
Não achava que teria qualquer problema para ficar acordado na longa viagem para casa.	'na~w~ a'Sa.va ki te'ri.a kwaw'kEX pro'ble~.ma 'pa.ra fi'kar a.koR'da.du na 'lo~.ga vi'a.Ze~j~ 'pa.ra 'ka.za
Sentia-se ansioso para encontrar sua família, especialmente Kate.	se~'Ti.a si a~.si'o.zu 'pa.ra e~.ko~'traX 'su.a fa~'mi.lja, es.pe.si.aw'me~.Ti 'kej.Ti
Perdido em pensamentos, simplesmente passou pelo cruzamento quando o sinal ficou verde.	peR'Di.du e~j~ pe~.sa~'me~.tus, si~.pliz'me~.Ti pa'sow 'pe.lu kru.za~'me~.tu 'kwa~.du u si~'naw fi'kow 'veR.Di
Não viu o outro motorista avançando o sinal vermelho da transversal.	'na~w~ 'viw u 'ow.tru mo.to'ris.ta a.va~'sa~.du u si~'naw veR'me.Lu da tra~z.veX'saw
Houve apenas um clarão luminoso e depois nada, a não ser silêncio e escuridão.	'ow.vi a'pe~.naz u~ kla'ra~w~ lu~.mi~'no.zu i de'pojs 'na.da, a 'na~w~ 'seX si'le~.sju i es.ku.ri'da~w~
Numa fração de segundo o jipe vermelho de Willie foi destruído, em minutos chegaram o resgate dos bombeiros e a polícia e em horas o corpo ferido e inconsciente de Mack foi entregue pelo resgate aéreo no Emmanuel Hospital em Portland, Oregon.	'nu~.ma fra'sa~w~ Di se'gu~.du u 'Zi.pi veR'me.Lu Di 'wi.li 'foj des.tru'i.du, e~j~ mi~'nu.tu.Se'ga.ra~w~ u Rez'ga.Ti dus bo~'bej.ruz i a po'li.sja i e~j~ 'O.raz u 'koX.pu fe'ri.du i i~.ko~.si'e~.Ti Di 'mE.ki 'foj e~'trE.gi 'pe.lu Rez'ga.Ti a'E.rju nu e~.ma~.nu'Ew os.pi'taw e~j~ 'pOX.Ti.la~.Di, 'O.re.go~
A fé nunca sabe aonde está sendo levada, mas conhece e ama Aquele que a está levando.	a 'fE 'nu~.ka 'sa.bi a'o~.Di es'ta 'se~.du le'va.da, majs ko~'JE.si i 'a~.ma a'ke.li ki a es'ta le'va~.du
E finalmente, como se viesse de muito longe, ele escutou uma voz familiar gritando:	i fi~.naw'me~.Ti, 'ko~.mu si vi'E.si Di 'mu~j~.tu 'lo~.Zi, 'e.li es.ku'tow u~.ma 'vOjs fa~.mi.li'aR gri'ta~.du
Ele apertou meu dedo! Eu senti! Juro!	'e.li a.peX'tow 'mew 'de.du, ew se~'Ti, 'Zu.ru
Mack não podia abrir os olhos para ver, mas sabia que Josh estava segurando sua mão.	'mE.ki 'na~w~ po'Di.a a'brir uz 'O.Lus 'pa.ra 'veX, majs sa'bi.a ki 'ZOS es'ta.va se.gu'ra~.du 'su.a 'ma~w~
Tentou apertar de novo, mas a escuridão o dominou e ele apagou.	te~'tow a.peX'taR Di 'no.vu, majz a es.ku.ri'da~w~ u do~.mi~'now i 'e.li a.pa'gow
Demorou um dia inteiro para recuperar a consciência outra vez.	de~.mo'row 'u~ 'Di.a i~'tej.ru 'pa.ra Re.ku.pe'rar a ko~.si'e~.sja 'ow.tra 'vejs
Mal podia mover outro músculo do corpo.	'maw po'Di.a mo'ver 'ow.tru 'mus.ku.lu du 'koX.pu
Até mesmo o esforço para levantar uma única pálpebra parecia avassalador, mas o movimento foi recompensado por gritos e risos.	a'tE 'mez.mu u es'foX.su 'pa.ra le.va~'tar u~.ma 'u~.ni.ka 'paw.pe.bra pa.re'si.a a.va.sa.la'doX, majz u mo.vi~'me~.tu 'foj Re.ko~.pe~'sa.du puR 'gri.tuz i 'Ri.zus
Uma após outra, um desfile de pessoas veio até seu único olho entreaberto, como se estivessem olhando para dentro de um buraco fundo e escuro que continha algum tesouro incrível.	u~.ma a'pOjz 'ow.tra, u~ des'fi.li Di pe'so.as 'vej.u a'tE 'sew 'u~.ni.ku 'o.Lu e~.tre.a'bEX.tu, 'ko~.mu si es.Ti'vE.se~j~ o'La~.du 'pa.ra 'de~.tru Di u~ bu'ra.ku 'fu~.du i es'ku.ru ki ko~'Ti~.Ja aw'gu~ te'zow.ru i~'kri.vew
Aquilo que viam parecia agradá-las tremendamente e elas foram espalhar a notícia.	a'ki.lu ki 'vi.a~w~ pa.re'si.a a.gra'da las tre~.me~.da~'me~.Ti i 'E.las 'fo.ra~w~ es.pa'Lar a no'Ti.sja
Alguns rostos Mack reconhecia, e os que não reconhecia, ele logo ficou sabendo, eram os de seus médicos e das enfermeiras.	aw'gu~s 'Ros.tus 'mE.ki Re.ko~.Je'si.a, i us ki 'na~w~ Re.ko~.Je'si.a, 'e.li 'lO.gu fi'kow sa'be~.du, 'E.ra~w~ us Di 'sews 'mE.Di.kuz i daz e~.feR'mej.ras
Dormia com frequência, mas parecia que cada vez que abria os olhos isso causava uma grande empolgação.	doR'mi.a ko~ fre'kwe~.sja, majs pa.re'si.a ki 'ka.da 'vejs ki a'bri.a uz 'O.Luz 'i.su kaw'za.va u~.ma 'gra~.Di e~.pow.ga'sa~w~
Esperem só até eu poder esticar a língua, pensava, aí, sim, todo mundo vai ficar realmente impressionado.	es'pE.re~j~ 'sO a'tE ew po'der es.Ti'kar a 'li~.gwa, pe~'sa.va, a'i, 'si~, 'to.du 'mu~.du 'vaj fi'ka.Re.aw'me~.Ti i~.pre.si.o~'na.du
Tudo parecia doer.	'tu.du pa.re'si.a do'eX
Todo o corpo reclamava quando um enfermeiro o virava para a fisioterapia e para impedir as escaras.	'to.du u 'koX.pu Re.kla~'ma.va 'kwa~.du u~ e~.feR'mej.ru u vi'ra.va 'pa.ra a fi.zi.o.te.ra'pi.a i 'pa.ra i~.pe'Dir az es'ka.ras
Aparentemente esse era um tratamento de rotina para pessoas que haviam ficado inconscientes por mais de um ou dois dias, mas saber disso não tornava a coisa mais suportável.	a.pa.re~.Ti~'me~.Ti 'e.si 'E.ra u~ tra.ta~'me~.tu Di Ro'Ti~.na 'pa.ra pe'so.as ki a'vi.a~w~ fi'ka.du i~.ko~.si'e~.Tis puR 'majs Di 'u~ ow 'dojs 'Di.as, majs sa'beR 'Di.su 'na~w~ toR'na.va a 'koj.za 'majs su.poX'ta.vew
No princípio, Mack não fazia ideia de onde estava nem de como havia chegado àquela situação.	nu pri~'si.pju, 'mE.ki 'na~w~ fa'zi.a i'dEj.a Di 'o~.Di es'ta.va ne~j~ Di 'ko~.mu a'vi.a Se'ga.du a'kE.la si.tu.a'sa~w~
Mal conseguia perceber quem era.	'maw ko~.se'gi.a peX.se'beX 'ke~j~ 'E.ra
Sentia-se grato pela morfina que tirava o excesso da dor.	se~'Ti.a si 'gra.tu 'pe.la moX'fi~.na ki Ti'ra.va u e'sE.su da 'doX
Nos dois dias seguintes sua mente foi clareando devagar e ele começou a recuperar a voz.	nus 'dojs 'Di.as se'gi~.Tis 'su.a 'me~.Ti 'foj kla.re'a~.du de.va'gar i 'e.li ko~.me'sow a Re.ku.pe'rar a 'vOjs
Num entra e sai constante, familiares e amigos vieram desejar uma recuperação rápida ou conseguir alguma informação que ninguém sabia dar.	nu~ 'e~.tra i 'saj ko~s'ta~.Ti, fa~.mi.li'a.riz i a~'mi.gus vi'E.ra~w~ de.ze'Zar u~.ma Re.ku.pe.ra'sa~w~ 'Ra.pi.da ow ko~.se'gir aw'gu~.ma i~.foR.ma'sa~w~ ki ni~'ge~j~ sa'bi.a 'daX
Josh e Kate estavam sempre ali, ocupando-se com o dever de casa, enquanto Mack cochilava ou respondia às perguntas que nos primeiros dias ele se fazia repetidamente.	'ZOS i 'kej.Ti es'ta.va~w~ 'se~.pri a'li, o.ku'pa~.du si ko~ u de'veR Di 'ka.za, e~'kwa~.tu 'mE.ki ko.Si'la.va ow Res.po~'Di.a as peR'gu~.tas ki nus pri~'mej.rus 'Di.az 'e.li si fa'zi.a Re.pe.Ti.da~'me~.Ti
Num determinado ponto, Mack por fim entendeu que ficara inconsciente durante quase quatro dias depois do acidente terrível em Joseph.	nu~ de.teR.mi~'na.du 'po~.tu, 'mE.ki puX 'fi~ e~.te~'dew ki fi'ka.ra i~.ko~.si'e~.Ti du'ra~.Ti 'kwa.zi 'kwa.tru 'Di.as de'pojs du a.si'de~.Ti te'Ri.vew e~j~ 'Zo.zef
Nan deixou claro que ele tinha de dar muitas explicações, mas por enquanto estava mais concentrada em sua recuperação do que na necessidade de respostas.	'na~ dej'Sow 'kla.ru ki 'e.li 'Ti~.Ja Di 'daR 'mu~j~.taz es.pli.ka'so~j~s, majs pur e~'kwa~.tu es'ta.va 'majs ko~.se~'tra.da e~j~ 'su.a Re.ku.pe.ra'sa~w~ du ki na ne.se.si'da.Di Di Res'pOs.tas
De qualquer forma, sua memória estava envolta numa névoa, e, mesmo que ele pudesse recordar alguns pedaços, não conseguia juntá-los de modo a fazer sentido.	Di kwaw'kEX 'fOR.ma, 'su.a me~'mO.rja es'ta.va e~'vOw.ta 'nu~.ma 'nE.vo.a, i, 'mez.mu ki 'e.li pu'dE.si Re.koR'dar aw'gu~s pe'da.sus, 'na~w~ ko~.se'gi.a Zu~'ta lus Di 'mO.du a fa'zeX se~'Ti.du
Lembrava-se vagamente de ter ido à cabana, mas depois disso as coisas ficavam turvas.	le~'bra.va si va.ga~'me~.Ti Di 'ter 'i.du a ka'ba~.na, majs de'pojs 'Di.su as 'koj.zas fi'ka.va~w~ 'tuR.vas
Nos sonhos, as imagens de Papai, Jesus, Missy brincando junto ao lago, Sophia na caverna e a luz e as cores do festival na campina voltavam como cacos de um espelho quebrado.	nus 'so~.Jus, az i~'ma.Ze~s Di pa'paj, Ze'zujs, 'mi.si bri~'ka~.du 'Zu~.tu aw 'la.gu, so'fi.a na ka'vER.na i a 'lujz i as 'ko.ris du fes.Ti'vaw na ka~'pi~.na vow'ta.va~w~ 'ko~.mu 'ka.kus Di u~ es'pe.Lu ke'bra.du
Cada uma era acompanhada por ondas de deleite e alegria, mas ele não sabia se eram reais ou uma alucinação provocada por colisões entre neurônios danificados e os remédios que percorriam suas veias.	'ka.da u~.ma 'E.ra a.ko~.pa~'Ja.da pur 'o~.das Di de'lej.Ti i a.le'gri.a, majz 'e.li 'na~w~ sa'bi.a si 'E.ra~w~ Re'ajz ow u~.ma a.lu.si~.na'sa~w~ pro.vo'ka.da puX ko.li'zo~j~z 'e~.tri new'ro~.njus da~.ni.fi'ka.duz i us Re~'mE.Djus ki peX.ko'Ri.a~w~ 'su.as 'vej.as
Na terceira tarde depois de ter recuperado a consciência acordou e encontrou Willie encarando-o, parecendo meio sem jeito.	na teX'sej.ra 'taR.Di de'pojs Di 'te.Re.ku.pe'ra.du a ko~.si'e~.sja a.koR'dow i e~.ko~'trow 'wi.li e~.ka'ra~.du u, pa.re'se~.du 'mej.u se~j~ 'Zej.tu
Seu idiota! resmungou Willie.	'sew i.Di'O.ta, Rez.mu~'gow 'wi.li
É um prazer vê-lo também, Willie, bocejou Mack.	E u~ pra'zeX 've lu ta~'be~j~, 'wi.li, bo.se'Zow 'mE.ki
Onde foi que você aprendeu a dirigir? interpelou Willie.	'o~.Di 'foj ki vo'se a.pre~'dew a Di.ri'ZiX, i~.teX.pe'low 'wi.li
Ah, já sei, é um garoto criado em fazenda que não se acostumou com cruzamentos.	'a, 'Za 'sej, E u~ ga'ro.tu kri'a.du e~j~ fa'ze~.da ki 'na~w~ si a.kos.tu~'mow ko~ kru.za~'me~.tus
Mack, pelo que ouvi dizer, você deveria ter sentido o bafo do outro cara a 1 quilômetro de distância.	'mE.ki, 'pe.lu ki ow'vi Di'zeX, vo'se de.ve'ri.a 'teX se~'Ti.du u 'ba.fu du 'ow.tru 'ka.ra a 'u~ ki'lo~.me.tru Di Dis'ta~.sja
Mack ficou deitado, olhando o amigo falar sem parar, tentando ouvir e compreender cada palavra, sem conseguir.	'mE.ki fi'kow dej'ta.du, o'La~.du u a~'mi.gu fa'laX se~j~ pa'raX, te~'ta~.du ow'vir i ko~.pre.e~'deX 'ka.da pa'la.vra, se~j~ ko~.se'giX
E agora, continuou Willie, Nan está furiosa e não quer falar comigo.	i a'gO.ra, ko~.Ti~.nu'ow 'wi.li, 'na~ es'ta fu.ri'O.za i 'na~w~ 'kEX fa'laX ko~'mi.gu
Ela me culpa por ter te emprestado o jipe e deixado você ir à cabana.	'E.la mi 'kuw.pa puX 'teX Ti e~.pres'ta.du u 'Zi.pi i dej'Sa.du vo'se 'ir a ka'ba~.na
Então por que eu fui à cabana? perguntou Mack, lutando para juntar os pensamentos.	e~'ta~w~ puX 'ke ew 'fuj a ka'ba~.na, peR.gu~'tow 'mE.ki, lu'ta~.du 'pa.ra Zu~'tar us pe~.sa~'me~.tus
Tudo está confuso.	'tu.du es'ta ko~'fu.zu
Willie gemeu suplicando.	'wi.li Ze~'mew su.pli'ka~.du
Você tem que contar a ela que eu tentei convencê-lo a não ir.	vo'se te~j~ ki ko~'tar a 'E.la ki ew te~'tej ko~.ve~'se lu a 'na~w~ 'iX
Você tentou?	vo'se te~'tow
Não faça isso comigo, Mack. Eu tentei convencer...	'na~w~ 'fa.sa 'i.su ko~'mi.gu, 'mE.ki, ew te~'tej ko~.ve~'seX
Mack sorria enquanto ouvia Willie reclamar.	'mE.ki so'Ri.a e~'kwa~.tu ow'vi.a 'wi.li Re.kla~'maX
Se as outras lembranças eram confusas, recordava-se com nitidez de quanto esse sujeito gostava dele e apreciava tê-lo por perto.	si az 'ow.tras le~'bra~.saz 'E.ra~w~ ko~'fu.zas, Re.koR'da.va si ko~ ni.Ti'dejz Di 'kwa~.tu 'e.si su'Zej.tu gos'ta.va 'de.li i a.pre.si'a.va 'te lu puX 'pEX.tu
De repente Mack se espantou ao perceber que Willie havia se inclinado e sussurrava.	Di Re'pe~.Ti 'mE.ki si es.pa~'tow aw peX.se'beX ki 'wi.li a'vi.a si i~.kli~'na.du i su.su'Ra.va
Sério, ele estava lá?	'sE.rju, 'e.li es'ta.va 'la
Willie olhou rapidamente ao redor para se certificar de que não havia ninguém escutando.	'wi.li o'Low Ra.pi.da~'me~.Ti aw Re'dOX 'pa.ra si seX.Ti.fi'kaR Di ki 'na~w~ a'vi.a ni~'ge~j~ es.ku'ta~.du
Quem? sussurrou Mack.	'ke~j~, su.su'Row 'mE.ki
E por que estamos falando baixo?	i puX 'ke es'ta~.mus fa'la~.du 'baj.Su
Você sabe, Deus, insistiu Willie.	vo'se 'sa.bi, 'dews, i~.sis'Tiw 'wi.li
Ele estava na cabana?	'e.li es'ta.va na ka'ba~.na
Mack achou divertido.	'mE.ki a'Sow Di.veX'Ti.du
Willie, ele respondeu, não é segredo.	'wi.li, 'e.li Res.po~'dew, 'na~w~ E se'gre.du
Deus está em toda parte.	'dewz es'ta e~j~ 'to.da 'paX.Ti
Então eu estive na cabana.	e~'ta~w~ ew es'Ti.vi na ka'ba~.na
Sei disso, gênio, reagiu Willie impetuosamente.	'sej 'Di.su, 'Ze~.nju, Re.a'Ziw 'wi.li i~.pe.tu.O.za~'me~.Ti
Não se lembra de nada?	'na~w~ si 'le~.bra Di 'na.da
Quer dizer, nem se lembra do bilhete?	'kER Di'zeX, ne~j~ si 'le~.bra du bi'Le.Ti
Você sabe: o que recebeu do Papai e que estava na sua caixa de correio quando você escorregou no gelo e bateu com a cabeça.	vo'se 'sa.bi, u ki Re.se'bew du pa'paj i ki es'ta.va na 'su.a 'kaj.Sa Di ko'Rej.u 'kwa~.du vo'se es.ko.Re'gow nu 'Ze.lu i ba'tew ko~ a ka'be.sa
Foi então que a história desconjuntada começou a se cristalizar na mente de Mack.	'foj e~'ta~w~ ki a is'tO.rja des.ko~.Zu~'ta.da ko~.me'sow a si kris.ta.li'zaR na 'me~.Ti Di 'mE.ki
Subitamente tudo fez sentido quando sua mente começou a ligar os pontos e preencher os detalhes: o bilhete, o jipe, a viagem a cabana e cada acontecimento daquele glorioso fim de semana.	su.bi.ta~'me~.Ti 'tu.du 'fejs se~'Ti.du 'kwa~.du 'su.a 'me~.Ti ko~.me'sow a li'gar us 'po~.tuz i pre.e~'Ser us de'ta.Lis, u bi'Le.Ti, u 'Zi.pi, a vi'a.Ze~j~ a ka'ba~.na i 'ka.da a.ko~.te.si~'me~.tu da'ke.li glo.ri'o.zu 'fi~ Di se~'ma~.na
As imagens e as lembranças começaram a jorrar de volta tão poderosamente que ele sentiu que elas seriam capazes de arrancá-lo da cama e levá-lo para fora deste mundo.	az i~'ma.Ze~z i as le~'bra~.sas ko~.me'sa.ra~w~ a Zo'RaR Di 'vOw.ta 'ta~w~ po.de.rO.za~'me~.Ti ki 'e.li se~'Tiw ki 'E.las se'ri.a~w~ ka'pa.zis Di a.Ra~'ka lu da 'ka~.ma i le'va lu 'pa.ra 'fO.ra 'des.Ti 'mu~.du
Enquanto se lembrava, começou a chorar.	e~'kwa~.tu si le~'bra.va, ko~.me'sow a So'raX
Mack, desculpe.	'mE.ki, des'kuw.pi
Agora Willie estava implorando.	a'gO.ra 'wi.li es'ta.va i~.plo'ra~.du
O que foi que eu disse?	u ki 'foj ki ew 'Di.si
Mack estendeu a mão e tocou o rosto do amigo.	'mE.ki es.te~'dew a 'ma~w~ i to'kow u 'Ros.tu du a~'mi.gu
Willie ficou imóvel, sem saber o que pensar ou dizer, com medo de ter forçado o amigo além do limite.	'wi.li fi'kow i~'mO.vew, se~j~ sa'ber u ki pe~'sar ow Di'zeX, ko~ 'me.du Di 'teX foX'sa.du u a~'mi.gu a'le~j~ du li~'mi.Ti
Por fim, perguntou:	puX 'fi~, peR.gu~'tow
Quer dizer que ele estava lá?	'kER Di'zeX ki 'e.li es'ta.va 'la
Deus estava lá?	'dewz es'ta.va 'la
E agora Mack ria e chorava.	i a'gO.ra 'mE.ki 'Ri.a i So'ra.va
Willie, ele estava lá! Ah, ele estava lá!	'wi.li, 'e.li es'ta.va 'la, 'a, 'e.li es'ta.va 'la
Espere até que eu lhe conte.	es'pE.ri a'tE ki ew Li 'ko~.Ti
Você nunca vai acreditar.	vo'se 'nu~.ka 'vaj a.kre.Di'taX
Cara, nem eu sei se acredito.	'ka.ra, ne~j~ ew 'sej si a.kre'Di.tu
Mack parou, perdido nas lembranças por um momento.	'mE.ki pa'row, peR'Di.du nas le~'bra~.sas pur u~ mo~'me~.tu
Ah, é, falou finalmente.	'a, E, fa'low fi~.naw'me~.Ti
Ele me mandou lhe dizer uma coisa.	'e.li mi ma~'dow Li Di'zer u~.ma 'koj.za
A mim?	a 'mi~
Mack ficou olhando enquanto a preocupação e a dúvida se estampavam no rosto de Willie.	'mE.ki fi'kow o'La~.du e~'kwa~.tu a prew.ku.pa'sa~w~ i a 'du.vi.da si es.ta~'pa.va~w~ nu 'Ros.tu Di 'wi.li
Então, o que ele disse?	e~'ta~w~, u ki 'e.li 'Di.si
Mack parou, procurando as palavras.	'mE.ki pa'row, pro.ku'ra~.du as pa'la.vras
Ele falou: Diga ao Willie que gosto especialmente dele.	'e.li fa'low, 'Di.ga aw 'wi.li ki 'gOs.tu es.pe.si.aw'me~.Ti 'de.li
Mack viu o rosto e o maxilar do amigo ficarem tensos e poças de lágrimas encherem seus olhos.	'mE.ki 'viw u 'Ros.tu i u mak.si'laR du a~'mi.gu fi'ka.re~j~ 'te~.suz i 'po.sas Di 'la.gri~.maz e~'Se.re~j~ 'sewz 'O.Lus
Os lábios e o queixo de Willie tremeram e Mack soube que o amigo estava se esforçando para manter o controle.	us 'la.bjuz i u 'kej.Su Di 'wi.li tre~'me.ra~w~ i 'mE.ki 'sow.bi ki u a~'mi.gu es'ta.va si es.foX'sa~.du 'pa.ra ma~'ter u ko~'tro.li
Preciso ir, sussurrou Willie, rouco.	pre'si.zu 'iX, su.su'Row 'wi.li, 'Row.ku
Você terá de me contar isso mais tarde.	vo'se te'ra Di mi ko~'tar 'i.su 'majs 'taR.Di
Virou-se e saiu do quarto, deixando Mack as voltas com seus pensamentos e lembranças.	vi'row si i sa'iw du 'kwaX.tu, dej'Sa~.du 'mE.ki as 'vOw.tas ko~ 'sews pe~.sa~'me~.tuz i le~'bra~.sas
Quando Nan chegou, encontrou Mack sentado e rindo.	'kwa~.du 'na~ Se'gow, e~.ko~'trow 'mE.ki se~'ta.du i 'Ri~.du
Como ele não sabia por onde começar, deixou que a mulher falasse primeiro.	'ko~.mu 'e.li 'na~w~ sa'bi.a pur 'o~.Di ko~.me'saX, dej'Sow ki a mu'LEX fa'la.si pri~'mej.ru
Ela o colocou a par de alguns detalhes do acidente.	'E.la u ko.lo'kow a 'paR Di aw'gu~s de'ta.Lis du a.si'de~.Ti
Ele quase fora morto por um motorista bêbado e havia passado por cirurgias de emergência para reparar vários ossos quebrados e ferimentos internos.	'e.li 'kwa.zi 'fo.ra 'moX.tu pur u~ mo.to'ris.ta 'be.ba.du i a'vi.a pa'sa.du puX si.ruR'Zi.as Di e~.meR'Ze~.sja 'pa.ra Re.pa'raR 'va.rjuz 'O.sus ke'bra.duz i fe.ri~'me~.tuz i~'tER.nus
Seu estado era grave e, por isso, o seu despertar aliviara a preocupação.	'sew es'ta.du 'E.ra 'gra.vi i, pur 'i.su, u 'sew des.peX'tar a.li.vi'a.ra a prew.ku.pa'sa~w~
Enquanto ela falava, Mack pensou que era realmente estranho sofrer um acidente logo depois de passar um fim de semana com Deus.	e~'kwa~.tu 'E.la fa'la.va, 'mE.ki pe~'sow ki 'E.ra Re.aw'me~.Ti es'tra~.Ju so'frer u~ a.si'de~.Ti 'lO.gu de'pojs Di pa'sar u~ 'fi~ Di se~'ma~.na ko~ 'dews
O aparente caos aleatório da vida.	u a.pa're~.Ti 'kawz a.le.a'tO.rju da 'vi.da
Não era assim que Papai tinha dito?	'na~w~ 'E.ra a'si~ ki pa'paj 'Ti~.Ja 'Di.tu
Então ouviu Nan dizer que o acidente havia acontecido na noite de sexta-feira.	e~'ta~w~ ow'viw 'na~ Di'zeX ki u a.si'de~.Ti a'vi.a a.ko~.te'si.du na 'noj.Ti Di 'ses.ta 'fej.ra
Não foi no domingo? perguntou.	'na~w~ 'foj nu do~'mi~.gu, peR.gu~'tow
Claro que não!	'kla.ru ki 'na~w~
Foi na noite de sexta-feira que trouxeram você pra cá de helicóptero.	'foj na 'noj.Ti Di 'ses.ta 'fej.ra ki trow'sE.ra~w~ vo'se pra 'ka Di e.li'kOp.te.ru
As palavras dela o confundiram e por um momento ele se perguntou se os acontecimentos na cabana teriam sido apenas um sonho.	as pa'la.vras 'dE.la u ko~.fu~'Di.ra~w~ i pur u~ mo~'me~.tu 'e.li si peR.gu~'tow si uz a.ko~.te.si~'me~.tus na ka'ba~.na te'ri.a~w~ 'si.du a'pe~.naz u~ 'so~.Ju
Talvez fosse um daqueles deslocamentos temporais de Sarayu, pensou.	taw'vejs 'fo.si u~ da'ke.lis dez.lo.ka~'me~.tus te~.po'rajs Di sa.ra'ju, pe~'sow
Quando Nan terminou de narrar os acontecimentos, Mack começou a contar tudo o que lhe havia acontecido.	'kwa~.du 'na~ teR.mi~'now Di na'Rar uz a.ko~.te.si~'me~.tus, 'mE.ki ko~.me'sow a ko~'taX 'tu.du u ki Li a'vi.a a.ko~.te'si.du
Mas primeiro pediu perdão, confessando como e por que mentira.	majs pri~'mej.ru pe'Diw peR'da~w~, ko~.fe'sa~.du 'ko~.mu i puX 'ke me~'Ti.ra
Perplexa, Nan pensou que se tratava dos efeitos do trauma e da morfina.	peX'plEk.sa, 'na~ pe~'sow ki si tra'ta.va duz e'fej.tus du 'traw~.ma i da moX'fi~.na
Algumas vezes os remédios o dominavam e ele caía num sono sem sonhos, no meio de uma frase.	aw'gu~.mas 've.ziz us Re~'mE.Djuz u do~.mi~'na.va~w~ i 'e.li ka'i.a nu~ 'so~.nu se~j~ 'so~.Jus, nu 'mej.u Di u~.ma 'fra.zi
Inicialmente Nan ouviu com paciência e atenção, tentando suspender ao máximo o julgamento, pensando que a narrativa dele pudesse ser consequência de algum dano neurológico.	i~.ni.si.aw'me~.Ti 'na~ ow'viw ko~ pa.si'e~.sja i a.te~'sa~w~, te~'ta~.du sus.pe~'der aw 'ma.si~.mu u Zuw.ga~'me~.tu, pe~'sa~.du ki a na.Ra'Ti.va 'de.li pu'dE.si 'seX ko~.se'kwe~.sja Di aw'gu~ 'da~.nu new.ro'lO.Zi.ku
Mas a nitidez e a profundidade das lembranças a tocaram e lentamente foram solapando sua dúvida.	majz a ni.Ti'dejz i a pro.fu~.Di'da.Di das le~'bra~.saz a to'ka.ra~w~ i le~.ta~'me~.Ti 'fo.ra~w~ so.la'pa~.du 'su.a 'du.vi.da
Era intensamente vivo o que Mack estava contando e ela entendeu rapidamente e que o que quer que tivesse acontecido causara um enorme impacto e transformara seu marido.	'E.ra i~.te~.sa~'me~.Ti 'vi.vu u ki 'mE.ki es'ta.va ko~'ta~.du i 'E.la e~.te~'dew Ra.pi.da~'me~.Ti i ki u ki 'kEX ki Ti'vE.si a.ko~.te'si.du kaw'za.ra u~ e~'nOR.mi i~'pak.tu i tra~s.foR'ma.ra 'sew ma'ri.du
O ceticismo de Nan foi cedendo e finalmente ela concordou em terem uma conversa com Kate.	u se.Ti'siz.mu Di 'na~ 'foj se'de~.du i fi~.naw'me~.Ti 'E.la ko~.koR'dow e~j~ 'te.re~j~ u~.ma ko~'vEX.sa ko~ 'kej.Ti
Mack não quis dizer o motivo, o que a deixou nervosa, mas decidiu confiar nele.	'mE.ki 'na~w~ 'kis Di'zer u mo'Ti.vu, u ki a dej'Sow neR'vO.za, majs de.si'Diw ko~.fi'aR 'ne.li
Chamaram a filha e mandaram Josh se ocupar com alguma coisa deixando os três sozinhos.	Sa~'ma.ra~w~ a 'fi.La i ma~'da.ra~w~ 'ZOS si o.ku'paX ko~ aw'gu~.ma 'koj.za dej'Sa~.du us 'trejs sO'zi~.Jus
Mack estendeu a mão e Kate segurou-a.	'mE.ki es.te~'dew a 'ma~w~ i 'kej.Ti se.gu'row a
Kate, ele começou, com a voz ainda um pouco fraca e áspera.	'kej.Ti, 'e.li ko~.me'sow, ko~ a 'vOjz a'i~.da u~ 'pow.ku 'fra.ka i 'as.pe.ra
Quero que você saiba que eu a amo de todo o coração.	'kE.ru ki vo'se 'saj.ba ki ew a 'a~.mu Di 'to.du u ko.ra'sa~w~
Eu amo você também, papai.	ew 'a~.mu vo'se ta~'be~j~, pa'paj
vê lo naquele estado a havia suavizado um pouco.	've lu na'ke.li es'ta.du a a'vi.a su.a.vi'za.du u~ 'pow.ku
Ele sorriu, depois ficou sério de novo, ainda segurando a mão da filha.	'e.li so'Riw, de'pojs fi'kow 'sE.rju Di 'no.vu, a'i~.da se.gu'ra~.du a 'ma~w~ da 'fi.La
Quero falar com você sobre Missy.	'kE.ru fa'laX ko~ vo'se 'so.bri 'mi.si
Kate deu um repelão para trás, como se tivesse sido picada por uma abelha, e seu rosto ficou sombrio.	'kej.Ti 'dew u~ Re.pe'la~w~ 'pa.ra 'trajs, 'ko~.mu si Ti'vE.si 'si.du pi'ka.da pur u~.ma a'be.La, i 'sew 'Ros.tu fi'kow so~'bri.u
Instintivamente tentou puxar a mão, mas Mack a segurou, o que exigiu um esforço considerável.	i~s.Ti~.Ti.va~'me~.Ti te~'tow pu'Sar a 'ma~w~, majs 'mE.ki a se.gu'row, u ki e.zi'Ziw u~ es'foX.su ko~.si.de'ra.vew
Ela olhou ao redor.	'E.la o'Low aw Re'dOX
Nan se aproximou e a envolveu com o braço.	'na~ si a.pro.si~'mow i a e~.vow'vew ko~ u 'bra.su
Kate tremia.	'kej.Ti tre~'mi.a
Por quê? perguntou num sussurro.	puX 'ke, peR.gu~'tow nu~ su'su.Ru
Katie, não foi sua culpa.	'kej.Ti, 'na~w~ 'foj 'su.a 'kuw.pa
Agora ela hesitou, quase como se tivesse sido apanhada num segredo.	a'gO.ra 'E.la e.zi'tow, 'kwa.zi 'ko~.mu si Ti'vE.si 'si.du a.pa~'Ja.da nu~ se'gre.du
O que não foi minha culpa?	u ki 'na~w~ 'foj 'mi~.Ja 'kuw.pa
De novo ele precisou esforçar-se para falar, mas ela ouviu com clareza.	Di 'no.vu 'e.li pre.si'zow es.foX'saX si 'pa.ra fa'laX, majz 'E.la ow'viw ko~ kla're.za
Termos perdido Missy.	'teR.mus peR'Di.du 'mi.si
Lágrimas rolaram pelo rosto de Mack enquanto ele lutava com essas palavras simples.	'la.gri~.mas Ro'la.ra~w~ 'pe.lu 'Ros.tu Di 'mE.ki e~'kwa~.tu 'e.li lu'ta.va ko~ 'E.sas pa'la.vras 'si~.plis
De novo Kate se encolheu, dando-lhe as costas.	Di 'no.vu 'kej.Ti si e~.ko'Lew, 'da~.du Li as 'kOs.tas
Querida, ninguém culpa você pelo que aconteceu.	ke'ri.da, ni~'ge~j~ 'kuw.pa vo'se 'pe.lu ki a.ko~.te'sew
O silêncio dela durou apenas alguns segundos mais, antes que a represa transbordasse.	u si'le~.sju 'dE.la du'row a'pe~.naz aw'gu~s se'gu~.dus 'majs, 'a~.Tis ki a Re'pre.za tra~z.boR'da.si
Mas se eu não fosse descuidada na canoa você não teria que...	majs si ew 'na~w~ 'fo.si des.kuj'da.da na ka~'no.a vo'se 'na~w~ te'ri.a ki
Sua voz saiu pesada de acusações.	'su.a 'vOjs sa'iw pe'za.da Di a.ku.za'so~j~s
Mack a interrompeu, pondo a mão em seu braço.	'mE.ki a i~.te.Ro~'pew, 'po~.du a 'ma~w~ e~j~ 'sew 'bra.su
É isso que estou tentando dizer, querida.	E 'i.su ki es'tow te~'ta~.du Di'zeX, ke'ri.da
Não foi sua culpa.	'na~w~ 'foj 'su.a 'kuw.pa
Kate soluçou enquanto as palavras do pai penetravam em seu coração devastado.	'kej.Ti so.lu'sow e~'kwa~.tu as pa'la.vras du 'paj pe~.ne'tra.va~w~ e~j~ 'sew ko.ra'sa~w~ de.vas'ta.du
Mas eu sempre achei que fosse minha culpa.	majz ew 'se~.pri a'Sej ki 'fo.si 'mi~.Ja 'kuw.pa
E achava que você e mamãe me culpavam, e eu não queria...	i a'Sa.va ki vo'se i ma~'ma~j~ mi kuw'pa.va~w~, i ew 'na~w~ ke'ri.a
Nenhum de nós queria que isso acontecesse, Kate.	ne~'Ju~ Di 'nOjs ke'ri.a ki 'i.su a.ko~.te'se.si, 'kej.Ti
Simplesmente aconteceu, e vamos aprender a conviver com isso.	si~.pliz'me~.Ti a.ko~.te'sew, i 'va~.muz a.pre~'der a ko~.vi'veX ko~ 'i.su
Mas vamos fazer isso juntos.	majs 'va~.mus fa'zer 'i.su 'Zu~.tus
Está bem?	es'ta 'be~j~
Kate não tinha ideia de como reagir.	'kej.Ti 'na~w~ 'Ti~.Ja i'dEj.a Di 'ko~.mu Re.a'ZiX
Dominada pela emoção e soluçando, soltou-se da mão do pai e saiu correndo do quarto.	do~.mi~'na.da 'pe.la e~.mo'sa~w~ i so.lu'sa~.du, sow'tow si da 'ma~w~ du 'paj i sa'iw ko'Re~.du du 'kwaX.tu
Nan, com lágrimas descendo pelo rosto, deu um olhar desamparado mas encorajador para Mack e saiu rapidamente atrás da filha.	'na~, ko~ 'la.gri~.mas de'se~.du 'pe.lu 'Ros.tu, 'dew u~ o'LaR de.za~.pa'ra.du majz e~.ko.ra.Za'doX 'pa.ra 'mE.ki i sa'iw Ra.pi.da~'me~.Ti a'trajs da 'fi.La
Na vez seguinte em que Mack despertou, Kate estava dormindo ao seu lado na cama, aninhada e segura.	na 'vejs se'gi~.Ti e~j~ ki 'mE.ki des.peX'tow, 'kej.Ti es'ta.va doR'mi~.du aw 'sew 'la.du na 'ka~.ma, a~.ni~'Ja.da i se'gu.ra
Era evidente que Nan pudera ajudá-la a superar parte da dor.	'E.ra e.vi'de~.Ti ki 'na~ pu'dE.ra a.Zu'da la a su.pe'raX 'paX.Ti da 'doX
Quando Nan percebeu que Mack abrira os olhos, aproximou-se em silêncio para não acordar a filha e beijou-o.	'kwa~.du 'na~ peX.se'bew ki 'mE.ki a'bri.ra uz 'O.Lus, a.pro.si~'mow si e~j~ si'le~.sju 'pa.ra 'na~w~ a.koR'dar a 'fi.La i bej'Zow u
Acredito em você, sussurrou e ele sorriu, surpreso ao se dar conta de como era importante ouvir isso.	a.kre'Di.tu e~j~ vo'se, su.su'Row i 'e.li so'Riw, suX'pre.zu aw si 'daX 'ko~.ta Di 'ko~.mu 'E.ra i~.poX'ta~.Ti ow'vir 'i.su
Provavelmente eram os remédios que o estavam deixando assim tão emotivo, ela pensou.	pro.va.vew'me~.Ti 'E.ra~w~ us Re~'mE.Djus ki u es'ta.va~w~ dej'Sa~.du a'si~ 'ta~w~ e~.mo'Ti.vu, 'E.la pe~'sow
Mack melhorou rapidamente nas semanas seguintes.	'mE.ki me.Lo'row Ra.pi.da~'me~.Ti nas se~'ma~.nas se'gi~.Tis
Menos de um mês depois de receber alta do hospital, ele e Nan ligaram para o recém-nomeado subxerife de Joseph, Tommy Dalton, para falar sobre a possibilidade de fazerem uma caminha outra vez na área atrás da cabana.	'me~.nus Di 'u~ 'mejs de'pojs Di Re.se'ber 'aw.ta du os.pi'taw, 'e.li i 'na~ li'ga.ra~w~ 'pa.ra u Re'se~j~ no~.me'a.du sub.Se'ri.fi Di 'Zo.zef, 'to~.mi 'daw.to~, 'pa.ra fa'laX 'so.bri a po.si.bi.li'da.Di Di fa'ze.re~j~ u~.ma ka~'mi~.Ja 'ow.tra 'vejz na 'a.rja a'trajs da ka'ba~.na
Como tudo havia revertido a desolação original, Mack começara a se perguntar se o corpo de Missy ainda estaria na caverna.	'ko~.mu 'tu.du a'vi.a Re.veX'Ti.du a de.zo.la'sa~w~ o.ri.Zi~'naw, 'mE.ki ko~.me'sa.ra a si peR.gu~'taX si u 'koX.pu Di 'mi.si a'i~.da es.ta'ri.a na ka'vER.na
Seria difícil explicar a polícia como sabia onde o corpo da filha estava escondido, mas Mack achava que o amigo lhe daria o benefício da dúvida e o ajudaria.	se'ri.a Di'fi.siw es.pli'kar a po'li.sja 'ko~.mu sa'bi.a 'o~.Di u 'koX.pu da 'fi.La es'ta.va es.ko~'Di.du, majs 'mE.ki a'Sa.va ki u a~'mi.gu Li da'ri.a u be~.ne'fi.sju da 'du.vi.da i u a.Zu.da'ri.a
Tommy foi realmente solícito.	'to~.mi 'foj Re.aw'me~.Ti so'li.si.tu
Mesmo depois de ouvir a história do fim de semana de Mack, que ele interpretou como sendo os sonhos e pesadelos de um pai sofredor, concordou em voltar a cabana.	'mez.mu de'pojs Di ow'vir a is'tO.rja du 'fi~ Di se~'ma~.na Di 'mE.ki, ki 'e.li i~.teX.pre'tow 'ko~.mu 'se~.du us 'so~.Juz i pe.za'de.lus Di u~ 'paj so.fre'doX, ko~.koR'dow e~j~ vow'tar a ka'ba~.na
Queria ver Mack, de qualquer modo.	ke'ri.a 'veR 'mE.ki, Di kwaw'kER 'mO.du
Itens pessoais haviam sido salvos dos destroços do jipe de Willie e devolvê-los era uma boa desculpa para passarem algum tempo juntos.	'i.te~s pe.so'ajz a'vi.a~w~ 'si.du 'saw.vus dus des'trO.sus du 'Zi.pi Di 'wi.li i de.vow've lus 'E.ra u~.ma 'bo.a des'kuw.pa 'pa.ra pa'sa.re~j~ aw'gu~ 'te~.pu 'Zu~.tus
Assim, numa manhã límpida de sábado, no início de novembro, Willie acompanhou Mack e Nan até Joseph.	a'si~, 'nu~.ma ma~'Ja~ 'li~.pi.da Di 'sa.ba.du, nu i~'ni.sju Di no've~.bru, 'wi.li a.ko~.pa~'Jow 'mE.ki i 'na~ a'tE 'Zo.zef
Lá encontraram Tommy e os quatro se dirigiram para a Reserva.	'la e~.ko~'tra.ra~w~ 'to~.mi i us 'kwa.tru si Di.ri'Zi.ra~w~ 'pa.ra a Re'zER.va
Tommy ficou surpreso ao ver Mack passar direto pela cabana e ir até uma árvore perto do início de uma trilha.	'to~.mi fi'kow suX'pre.zu aw 'veR 'mE.ki pa'saR Di'rE.tu 'pe.la ka'ba~.na i 'ir a'tE u~.ma 'aR.vo.ri 'pEX.tu du i~'ni.sju Di u~.ma 'tri.La
Tal como explicara aos outros na vinda, Mack encontrou um arco vermelho na base da árvore.	'taw 'ko~.mu es.pli'ka.ra awz 'ow.trus na 'vi~.da, 'mE.ki e~.ko~'trow u~ 'aX.ku veR'me.Lu na 'ba.zi da 'aR.vo.ri
Ainda mancando ligeiramente, guiou-os numa caminhada de duas horas pelo terreno ermo.	a'i~.da ma~'ka~.du li.Zej.ra~'me~.Ti, gi'ow us 'nu~.ma ka~.mi~'Ja.da Di 'du.az 'O.ras 'pe.lu te'Re~.nu 'eR.mu
Nan ficou em absoluto silêncio, mas seu rosto revelava claramente a intensidade das emoções com as quais batalhava.	'na~ fi'kow e~j~ ab.so'lu.tu si'le~.sju, majs 'sew 'Ros.tu Re.ve'la.va kla.ra~'me~.Ti a i~.te~.si'da.Di daz e~.mo'so~j~s ko~ as 'kwajs ba.ta'La.va
No caminho continuaram encontrando o mesmo arco vermelho marcado em árvores e pedras.	nu ka~'mi~.Ju ko~.Ti~.nu'a.ra~w~ e~.ko~'tra~.du u 'mez.mu 'aX.ku veR'me.Lu maX'ka.du e~j~ 'aR.vo.riz i 'pE.dras
Quando chegaram a uma vasta área de pedregulhos, sem hesitar Mack entrou diretamente no labirinto de paredes rochosas.	'kwa~.du Se'ga.ra~w~ a u~.ma 'vas.ta 'a.rja Di pe.dre'gu.Lus, se~j~ e.zi'taR 'mE.ki e~'trow Di.rE.ta~'me~.Ti nu la.bi'ri~.tu Di pa're.Dis Ro'SO.zas
Provavelmente nunca teriam encontrado o lugar exato se não fosse por Papai.	pro.va.vew'me~.Ti 'nu~.ka te'ri.a~w~ e~.ko~'tra.du u lu'gar e'za.tu si 'na~w~ 'fo.si puX pa'paj
No topo de uma pilha de rochas diante da caverna estava a pedra com a marca vermelha voltada para fora.	nu 'to.pu Di u~.ma 'pi.La Di 'RO.Sas Di'a~.Ti da ka'vER.na es'ta.va a 'pE.dra ko~ a 'maX.ka veR'me.La vow'ta.da 'pa.ra 'fO.ra
A percepcão de que aquilo era obra de Papai levou Mack a quase rir alto.	a peX.sep'ka~w~ Di ki a'ki.lu 'E.ra 'O.bra Di pa'paj le'vow 'mE.ki a 'kwa.zi 'Rir 'aw.tu
Mas encontraram e, quando ficou convencido do que estavam abrindo, Tommy fez com que parassem.	majz e~.ko~'tra.ra~w~ i, 'kwa~.du fi'kow ko~.ve~'si.du du ki es'ta.va~w~ a'bri~.du, 'to~.mi 'fejs ko~ ki pa'ra.se~j~
Mack entendeu a importância do procedimento e, embora um tanto de má vontade, concordou que deveriam lacrar de novo a caverna para protegê-la.	'mE.ki e~.te~'dew a i~.poX'ta~.sja du pro.se.Di~'me~.tu i, e~'bO.ra u~ 'ta~.tu Di 'ma vo~'ta.Di, ko~.koR'dow ki de.ve'ri.a~w~ la'kraR Di 'no.vu a ka'vER.na 'pa.ra pro.te'Ze la
Retornariam a Joseph, onde Tommy poderia notificar os peritos legistas e as agências policiais adequadas.	Re.toR.na'ri.a~w~ a 'Zo.zef, 'o~.Di 'to~.mi po.de'ri.a no.Ti.fi'kar us pe'ri.tus le'Zis.taz i az a'Ze~.sjas po.li.si'ajz a.de'kwa.das
Durante a descida, Tommy ouviu novamente a história de Mack, dessa vez com uma nova percepção.	du'ra~.Ti a de'si.da, 'to~.mi ow'viw nO.va~'me~.Ti a is'tO.rja Di 'mE.ki, 'dE.sa 'vejs ko~ u~.ma 'nO.va peX.sep'sa~w~
Também aproveitou para orientar o amigo sobre o melhor modo de enfrentar os interrogatórios que logo viriam.	ta~'be~j~ a.pro.vej'tow 'pa.ra o.ri.e~'tar u a~'mi.gu 'so.bri u me'LOR 'mO.du Di e~.fre~'tar uz i~.te.Ro.ga'tO.rjus ki 'lO.gu vi'ri.a~w~
No dia seguinte os peritos recuperaram os restos de Missy e guardaram o pano junto com tudo que puderam encontrar.	nu 'Di.a se'gi~.Ti us pe'ri.tus Re.ku.pe'ra.ra~w~ us 'REs.tus Di 'mi.si i gwaR'da.ra~w~ u 'pa~.nu 'Zu~.tu ko~ 'tu.du ki pu'dE.ra~w~ e~.ko~'traX
Depois disso foram necessárias apenas algumas semanas até obterem provas para rastrear e prender o Matador de Meninas.	de'pojs 'Di.su 'fo.ra~w~ ne.se'sa.rjaz a'pe~.naz aw'gu~.mas se~'ma~.naz a'tE ob'te.re~j~ prO'vajs 'pa.ra Ras.tre'ar i pre~'der u ma.ta'doR Di me~'ni~.nas
A partir das pistas que o homem deixara para poder encontrar a caverna de Missy, as autoridades localizaram e recuperaram os corpos das outras meninas assassinadas.	a paX'TiR das 'pis.tas ki u 'o~.me~j~ dej'Sa.ra 'pa.ra po'der e~.ko~'trar a ka'vER.na Di 'mi.si, az aw.to.ri'da.Dis lo.ka.li'za.ra~w~ i Re.ku.pe'ra.ra~w~ us 'kOX.pus daz 'ow.tras me~'ni~.naz a.sa.si~'na.das
Bom, aí está.	'bo~, a'i es'ta
Pelo menos como me foi contado.	'pe.lu 'me~.nus 'ko~.mu mi 'foj ko~'ta.du
Tenho certeza de que algumas pessoas se perguntarão se a história de Mack aconteceu de verdade ou se o acidente e a morfina simplesmente o deixaram meio confuso.	'te~.Ju seX'te.za Di ki aw'gu~.mas pe'so.as si peR.gu~.ta'ra~w~ si a is'tO.rja Di 'mE.ki a.ko~.te'sew Di veR'da.Di ow si u a.si'de~.Ti i a moX'fi~.na si~.pliz'me~.Ti u dej'Sa.ra~w~ 'mej.u ko~'fu.zu
Mack continua levando sua vida normal e produtiva e teima em garantir que cada palavra da história é verdadeira.	'mE.ki ko~.Ti~'nu.a le'va~.du 'su.a 'vi.da noR'maw i pro.du'Ti.va i 'tej.ma e~j~ ga.ra~'TiX ki 'ka.da pa'la.vra da is'tO.rja E veR.da'dej.ra
A Grande Tristeza se foi e ele passa a maior parte dos dias com um profundo sentimento de alegria.	a 'gra~.Di tris'te.za si 'foj i 'e.li 'pa.sa a maj'OX 'paX.Ti dus 'Di.as ko~ u~ pro'fu~.du se~.Ti~'me~.tu Di a.le'gri.a
Assim, a questão que eu me coloco enquanto redijo este texto é: como terminar uma história destas?	a'si~, a kes'ta~w~ ki ew mi ko'lO.ku e~'kwa~.tu Re'Di.Zu 'es.Ti 'tes.tu E, 'ko~.mu teR.mi~'nar u~.ma is'tO.rja 'dEs.tas
Talvez eu possa fazer isso falando um pouco das transformações que ela causou em mim.	taw'vejz ew 'pO.sa fa'zer 'i.su fa'la~.du u~ 'pow.ku das tra~s.foR.ma'so~j~s ki 'E.la kaw'zow e~j~ 'mi~
Como declarei no Prefácio, a história de Mack me mudou.	'ko~.mu de.kla'rej nu pre'fa.sju, a is'tO.rja Di 'mE.ki mi mu'dow
Não creio que haja algum aspecto da minha vida, sobretudo de meus relacionamentos, que não tenha sido profundamente tocado e alterado de modo importante.	'na~w~ 'krej.u ki 'a.Za aw'gu~ as'pEk.tu da 'mi~.Ja 'vi.da, so.bre'tu.du Di 'mews Re.la.si.o~.na~'me~.tus, ki 'na~w~ 'te~.Ja 'si.du pro.fu~.da~'me~.Ti to'ka.du i aw.te'ra.du Di 'mO.du i~.poX'ta~.Ti
Se eu acho que é verdade?	si ew 'a.Su ki E veR'da.Di
Quero que tudo seja verdade.	'kE.ru ki 'tu.du 'se.Za veR'da.Di
Talvez alguma parte não seja verdadeira num determinado sentido, mas ainda assim é verdade.	taw'vejz aw'gu~.ma 'paX.Ti 'na~w~ 'se.Za veR.da'dej.ra nu~ de.teR.mi~'na.du se~'Ti.du, majz a'i~.da a'si~ E veR'da.Di
Você sabe o que quero dizer.	vo'se 'sa.bi u ki 'kE.ru Di'zeX
Acho que Sarayu vai ajudá-lo a entender.	'a.Su ki sa.ra'ju 'vaj a.Zu'da lu a e~.te~'deX
E Mack?	i 'mE.ki
Noto que ele ama mais e melhor do que a maioria das pessoas, é rápido em perdoar e ainda mais rápido em pedir perdão.	'nO.tu ki 'e.li 'a~.ma 'majz i me'LOR du ki a maj.o'ri.a das pe'so.as, E 'Ra.pi.du e~j~ peR.do'ar i a'i~.da 'majs 'Ra.pi.du e~j~ pe'DiX peR'da~w~
As transformações que ele sofreu provocaram na família e nos amigos efeitos que nem sempre foram fáceis de entender.	as tra~s.foR.ma'so~j~s ki 'e.li so'frew pro.vo'ka.ra~w~ na fa~'mi.lja i nuz a~'mi.guz e'fej.tus ki ne~j~ 'se~.pri 'fo.ra~w~ 'fa.sejs Di e~.te~'deX
Mas devo lhe dizer que nunca conheci outro adulto que leve a vida com tanta simplicidade e alegria.	majs 'de.vu Li Di'zeX ki 'nu~.ka ko~.Je'si 'ow.tru a'duw.tu ki 'lE.vi a 'vi.da ko~ 'ta~.ta si~.pli.si'da.Di i a.le'gri.a
De algum modo, ele virou criança de novo.	Di aw'gu~ 'mO.du, 'e.li vi'row kri'a~.sa Di 'no.vu
Ou, para explicar melhor, ele virou a criança que nunca teve permissão de ser.	ow, 'pa.ra es.pli'kaR me'LOX, 'e.li vi'row a kri'a~.sa ki 'nu~.ka 'te.vi peR.mi'sa~w~ Di 'seX
Uma pessoa confiante e cheia de entusiasmo.	u~.ma pe'so.a ko~.fi'a~.Ti i 'Sej.a Di e~.tu.zi'az.mu
Ele consegue acolher até mesmo os tons mais escuros da vida, vendo-os como parte de uma tapeçaria incrivelmente rica e profunda, tecida magistralmente por invisíveis mãos de amor.	'e.li ko~'sE.gi a.ko'Ler a'tE 'mez.mu us 'to~s 'majz es'ku.rus da 'vi.da, 've~.du us 'ko~.mu 'paX.Ti Di u~.ma ta.pe.sa'ri.a i~.kri.vew'me~.Ti 'Ri.ka i pro'fu~.da, te'si.da ma.Zis.traw'me~.Ti pur i~.vi'zi.vejs 'ma~w~s Di a~'moX
Enquanto escrevo isto, Mack está sendo testemunha no julgamento do Matador de Meninas.	e~'kwa~.tu es'kre.vu 'is.tu, 'mE.ki es'ta 'se~.du tes.te~'mu~.Ja nu Zuw.ga~'me~.tu du ma.ta'doR Di me~'ni~.nas
Ele quer fazer uma visita ao acusado, mas ainda não teve permissão.	'e.li 'kEX fa'zer u~.ma vi'zi.ta aw a.ku'za.du, majz a'i~.da 'na~w~ 'te.vi peR.mi'sa~w~
Porém está determinado a vê-lo, mesmo que isso só aconteça depois do veredicto.	po're~j~ es'ta de.teR.mi~'na.du a 've lu, 'mez.mu ki 'i.su 'sO a.ko~'te.sa de'pojs du ve.re'Dik.tu
Se você tiver chance de passar um tempo com Mack, logo vai perceber que ele está esperando uma nova revolução, uma revolução de amor e gentileza, uma revolução provocada por Jesus, pelo que ele fez por nós e continua a fazer em um mundo que tem fome de reconciliação e de um local que possa chamar de lar.	si vo'se Ti'vEX 'Sa~.si Di pa'sar u~ 'te~.pu ko~ 'mE.ki, 'lO.gu 'vaj peX.se'beX ki 'e.li es'ta es.pe'ra~.du u~.ma 'nO.va Re.vo.lu'sa~w~, u~.ma Re.vo.lu'sa~w~ Di a~'mor i Ze~.Ti'le.za, u~.ma Re.vo.lu'sa~w~ pro.vo'ka.da puR Ze'zujs, 'pe.lu ki 'e.li 'fejs puR 'nOjz i ko~.Ti~'nu.a a fa'zer e~j~ u~ 'mu~.du ki te~j~ 'fo~.mi Di Re.ko~.si.li.a'sa~w~ i Di u~ lo'kaw ki 'pO.sa Sa~'maR Di 'laX
Não é uma revolução que pretenda derrubar nada, ou, se derrubar, fará isso de um modo que jamais poderemos imaginar antecipadamente.	'na~w~ E u~.ma Re.vo.lu'sa~w~ ki pre'te~.da de.Ru'baR 'na.da, ow, si de.Ru'baX, fa'ra 'i.su Di u~ 'mO.du ki Za~'majs po.de're~.muz i~.ma.Zi~'nar a~.te.si.pa.da~'me~.Ti
Ah, uma última coisa.	'a, u~.ma 'uw.Ti~.ma 'koj.za
Estou convencido de que Mack e Nan ainda vão lá algumas vezes, a cabana, só para ficarem à sós.	es'tow ko~.ve~'si.du Di ki 'mE.ki i 'na~ a'i~.da 'va~w~ 'la aw'gu~.mas 've.zis, a ka'ba~.na, 'sO 'pa.ra fi'ka.re~j~ a 'sOjs
A Terra repleta de céu,	a 'tE.Ra Re'plE.ta Di 'sEw
E cada arburto comum incendiado com Deus,	i 'ka.da aR'buX.tu ko~'mu~ i~.se~.Di'a.du ko~ 'dews
Mas só aquele que vê tira os sapatos;	majs 'sO a'ke.li ki 've 'Ti.ra us sa'pa.tus
Os outros se sentam ao redor e colhem amoras.	uz 'ow.trus si 'se~.ta~w~ aw Re'dOr i 'kO.Le~j~ a~'mO.ras
Sobre o Autor de A Cabana	'so.bri u aw'toR Di a ka'ba~.na
Pagou seus estudos religiosos trabalhando como Dee Jay, salva-vidas e em diversos outros empregos temporários.	pa'gow 'sewz es'tu.dus Re.li.Zi'O.zus tra.ba'La~.du 'ko~.mu 'Di 'Dej, 'saw.va 'vi.daz i e~j~ Di'vEX.suz 'ow.truz e~'pre.gus te~.po'ra.rjus
Formou-se em religião no Oregon, Estados Unidos.	foR'mow si e~j~ Re.li.Zi'a~w~ nu 'O.re.go~, es'ta.duz u~'ni.dus
Durante quase dois dias, amarrado ao grande carvalho nos fundos da casa, ele foi castigado com um cinto e com versículos da Bíblia todas as vezes que o pai acordava de sua bebedeira e largava a garrafa.	du'ra~.Ti 'kwa.zi 'dojs 'Di.as, a~.ma'Ra.du aw 'gra~.Di kaR'va.Lu nus 'fu~.dus da 'ka.za, 'e.li 'foj kas.Ti'ga.du ko~ u~ 'si~.tu i ko~ veX'si.ku.lus da 'bi.blja 'to.daz as 've.zis ki u 'paj a.koR'da.va Di 'su.a be.be'dej.ra i laR'ga.va a ga'Ra.fa
Quando fala, dá a impressão de ser uma espécie de alienígena que vê a paisagem das idéias e experiências humanas de modo diferente de todas as outras pessoas.	'kwa~.du 'fa.la, 'da a i~.pre'sa~w~ Di 'ser u~.ma es'pE.si Di a.li.e~'ni.Ze~.na ki 've a paj'za.Ze~j~ daz i'dEj.az i es.pe.ri'e~.sjaz u~'ma~.nas Di 'mO.du Di.fe're~.Ti Di 'to.daz az 'ow.tras pe'so.as
E isso fez toda a diferença cada noite e cada dia.	i 'i.su 'fejs 'to.da a Di.fe're~.sa 'ka.da 'noj.Ti i 'ka.da 'Di.a
Na sexta de manhã, depois de um último sermão de Nan para os filhos sobre segurança, obediência, escovar os dentes de manhã, não pegar gatos com listras brancas nas costas e todo tipo de outras coisas, todos saíram: Nan para o norte e Mack e os três mosqueteiros para o leste.	na 'ses.ta Di ma~'Ja~, de'pojs Di u~ 'uw.Ti~.mu seR'ma~w~ Di 'na~ 'pa.ra us 'fi.Lus 'so.bri se.gu'ra~.sa, o.be.Di'e~.sja, es.ko'var us 'de~.Tis Di ma~'Ja~, 'na~w~ pe'gaR 'ga.tus ko~ 'lis.tras 'bra~.kas nas 'kOs.taz i 'to.du 'Ti.pu Di 'ow.tras 'koj.zas, 'to.dus sa'i.ra~w~, 'na~ 'pa.ra u 'nOX.Ti i 'mE.ki i us 'trejs mos.ke'tej.rus 'pa.ra u 'lEs.Ti
Uma dúzia de jovens, todas filhas dos vários chefes, foram trazidas diante do Conselho.	u~.ma 'du.zja Di 'ZO.ve~s, 'to.das 'fi.Las dus 'va.rju'SE.fis, 'fo.ra~w~ tra'zi.das Di'a~.Ti du ko~'se.Lu
Demorou toda a noite e todo o dia seguinte para chegar ao local indicado na lenda, um penhasco altíssimo acima do Grande Rio e das terras mais além.	de~.mo'row 'to.da a 'noj.Ti i 'to.du u 'Di.a se'gi~.Ti 'pa.ra Se'gar aw lo'kaw i~.Di'ka.du na 'le~.da, u~ pe~'Jas.ku aw'Ti.si~.mu a'si~.ma du 'gra~.Di 'Ri.u i das 'tE.Ras 'majz a'le~j~
Jesus escolheu morrer porque ele e o pai amavam muito você, eu e todas as pessoas.	Ze'zujz es.ko'Lew mo'ReX puX'ke 'e.li i u 'paj a~'ma.va~w~ 'mu~j~.tu vo'se, ew i 'to.daz as pe'so.as
O domingo nasceu radioso e todo o grupo se empolgou com a idéia de pegar o teleférico do lago Wallowa até o topo do monte Howard, 2484 metros acima do nível do mar.	u do~'mi~.gu na'sew Ra.Di'o.zu i 'to.du u 'gru.pu si e~.pow'gow ko~ a i'dEj.a Di pe'gar u te.le'fE.ri.ku du 'la.gu 'wa.lo.wa a'tE u 'to.pu du 'mo~.Ti 'Raw.aR.Di, 'dojz 'miw kwa.tro'se~.tuz i oj'te~.ta i 'kwa.tru 'mE.truz a'si~.ma du 'ni.vew du 'maX
Jesse e Sarah convidaram todos para almoçar em um restaurante no topo da montanha.	'ZE.si i 'sa.ra ko~.vi'da.ra~w~ 'to.dus 'pa.ra aw.mo'sar e~j~ u~ Res.taw'ra~.Ti nu 'to.pu da mo~'ta~.Ja
No fim da tarde estavam todos cansados e felizes.	nu 'fi~ da 'taR.Di es'ta.va~w~ 'to.dus ka~'sa.duz i fe'li.zis
Para alegria de Kate, ela e Emmy haviam surpreendido Josh e Amber de mãos dadas no escuro e queriam que todos soubessem.	'pa.ra a.le'gri.a Di 'kej.Ti, 'E.la i 'e~.mi a'vi.a~w~ suX.pre.e~'Di.du 'ZOS i a~'beR Di 'ma~w~s 'da.das nu es'ku.ru i ke'ri.a~w~ ki 'to.dus sow'bE.se~j~
Apesar de toda a agitação, a água continuava razoavelmente límpida.	a.pe'zaR Di 'to.da a a.Zi.ta'sa~w~, a 'a.gwa ko~.Ti~.nu'a.va Ra.zo.a.vew'me~.Ti 'li~.pi.da
Mack veio à superfície, gritou para Kate nadar até a margem, sugou todo o ar que pôde e mergulhou pela segunda vez.	'mE.ki 'vej.u a su.peX'fi.si, gri'tow 'pa.ra 'kej.Ti na'dar a'tE a 'maR.Ze~j~, su'gow 'to.du u 'aX ki 'po.Di i meR.gu'Low 'pe.la se'gu~.da 'vejs
Dominado pelo alívio e pela descarga de adrenalina resultante do esforço, começou a chorar e, de repente, Kate estava soluçando com os braços em volta de seu pescoço, enquanto todos riam, choravam e se abraçavam.	do~.mi~'na.du 'pe.lu a'li.vju i 'pe.la des'kaR.ga Di a.dre~.na'li~.na Re.zuw'ta~.Ti du es'foX.su, ko~.me'sow a So'rar i, Di Re'pe~.Ti, 'kej.Ti es'ta.va so.lu'sa~.du ko~ us 'bra.suz e~j~ 'vOw.ta Di 'sew pes'ko.su, e~'kwa~.tu 'to.dus 'Ri.a~w~, So'ra.va~w~ i si a.bra'sa.va~w~
Mack o abraçou e disse quase gritando em seu ouvido: Pare com isso! Não foi culpa sua e estão todos bem.	'mE.ki u a.bra'sow i 'Di.si 'kwa.zi gri'ta~.du e~j~ 'sew ow'vi.du, 'pa.ri ko~ 'i.su, 'na~w~ 'foj 'kuw.pa 'su.a i es'ta~w~ 'to.dus 'be~j~
A notícia do resgate na água havia chegado à pequena sede e todos se mostravam animados.	a no'Ti.sja du Rez'ga.Ti na 'a.gwa a'vi.a Se'ga.du a pe'ke~.na 'sE.Di i 'to.dus si mos'tra.va~w~ a~.ni~'ma.dus
Isolaram o acampamento dos Phillips com fitas, caracterizando-o como uma cena de crime, e todos nas imediações foram interrogados.	i.zo'la.ra~w~ u a.ka~.pa~'me~.tu dus 'fi.lips ko~ 'fi.tas, ka.rak.te.ri'za~.du u 'ko~.mu u~.ma 'se~.na Di 'kri~.mi, i 'to.dus naz i~.me.Di.a'so~j~s 'fo.ra~w~ i~.te.Ro'ga.dus
Acreditamos que ele seja responsável pelo sequestro e morte de pelo menos quatro crianças até agora, todas meninas, todas com menos de 10 anos.	a.kre.Di'ta~.mus ki 'e.li 'se.Za Res.po~'sa.vew 'pe.lu se'kwEs.tru i 'mOX.Ti Di 'pe.lu 'me~.nus 'kwa.tru kri'a~.saz a'tE a'gO.ra, 'to.das me~'ni~.nas, 'to.das ko~ 'me~.nus Di 'dEjz 'a~.nus
Ele sempre deixa os broches em algum lugar da área do sequestro, todos têm o mesmo número de modelo, mas não conseguimos descobrir de onde eles vieram originalmente nem encontrar o corpo de nenhuma das quatro meninas, mas temos bons motivos para acreditar que nenhuma delas sobreviveu.	'e.li 'se~.pri 'dej.Sa us 'brO.Siz e~j~ aw'gu~ lu'gaR da 'a.rja du se'kwEs.tru, 'to.dus 'te~j~ u 'mez.mu 'nu~.me.ru Di mo'de.lu, majs 'na~w~ ko~.se'gi~.mus des.ko'briR Di 'o~.Di 'e.lis vi'E.ra~w~ o.ri.Zi~.naw'me~.Ti ne~j~ e~.ko~'trar u 'koX.pu Di ne~'Ju~.ma das 'kwa.tru me~'ni~.nas, majs 'te~.mus 'bo~s mo'Ti.vus 'pa.ra a.kre.Di'taX ki ne~'Ju~.ma 'dE.las so.bre.vi'vew
Sobrepunha-se a todas a imagem tão recente de Missy caindo no sono, aninhada no colo do pai.	so.bre'pu~.Ja si a 'to.daz a i~'ma.Ze~j~ 'ta~w~ Re'se~.Ti Di 'mi.si ka'i~.du nu 'so~.nu, a~.ni~'Ja.da nu 'kO.lu du 'paj
Em meio a toda a tristeza, Kate manteve-se firme, enviando e recebendo e-mails para que se mantivessem em comunicação permanente.	e~j~ 'mej.u a 'to.da a tris'te.za, 'kej.Ti ma~'te.vi si 'fiR.mi, e~.vi'a~.du i Re.se'be~.du i 'maj.ws 'pa.ra ki si ma~.Ti'vE.se~j~ e~j~ ko~.mu~.ni.ka'sa~w~ peR.ma~'ne~.Ti
Ao meio-dia todas as famílias estavam na estrada.	aw 'mej.u 'Di.a 'to.daz as fa~'mi.ljaz es'ta.va~w~ na es'tra.da
Ela permitiu que ele participasse de todas as providências e informes.	'E.la peR.mi'Tiw ki 'e.li paX.Ti.si'pa.si Di 'to.daz as pro.vi'de~.sjaz i i~'fOR.mis
Estamos vivendo uma turbulência, estabelecendo comunicações com todas as agências policiais envolvidas na tentativa de resgatar Missy.	es'ta~.mus vi've~.du u~.ma tuR.bu'le~.sja, es.ta.be.le'se~.du ko~.mu~.ni.ka'so~j~s ko~ 'to.daz az a'Ze~.sjas po.li.si'ajz e~.vow'vi.das na te~.ta'Ti.va Di Rez.ga'taR 'mi.si
Não, ele parece escolher as vítimas ao acaso, mas todas eram mais menos da idade da sua filha, com cor de cabelo semelhante.	'na~w~, 'e.li pa'rE.si es.ko'Ler as 'vi.Ti~.maz aw a'ka.zu, majs 'to.daz 'E.ra~w~ 'majs 'me~.nus da i'da.Di da 'su.a 'fi.La, ko~ 'koR Di ka'be.lu se~.me'La~.Ti
Depois de um tempo que pareceu excessivamente longo para Mack, todos concordaram em dar início à perseguição.	de'pojs Di u~ 'te~.pu ki pa.re'sew e.se.si.va~'me~.Ti 'lo~.gu 'pa.ra 'mE.ki, 'to.dus ko~.koR'da.ra~w~ e~j~ 'dar i~'ni.sju a peX.se.gi'sa~w~
Ainda que todos tivessem sido profundamente golpeados pela tragédia, Kate parecia a mais afetada, escondendo-se numa casca como uma tartaruga para se proteger de algo potencialmente perigoso.	a'i~.da ki 'to.dus Ti'vE.se~j~ 'si.du pro.fu~.da~'me~.Ti gow.pe'a.dus 'pe.la tra'ZE.Dja, 'kej.Ti pa.re'si.a a 'majz a.fe'ta.da, es.ko~'de~.du si 'nu~.ma 'kas.ka 'ko~.mu u~.ma taX.ta'ru.ga 'pa.ra si pro.te'ZeR Di 'aw.gu po.te~.si.aw'me~.Ti pe.ri'go.zu
Provavelmente ele iria precisar de todas as orações que conseguisse.	pro.va.vew'me~.Ti 'e.li i'ri.a pre.si'zaR Di 'to.daz az o.ra'so~j~s ki ko~.se'gi.si
Em poucos segundos aquela mulher havia rompido praticamente todas as convenções sociais atrás das quais ele se entrincheirava com tanta segurança.	e~j~ 'pow.kus se'gu~.duz a'kE.la mu'LEr a'vi.a Ro~'pi.du pra.Ti.ka~'me~.Ti 'to.daz as ko~.ve~'so~j~s so.si'ajz a'trajs das 'kwajz 'e.li si e~.tri~.Sej'ra.va ko~ 'ta~.ta se.gu'ra~.sa
Reuniu todas as forças possíveis para evitar cair de volta no buraco negro das emoções.	Re.u~'niw 'to.daz as 'foX.sas po'si.vejs 'pa.ra e.vi'taX ka'iR Di 'vOw.ta nu bu'ra.ku 'ne.gru daz e~.mo'so~j~s
Antes que ele pudesse perguntar, ela sorriu e sussurrou: Mackenzie, todos temos coisas que valorizamos a ponto de colecionar, não é?	'a~.Tis ki 'e.li pu'dE.si peR.gu~'taX, 'E.la so'Riw i su.su'Row, ma'ke~.zi, 'to.dus 'te~.mus 'koj.zas ki va.lo.ri'za~.muz a 'po~.tu Di ko.le.si.o~'naX, 'na~w~ E
A emoção o varria, enquanto sua mente tentava em desespero acompanhar todas as informações.	a e~.mo'sa~w~ u va'Ri.a, e~'kwa~.tu 'su.a 'me~.Ti te~'ta.va e~j~ de.zes'pe.ru a.ko~.pa~'JaX 'to.daz az i~.foR.ma'so~j~s
Sentia-se subitamente sem palavras e todas as suas perguntas pareciam tê-lo abandonado.	se~'Ti.a si su.bi.ta~'me~.Ti se~j~ pa'la.vraz i 'to.daz as 'su.as peR'gu~.tas pa.re'si.a~w~ 'te lu a.ba~.do~'na.du
A palavra rolava na língua da mulher como o vinho mais doce e, apesar de toda a fúria que ainda rugia em sua mente, de algum modo ele acreditou na sinceridade dela.	a pa'la.vra Ro'la.va na 'li~.gwa da mu'LEX 'ko~.mu u 'vi~.Ju 'majs 'do.si i, a.pe'zaR Di 'to.da a 'fu.rja ki a'i~.da Ru'Zi.a e~j~ 'su.a 'me~.Ti, Di aw'gu~ 'mO.du 'e.li a.kre.Di'tow na si~.se.ri'da.Di 'dE.la
Acreditava, pelo menos no coração, que Deus era um Espírito, nem masculino nem feminino, mas, apesar disso, sentia-se embaraçado ao admitir que todas as suas concepções visuais de Deus eram muito brancas e muito masculinas.	a.kre.Di'ta.va, 'pe.lu 'me~.nus nu ko.ra'sa~w~, ki 'dewz 'E.ra u~ es'pi.ri.tu, ne~j~ mas.ku'li~.nu ne~j~ fe~.mi~'ni~.nu, majs, a.pe'zaR 'Di.su, se~'Ti.a si e~.ba.ra'sa.du aw a.Di~.mi'TiX ki 'to.daz as 'su.as ko~.sep'so~j~s vi.zu'ajs Di 'dewz 'E.ra~w~ 'mu~j~.tu 'bra~.kaz i 'mu~j~.tu mas.ku'li~.nas
Então todas essas coisas que você sente borbulhando por dentro vão começar a sair.	e~'ta~w~ 'to.daz 'E.sas 'koj.zas ki vo'se 'se~.Ti boR.bu'La~.du puR 'de~.tru 'va~w~ ko~.me'sar a sa'iX
Suas emoções e pensamentos estavam todos misturados.	'su.az e~.mo'so~j~z i pe~.sa~'me~.tuz es'ta.va~w~ 'to.dus mis.tu'ra.dus
O problema é que muitas pessoas tentam entender um pouco o que eu sou pensando no melhor que elas podem ser, projetando isso ao enésimo grau, multiplicando por toda a bondade que são capazes de perceber, que frequentemente não é muita, e depois chamam o resultado de Deus.	u pro'ble~.ma E ki 'mu~j~.tas pe'so.as 'te~.ta~w~ e~.te~'der u~ 'pow.ku u ki ew 'sow pe~'sa~.du nu me'LOX ki 'E.las 'pO.de~j~ 'seX, pro.Ze'ta~.du 'i.su aw e~'nE.zi~.mu 'graw, muw.Ti.pli'ka~.du puX 'to.da a bo~'da.Di ki 'sa~w~ ka'pa.zis Di peX.se'beX, ki fre.kwe~.Ti~'me~.Ti 'na~w~ E 'mu~j~.ta, i de'poj'Sa~.ma~w~ u Re.zuw'ta.du Di 'dews
Mas, em vez de varrer toda a Criação, arregaçamos as mangas e entramos no meio da bagunça.	majs, e~j~ 'vejz Di va'ReX 'to.da a kri.a'sa~w~, a.Re.ga'sa~.muz as 'ma~.gaz i e~'tra~.mus nu 'mej.u da ba'gu~.sa
Também optamos por abraçar todas as limitações que isso implicava.	ta~'be~j~ op'ta~.mus pur a.bra'saX 'to.daz as li~.mi.ta'so~j~s ki 'i.su i~.pli'ka.va
Percebeu que precisaria de um certo tempo para compreender todas aquelas informações.	peX.se'bew ki pre.si.za'ri.a Di u~ 'sEX.tu 'te~.pu 'pa.ra ko~.pre.e~'deX 'to.daz a'kE.laz i~.foR.ma'so~j~s
Mas que diferença faz o fato de haver três de vocês e que todos sejam um só Deus?	majs ki Di.fe're~.sa 'fajz u 'fa.tu Di a'veX 'trejs Di vo'sejz i ki 'to.dus 'se.Za~w~ 'u~ 'sO 'dews
Mackenzie, faz toda a diferença do mundo!	ma'ke~.zi, 'fajs 'to.da a Di.fe're~.sa du 'mu~.du
O hã que Mack estivera retendo veio finalmente à superfície com toda a força.	u 'a~ ki 'mE.ki es.Ti'vE.ra Re'te~.du 'vej.u fi~.naw'me~.Ti a su.peX'fi.si ko~ 'to.da a 'foX.sa
Jesus deixara cair uma grande tigela com algum tipo de massa ou molho no chão, e a coisa tinha se espalhado por toda parte.	Ze'zujs dej'Sa.ra ka'ir u~.ma 'gra~.Di Ti'ZE.la ko~ aw'gu~ 'Ti.pu Di 'ma.sa ow 'mo.Lu nu 'Sa~w~, i a 'koj.za 'Ti~.Ja si es.pa'La.du puX 'to.da 'paX.Ti
Finalmente Mack conseguiu dizer uma coisa que o incomodara durante toda a conversa.	fi~.naw'me~.Ti 'mE.ki ko~.se'giw Di'zer u~.ma 'koj.za ki u i~.ko~.mo'da.ra du'ra~.Ti 'to.da a ko~'vEX.sa
Ele sentia como se estivesse fazendo a pergunta em nome de toda a raça humana.	'e.li se~'Ti.a 'ko~.mu si es.Ti'vE.si fa'ze~.du a peR'gu~.ta e~j~ 'no~.mi Di 'to.da a 'Ra.sa u~'ma~.na
Deus, que é a base de todo o ser, mora dentro, em volta e através de todas as coisas, e emerge em última instância como o real.	'dews, ki E a 'ba.zi Di 'to.du u 'seX, 'mO.ra 'de~.tru, e~j~ 'vOw.ta i a.tra'vEjs Di 'to.daz as 'koj.zas, i e~'mER.Zi e~j~ 'uw.Ti~.ma i~s'ta~.sja 'ko~.mu u Re'aw
E temos toda a sua vida para respondê-las, riu Jesus.	i 'te~.mus 'to.da a 'su.a 'vi.da 'pa.ra Res.po~'de las, 'Riw Ze'zujs
Mack lutou com todas as forças para se soltar da lama e da água, mas foi sendo sugado para mais fundo.	'mE.ki lu'tow ko~ 'to.daz as 'foX.sas 'pa.ra si sow'taR da 'la~.ma i da 'a.gwa, majs 'foj 'se~.du su'ga.du 'pa.ra 'majs 'fu~.du
Ainda estava na cabana com aquelas três figuras interessantes e todas as três achavam que eram Deus.	a'i~.da es'ta.va na ka'ba~.na ko~ a'kE.las 'trejs fi'gu.raz i~.te.re'sa~.Tiz i 'to.daz as 'trejz a'Sa.va~w~ ki 'E.ra~w~ 'dews
Cockburn era o favorito de toda a família havia anos.	kO.ki'buR.ni 'E.ra u fa.vo'ri.tu Di 'to.da a fa~'mi.lja a'vi.a 'a~.nus
Como você pode dizer isso diante de toda a dor deste mundo, de todas as guerras e desastres que destroem milhares?	'ko~.mu vo'se 'pO.Di Di'zer 'i.su Di'a~.Ti Di 'to.da a 'doR 'des.Ti 'mu~.du, Di 'to.daz as 'gE.Raz i de'zas.tris ki des'trO.e~j~ mi'La.ris
Vejam o custo, toda a dor, todo o sofrimento, tudo que é tão terrível e mau.	've.Za~w~ u 'kus.tu, 'to.da a 'doX, 'to.du u so.fri~'me~.tu, 'tu.du ki E 'ta~w~ te'Ri.vew i 'maw
Vinte minutos depois, todas as plantas estavam cortadas junto às raízes e o terreno parecia uma ferida no jardim.	'vi~.Ti mi~'nu.tus de'pojs, 'to.daz as 'pla~.taz es'ta.va~w~ koX'ta.da'Zu~.tu as Ra'i.ziz i u te'Re~.nu pa.re'si.a u~.ma fe'ri.da nu ZaR'Di~
Escolheram o caminho devastado da independência e não compreendem que estão arrastando toda a Criação com vocês.	es.ko'Le.ra~w~ u ka~'mi~.Ju de.vas'ta.du da i~.de.pe~'de~.sja i 'na~w~ ko~.pre'e~.de~j~ ki es'ta~w~ a.Ras'ta~.du 'to.da a kri.a'sa~w~ ko~ vo'sejs
Para preparar este terreno, devemos arrancar as raízes de todas as plantas maravilhosas que estavam aqui.	'pa.ra pre.pa'rar 'es.Ti te'Re~.nu, de've~.muz a.Ra~'kar as Ra'i.zis Di 'to.daz as 'pla~.tas ma.ra.vi'LO.zas ki es'ta.va~w~ a'ki
O impacto das palavras de Sarayu quase fez desmoronar todas as reservas de Mack.	u i~'pak.tu das pa'la.vras Di sa.ra'ju 'kwa.zi 'fejz dez.mo.ro~'naX 'to.daz as Re'zER.vas Di 'mE.ki
Mas, quando Tyler chegou, foi como se trouxesse com ele um presente maravilhoso para mim, toda uma nova capacidade de amá-lo especialmente.	majs, 'kwa~.du 'taj.leX Se'gow, 'foj 'ko~.mu si trow'sE.si ko~ 'e.li u~ pre'ze~.Ti ma.ra.vi'Lo.zu 'pa.ra 'mi~, 'to.da u~.ma 'nO.va ka.pa.si'da.Di Di a~'ma lu es.pe.si.aw'me~.Ti
Bom, hoje você terá a oportunidade de colocar toda a sua capacidade em uso.	'bo~, 'o.Zi vo'se te'ra a o.poX.tu~.ni'da.Di Di ko.lo'kaX 'to.da a 'su.a ka.pa.si'da.Di e~j~ 'u.zu
Ele conhece todas as pessoas já concebidas e muito mais profunda e claramente do que você jamais conhecerá seus filhos.	'e.li ko~'JE.si 'to.daz as pe'so.a'Za ko~.se'bi.daz i 'mu~j~.tu 'majs pro'fu~.da i kla.ra~'me~.Ti du ki vo'se Za~'majs ko~.Je.se'ra 'sews 'fi.Lus
Se vocês precisam de alguém para torturar por toda a eternidade, eu vou no lugar deles. Pode ser?	si vo'sejs pre'si.za~w~ Di aw'ge~j~ 'pa.ra toX.tu'raX puX 'to.da a e.teR.ni'da.Di, ew 'vow nu lu'gaR 'de.lis, 'pO.Di 'seX
você preferiria que ele tivesse escolhido a justiça para todo mundo?	vo'se pre.fe.ri'ri.a ki 'e.li Ti'vE.si es.ko'Li.du a Zus'Ti.sa 'pa.ra 'to.du 'mu~.du
De súbito, sem aviso, a água veio rugindo de cima, bem à sua frente, e obliterou toda a visão e as vozes de seus filhos.	Di 'su.bi.tu, se~j~ a'vi.zu, a 'a.gwa 'vej.u Ru'Zi~.du Di 'si~.ma, 'be~j~ a 'su.a 'fre~.Ti, i o.bli.te'row 'to.da a vi'za~w~ i as 'vO.zis Di 'sews 'fi.Lus
Jesus parou um momento para captar toda a atenção de Mack.	Ze'zujs pa'row u~ mo~'me~.tu 'pa.ra kap'taX 'to.da a a.te~'sa~w~ Di 'mE.ki
Mas por que nós mantemos toda essa porcaria lá dentro?	majs puX 'ke 'nOjs ma~'te~.mus 'to.da 'E.sa poX.ka'ri.a 'la 'de~.tru
Não pense que todas aquelas outras ocasiões foram um desperdício.	'na~w~ 'pe~.si ki 'to.daz a'kE.laz 'ow.traz o.ka.zi'o~j~s 'fo.ra~w~ u~ des.peR'Di.sju
O que vejo são as pessoas e suas vidas, uma comunidade que vive e respira, feita de todos que me amam, e não de prédios, regras e programas.	u ki 've.Zu 'sa~w~ as pe'so.az i 'su.as 'vi.das, u~.ma ko~.mu~.ni'da.Di ki 'vi.vi i Res'pi.ra, 'fej.ta Di 'to.dus ki mi 'a~.ma~w~, i 'na~w~ Di 'prE.Djus, 'RE.graz i pro'gra~.mas
Isso significa que todas as estradas levam a você?	'i.su si.gi~.ni'fi.ka ki 'to.daz az es'tra.das 'lE.va~w~ a vo'se
Por isso ela foi capaz de entender o que Jesus fez por ela e por toda a raça humana.	pur 'i.su 'E.la 'foj ka'pajz Di e~.te~'der u ki Ze'zujs 'fejs pur 'E.la i puX 'to.da a 'Ra.sa u~'ma~.na
Depois de todas as coisas que eu senti em relação a você e de todas as acusações que fiz, por que você se incomodaria em vir ao meu encontro?	de'pojs Di 'to.daz as 'koj.zas ki ew se~'Ti e~j~ Re.la'sa~w~ a vo'se i Di 'to.daz az a.ku.za'so~j~s ki 'fis, puX 'ke vo'se si i~.ko~.mo.da'ri.a e~j~ 'vir aw 'mew e~'ko~.tru
Se fosse simples anular todas as escolhas de independência, o mundo que você conhece deixaria de existir e o amor não teria significado.	si 'fo.si 'si~.pliz a~.nu'laX 'to.daz az es'ko.Las Di i~.de.pe~'de~.sja, u 'mu~.du ki vo'se ko~'JE.si dej.Sa'ri.a Di e.zis'Tir i u a~'moR 'na~w~ te'ri.a si.gi~.ni.fi'ka.du
Agora ele toca todos que eu amo, os que me seguem e os que não me seguem.	a'gO.ra 'e.li 'tO.ka 'to.dus ki ew 'a~.mu, us ki mi 'sE.ge~j~ i us ki 'na~w~ mi 'sE.ge~j~
Além disso, interrompeu ela, não se esqueça de que no meio de toda a sua dor e da sua mágoa você está rodeado por beleza, pela maravilha da Criação, pela arte, pela música, pela cultura, pelos sons de riso e amor, de esperanças sussurradas e de celebrações, de vida nova e de transformações, de reconciliação e perdão.	a'le~j~ 'Di.su, i~.te.Ro~'pew 'E.la, 'na~w~ si es'ke.sa Di ki nu 'mej.u Di 'to.da a 'su.a 'dor i da 'su.a 'ma.gwa vo'se es'ta Ro.de'a.du puR be'le.za, 'pe.la ma.ra'vi.La da kri.a'sa~w~, 'pe.la 'aX.Ti, 'pe.la 'mu.zi.ka, 'pe.la kuw'tu.ra, 'pe.lus 'so~s Di 'Ri.zu i a~'moX, Di es.pe'ra~.sas su.su'Ra.daz i Di se.le.bra'so~j~s, Di 'vi.da 'nO.va i Di tra~s.foR.ma'so~j~s, Di Re.ko~.si.li.a'sa~w~ i peR'da~w~
Essas coisas também são resultado de suas escolhas e toda escolha é importante, mesmo as ocultas.	'E.sas 'koj.zas ta~'be~j~ 'sa~w~ Re.zuw'ta.du Di 'su.az es'ko.Laz i 'to.da es'ko.La E i~.poX'ta~.Ti, 'mez.mu az o'kuw.tas
Todas as coisas devem se desdobrar, ainda que isso ponha todos os que eu amo no meio de um mundo de tragédias horríveis, mesmo os que são mais próximos de mim.	'to.daz as 'koj.zas 'dE.ve~j~ si dez.do'braX, a'i~.da ki 'i.su 'po~.Ja 'to.duz us ki ew 'a~.mu nu 'mej.u Di u~ 'mu~.du Di tra'ZE.Djaz o'Ri.vejs, 'mez.mu us ki 'sa~w~ 'majs 'prO.si~.mus Di 'mi~
Você sabe, todas as coisas que as Escrituras dizem que devemos fazer.	vo'se 'sa.bi, 'to.daz as 'koj.zas ki az es.kri'tu.ras 'Di.ze~j~ ki de've~.mus fa'zeX
Este fim de semana, compartilhando a vida com vocês, foi muito mais esclarecedor do que todas aquelas respostas.	'es.Ti 'fi~ Di se~'ma~.na, ko~.paX.Ti'La~.du a 'vi.da ko~ vo'sejs, 'foj 'mu~j~.tu 'majz es.kla.re.se'doR du ki 'to.daz a'kE.las Res'pOs.tas
De qualquer modo, todos nós gostamos de cozinhar, acrescentou Jesus.	Di kwaw'kER 'mO.du, 'to.dus 'nOjs gos'ta~.mus Di ko.zi~'JaX, a.kre.se~'tow Ze'zujs
Por isso Jesus realizou todas elas por vocês, para que elas não tivessem mais poder sobre vocês.	pur 'i.su Ze'zujs Re.a.li'zow 'to.daz 'E.las puR vo'sejs, 'pa.ra ki 'E.las 'na~w~ Ti'vE.se~j~ 'majs po'deX 'so.bri vo'sejs
Quero você inteiro e todas as partes de você e de seu dia.	'kE.ru vo'se i~'tej.ru i 'to.daz as 'paX.Tis Di vo'se i Di 'sew 'Di.a
Miríades de pequenas criaturas saltavam e voavam por toda parte, cada uma em sua própria glória.	mi'ri.a.Dis Di pe'ke~.nas kri.a'tu.ras saw'ta.va~w~ i vo'a.va~w~ puX 'to.da 'paX.Ti, 'ka.da u~.ma e~j~ 'su.a 'prO.prja 'glO.rja
Seguiu pelo caminho que se abriu à sua frente até chegar ao centro, o centro de toda a Criação, o homem que é Deus e o Deus que é homem.	se'giw 'pe.lu ka~'mi~.Ju ki si a'briw a 'su.a 'fre~.Ti a'tE Se'gar aw 'se~.tru, u 'se~.tru Di 'to.da a kri.a'sa~w~, u 'o~.me~j~ ki E 'dewz i u 'dews ki E 'o~.me~j~
Por um segundo acho que vou compreender, mas depois toda a dor da perda parece crescer e me dizer que o que eu compreendi simplesmente não pode ser verdade.	pur u~ se'gu~.du 'a.Su ki 'vow ko~.pre.e~'deX, majs de'pojs 'to.da a 'doR da 'peR.da pa'rE.si kre'ser i mi Di'zeX ki u ki ew ko~.pre.e~'Di si~.pliz'me~.Ti 'na~w~ 'pO.Di 'seR veR'da.Di
Chorou até ter derramado toda a escuridão, todo o anseio e a perda, até não restar nada.	So'row a'tE 'teR de.Ra~'ma.du 'to.da a es.ku.ri'da~w~, 'to.du u a~'sej.u i a 'peR.da, a'tE 'na~w~ Res'taR 'na.da
Odeio todas essas lágrimas, esse negócio de ficar chorando como um idiota, ele gemeu.	o'dej.u 'to.daz 'E.sas 'la.gri~.mas, 'e.si ne'gO.sju Di fi'kaX So'ra~.du 'ko~.mu u~ i.Di'O.ta, 'e.li Ze~'mew
O pano por baixo do corpo de Missy era frágil, mas Mack conseguiu levantá-la e colocá-la no meio de todas as flores e especiarias.	u 'pa~.nu puR 'baj.Su du 'koX.pu Di 'mi.si 'E.ra 'fra.Ziw, majs 'mE.ki ko~.se'giw le.va~'ta la i ko.lo'ka la nu 'mej.u Di 'to.daz as 'flo.riz i es.pe.si.a'ri.as
Bom, ele é um ser humano que continua passando por um processo de mudança, como todos nós.	'bo~, 'e.li E u~ 'ser u~'ma~.nu ki ko~.Ti~'nu.a pa'sa~.du pur u~ pro'sE.su Di mu'da~.sa, 'ko~.mu 'to.dus 'nOjs
Serão os poderes silenciosos e cotidianos de morrer, servir, amar e rir, de ternura simples e gentileza gratuita, porque, se alguma coisa importa, todas as coisas importam.	se'ra~w~ us po'de.ris si.le~.si'O.zuz i ko.Ti.Di'a~.nus Di mo'ReX, seR'viX, a~'mar i 'RiX, Di teR'nu.ra 'si~.pliz i Ze~.Ti'le.za gra'tuj~.ta, puX'ke, si aw'gu~.ma 'koj.za i~'pOX.ta, 'to.daz as 'koj.zaz i~'pOX.ta~w~
E um dia, quando tudo for revelado, cada um de nós ficará de joelhos e confessará, por obra e graça de Sarayu, que Jesus e o Senhor de toda a Criação, para a glória de Papai.	i u~ 'Di.a, 'kwa~.du 'tu.du 'fo.Re.ve'la.du, 'ka.da 'u~ Di 'nOjs fi.ka'ra Di Zu'e.Luz i ko~.fe.sa'ra, pur 'O.bra i 'gra.sa Di sa.ra'ju, ki Ze'zujz i u se~'JoR Di 'to.da a kri.a'sa~w~, 'pa.ra a 'glO.rja Di pa'paj
Passei a vida tentando corrigir os erros que cometi na minha ânsia de acertar.	pa'sej a 'vi.da te~'ta~.du ko.Ri'Zir uz 'e.Rus ki ko~.me'Ti na 'mi~.Ja 'a~.sja Di a.seX'taX
O erro que começou há mil anos é tão errado como o que começa hoje, e o acerto que surge hoje é tão certo como se tivesse a sanção de séculos.	u 'e.Ru ki ko~.me'sow 'a 'miw 'a~.nuz E 'ta~w~ e'Ra.du 'ko~.mu u ki ko~'mE.sa 'o.Zi, i u a'seX.tu ki 'suR.Zi 'o.Zi E 'ta~w~ 'sEX.tu 'ko~.mu si Ti'vE.si a sa~'sa~w~ Di 'sE.ku.lus
A sabedoria não vem do acerto, mas do aprendizado com os erros.	a sa.be.do'ri.a 'na~w~ 've~j~ du a'seX.tu, majs du a.pre~.Di'za.du ko~ uz 'e.Rus
Tem uma coisa que muito me entristece. Quando eu acerto ninguem vê e quando erro ninguem esquece!	te~j~ u~.ma 'koj.za ki 'mu~j~.tu mi e~.tris'tE.si, 'kwa~.du ew a'sEX.tu ni~'ge~j~ 've i 'kwa~.du 'E.Ru ni~'ge~j~ es'kE.si
E você foi o acerto na minha hora incerta de me apaixonar.	i vo'se 'foj u a'seX.tu na 'mi~.Ja 'O.ra i~'sEX.ta Di mi a.paj.So~'naX
Bem-aventurado aquele que já consegue receber com a mesma naturalidade o ganho e a perda, o acerto e o erro, o triunfo e a queda, a vida e a morte.	'be~j~ a.ve~.tu'ra.du a'ke.li ki 'Za ko~'sE.gi Re.se'beX ko~ a 'mez.ma na.tu.ra.li'da.Di u 'ga~.Ju i a 'peR.da, u a'seX.tu i u 'e.Ru, u tri'u~.fu i a 'kE.da, a 'vi.da i a 'mOX.Ti
Não pensa mais nada! No final dá tudo certo de algum jeito Eu me acerto, eu tropeço e não passo do chão Pode ir que eu aguento! Eu suporto a colisão Da verdade, na contramão...	'na~w~ 'pe~.sa 'majs 'na.da, nu fi~'naw 'da 'tu.du 'sEX.tu Di aw'gu~ 'Zej.tu ew mi a'sEX.tu, ew tro'pE.su i 'na~w~ 'pa.su du 'Sa~w~ 'pO.Di 'iX ki ew a'gwe~.tu, ew su'pOX.tu a ko.li'za~w~ da veR'da.Di, na ko~.tra~'ma~w~
Sou um ser humano forte nas tentativas de acerto, mas frágil na aceitação dos meus erros. Porém, continuo lutando para ser cada dia melhor.	'sow u~ 'ser u~'ma~.nu 'fOX.Ti nas te~.ta'Ti.vas Di a'seX.tu, majs 'fra.Ziw na a.sej.ta'sa~w~ dus 'mewz 'e.Rus, po're~j~, ko~.Ti~'nu.u lu'ta~.du 'pa.ra 'seX 'ka.da 'Di.a me'LOX
O fruto de qualquer situação sendo erro ou acerto, é fruto. De aprendizado ou de consequência; para o aprendizado - uma vida toda, para consequência - também.	u 'fru.tu Di kwaw'kEX si.tu.a'sa~w~ 'se~.du 'e.Ru ow a'seX.tu, E 'fru.tu, Di a.pre~.Di'za.du ow Di ko~.se'kwe~.sja, 'pa.ra u a.pre~.Di'za.du, u~.ma 'vi.da 'to.da, 'pa.ra ko~.se'kwe~.sja, ta~'be~j~
Bêbado   Quando a terra parar de girar eu acerto os meus passos.	'be.ba.du 'kwa~.du a 'tE.Ra pa'raR Di Zi'rar ew a'sEX.tu us 'mews 'pa.sus
Primeiro: Eu sou humano; sofro, erro, rio, acerto! Segundo: Eu sou eu; e como SINGULAR, tenho uma personalidade PRÓPRIA.	pri~'mej.ru, ew 'sow u~'ma~.nu, 'so.fru, 'E.Ru, 'Ri.u, a'sEX.tu, se'gu~.du, ew 'sow ew, i 'ko~.mu si~.gu'laX, 'te~.Ju u~.ma peX.so~.na.li'da.Di 'prO.prja
Quando você erra e admite pode estar fazendo desse erro um acerto, mas se mentir para remediar certamente estará duplicando ele. E é aí que estará verdadeiramente errando!	'kwa~.du vo'se 'E.Ra i a.Di~'mi.Ti 'pO.Di es'taX fa'ze~.du 'de.si 'e.Ru u~ a'seX.tu, majs si me~'TiX 'pa.ra Re~.me.Di'aX sEX.ta~'me~.Ti es.ta'ra du.pli'ka~.du 'e.li, i E a'i ki es.ta'ra veR.da.dej.ra~'me~.Ti e'Ra~.du
Teu troféu foi tua pior vitória. Teu erro foi meu maior acerto. Tua partida foi o melhor que você já fez por nós. Nosso fim, meu recomeço.	'tew tro'fEw 'foj 'tu.a pi'OR vi'tO.rja, 'tew 'e.Ru 'foj 'mew maj'Or a'seX.tu, 'tu.a paX'Ti.da 'foj u me'LOX ki vo'se 'Za 'fejs puR 'nOjs, 'nO.su 'fi~, 'mew Re.ko~'me.su
buscando um novo rumo, sem fazer resumo não me acostumo, de vez enquando sumo, pra ver se acerto, sozinho no deserto	bus'ka~.du u~ 'no.vu 'Ru~.mu, se~j~ fa'ze.Re'zu~.mu 'na~w~ mi a.kos'tu~.mu, Di 'vejz e~'kwa~.du 'su~.mu, pra 'veX si a'sEX.tu, sO'zi~.Ju nu de'zEX.tu
O gol em uma partida é um ponto de análise, pois ele surge de um acerto ou de um erro.	u 'gow e~j~ u~.ma paX'Ti.da E u~ 'po~.tu Di a~'na.li.zi, 'pojz 'e.li 'suR.Zi Di u~ a'seX.tu ow Di u~ 'e.Ru
Me deixe, me esquece e me erra. Que eu me acho, me revivo e me acerto. Simples assim. Flávia Abib	mi 'dej.Si, mi es'kE.si i mi 'E.Ra, ki ew mi 'a.Su, mi Re'vi.vu i mi a'sEX.tu, 'si~.pliz a'si~, 'fla.vja a'bi.bi
Não tenha medo de errar, o acerto faz você parar, e o erro é o aprendizado que faz você continuar tentando	'na~w~ 'te~.Ja 'me.du Di e'RaX, u a'seX.tu 'fajz vo'se pa'raX, i u 'e.Ru E u a.pre~.Di'za.du ki 'fajz vo'se ko~.Ti~.nu'aX te~'ta~.du
Perto de Deus aprendi que acerto quando deixo minhas vontades, pra ganhar o que o céu guardou pra mim.	'pEX.tu Di 'dewz a.pre~'Di ki a'sEX.tu 'kwa~.du 'dej.Su 'mi~.Jas vo~'ta.Dis, pra ga~'Jar u ki u 'sEw gwaR'dow pra 'mi~
Se procura defeitos em mim. Com certeza vai encontrar. Afinal sou imperfeita, e não consigo só acertar. Eu erro de tantas formas, do levantar até o deitar	si pro'ku.ra de'fej.tuz e~j~ 'mi~, ko~ seX'te.za 'vaj e~.ko~'trar a.fi~'naw, 'sow i~.peX'fej.ta, i 'na~w~ ko~'si.gu 'sO a.seX'tar, ew 'E.Ru Di 'ta~.tas 'fOR.mas, du le.va~'tar a'tE u dej'taX
A lei do retorno é uma espécie de dívida imprescritível, que mais cedo ou mais tarde todos irão ao encontro do chamado acerto de contas.	a 'lej du Re'toR.nu E u~.ma es'pE.si Di 'Di.vi.da i~.pres.kri'Ti.vew, ki 'majs 'se.du ow 'majs 'taR.Di 'to.duz i'ra~w~ aw e~'ko~.tru du Sa~'ma.du a'seX.tu Di 'ko~.tas
O bom da vida é que ela dá voltas, nos permitindo reviver os acertos e corrigir os erros.	u 'bo~ da 'vi.da E ki 'E.la 'da 'vOw.tas, nus peR.mi'Ti~.du Re.vi'ver uz a'sEX.tuz i ko.Ri'Zir uz 'e.Rus
Muitas das vezes nós erramos, quando na verdade deveríamos acertarmos!	'mu~j~.tas das 've.zis 'nOjz e'Ra~.mus, 'kwa~.du na veR'da.Di de.ve'ri.a~.muz a.seX'taR.mus
Erramos para acertar e acertamos errando.	e'Ra~.mus 'pa.ra a.seX'tar i a.seX'ta~.muz e'Ra~.du
Amar não tava nos meus planos Não tava procurando, mas eu encontrei Agora tô aqui falando Foi o erro mais lindo que eu acertei	a~'maR 'na~w~ 'ta.va nus 'mews 'pla~.nus 'na~w~ 'ta.va pro.ku'ra~.du, majz ew e~.ko~'trej a'gO.ra 'to a'ki fa'la~.du 'foj u 'e.Ru 'majs 'li~.du ki ew a.seX'tej
E são nas tentativas que se acha o acerto.	i 'sa~w~ nas te~.ta'Ti.vas ki si 'a.Sa u a'seX.tu
Um acerto não substitui um erro, a verdade não apaga a mentira, o perdão não cura a ferida	u~ a'seX.tu 'na~w~ subs.Ti'tuj u~ 'e.Ru, a veR'da.Di 'na~w~ a'pa.ga a me~'Ti.ra, u peR'da~w~ 'na~w~ 'ku.ra a fe'ri.da
Erro e acerto, sempre por impulso.	'E.Ru i a'sEX.tu, 'se~.pri pur i~'puw.su
O acerto é a soma de vários erros.	u a'seX.tu E a 'so~.ma Di 'va.rjuz 'e.Rus
Eu penso no acerto, eu aceito o acerto, mas tenho receio do erro, então porque não penso no erro como um preparo para o acerto?	ew 'pe~.su nu a'seX.tu, ew a'sej.tu u a'seX.tu, majs 'te~.Ju Re'sej.u du 'e.Ru, e~'ta~w~ puX'ke 'na~w~ 'pe~.su nu 'e.Ru 'ko~.mu u~ pre'pa.ru 'pa.ra u a'seX.tu
Porque, no meio dos meus erros, meu acerto foi você.	puX'ke, nu 'mej.u dus 'mewz 'e.Rus, 'mew a'seX.tu 'foj vo'se
Eu posso errar a todo instante, mas eu acerto toda vez que penso em nós...	ew 'pO.su e'Rar a 'to.du i~s'ta~.Ti, majz ew a'sEX.tu 'to.da 'vejs ki 'pe~.su e~j~ 'nOjs
Porque, no meio dos meus erros, o meu acerto foi você.	puX'ke, nu 'mej.u dus 'mewz 'e.Rus, u 'mew a'seX.tu 'foj vo'se
Somos o erro de ontem a correção de hoje e o acerto do amanhã.	'so~.muz u 'e.Ru Di 'o~.te~j~ a ko.Re'sa~w~ Di 'o.Zi i u a'seX.tu du a~.ma~'Ja~
De muitos erros é feito um ÚNICO acerto.	Di 'mu~j~.tuz 'e.Ruz E 'fej.tu u~ 'u~.ni.ku a'seX.tu
A vida é uma eterna contradição, se eu me contradigo então eu mesmo me conserto. O erro e o acerto são como um só, um não sobrevive sem o outro.	a 'vi.da E u~.ma e'tER.na ko~.tra.Di'sa~w~, si ew mi ko~.tra'Di.gu e~'ta~w~ ew 'mez.mu mi ko~'sEX.tu, u 'e.Ru i u a'seX.tu 'sa~w~ 'ko~.mu 'u~ 'sO, 'u~ 'na~w~ so.bre'vi.vi se~j~ u 'ow.tru
Não é coincidência. Se acerto no presente é porque projeto no passado.	'na~w~ E ko.i~.si'de~.sja, si a'sEX.tu nu pre'ze~.Ti E puX'ke pro'ZE.tu nu pa'sa.du
Errei sim! E muitas vezes, mas cada erro me levou a glória de um único acerto.	e'Rej 'si~, i 'mu~j~.tas 've.zis, majs 'ka.da 'e.Ru mi le'vow a 'glO.rja Di u~ 'u~.ni.ku a'seX.tu
Antes eu fazia tudo certo e dava errado. Agora eu faço tudo errado pra ver se acerto.	'a~.Tiz ew fa'zi.a 'tu.du 'sEX.tu i 'da.va e'Ra.du, a'gO.ra ew 'fa.su 'tu.du e'Ra.du pra 'veX si a'sEX.tu
Insista na prática e você persistirá no acerto.	i~'sis.ta na 'pra.Ti.ka i vo'se peX.sis.Ti'ra nu a'seX.tu
O erro é um meio de chegar ao acerto. Quanto mais errar mais perto estarei da convicção do que é certo.	u 'e.Ru E u~ 'mej.u Di Se'gar aw a'seX.tu, 'kwa~.tu 'majz e'RaR 'majs 'pEX.tu es.ta'rej da ko~.vik'sa~w~ du ki E 'sEX.tu
Feio não é errar; Feio mesmo é sustentar um erro como se fosse um acerto.	'fej.u 'na~w~ E e'RaX, 'fej.u 'mez.mu E sus.te~'tar u~ 'e.Ru 'ko~.mu si 'fo.si u~ a'seX.tu
Só pode errar quem está buscando o acerto	'sO 'pO.Di e'RaX 'ke~j~ es'ta bus'ka~.du u a'seX.tu
Hoje percebo que talvez o maior erro que cometi, foi o acerto de me apaixonar, pois hoje vivo nesse erro esperando um dia acertar, para jamais errar outra vez em por ti me apaixonar.	'o.Zi peX'se.bu ki taw'vejz u maj'Or 'e.Ru ki ko~.me'Ti, 'foj u a'seX.tu Di mi a.paj.So~'naX, 'pojz 'o.Zi 'vi.vu 'ne.si 'e.Ru es.pe'ra~.du u~ 'Di.a a.seX'taX, 'pa.ra Za~'majz e'Rar 'ow.tra 'vejz e~j~ puX 'Ti mi a.paj.So~'naX
Tem que fazer. Se der errado, a expectativa do acerto já fez a adrenalina movimentar.	te~j~ ki fa'zeX, si 'dEr e'Ra.du, a es.pek.ta'Ti.va du a'seX.tu 'Za 'fejz a a.dre~.na'li~.na mo.vi~.me~'taX
Na vida em toda ocasião vale a pena tentar. A tentativa abre a possibilidade para o acerto, mesmo não acertando ganhamos no aprendizado. Tolo é aquele que não tenta.	na 'vi.da e~j~ 'to.da o.ka.zi'a~w~ 'va.li a 'pe~.na te~'taX, a te~.ta'Ti.va 'a.bri a po.si.bi.li'da.Di 'pa.ra u a'seX.tu, 'mez.mu 'na~w~ a.seX'ta~.du ga~'Ja~.mus nu a.pre~.Di'za.du, 'to.lu E a'ke.li ki 'na~w~ 'te~.ta
O espaço pra mim é tão familiar, peculiar eu acerto não sei explicar.	u es'pa.su pra 'mi~ E 'ta~w~ fa~.mi.li'aX, pe.ku.li'ar ew a'sEX.tu 'na~w~ 'sej es.pli'kaX
Solidão completa é um acerto com aqueles que deixei solitários.	so.li'da~w~ ko~'plE.ta E u~ a'seX.tu ko~ a'ke.lis ki dej'Sej so.li'ta.rjus
o erro honesto é o acerto futuro.	u 'e.Ru o~'nEs.tu E u a'seX.tu fu'tu.ru
Se todos que errassem reconhecessem o erro já teriam feito um grande acerto	si 'to.dus ki e'Ra.se~j~ Re.ko~.Je'se.se~j~ u 'e.Ru 'Za te'ri.a~w~ 'fej.tu u~ 'gra~.Di a'seX.tu
O acerto convém de um erro.	u a'seX.tu ko~'ve~j~ Di u~ 'e.Ru
Os caminhos que percorro, os amores que vivo, as amizades que faço, cada erro e cada acerto meus são os fragmentos que compõem meu ser.	us ka~'mi~.Jus ki peX'ko.Ru, uz a~'mo.ris ki 'vi.vu, az a~.mi'za.Dis ki 'fa.su, 'ka.da 'e.Ru i 'ka.da a'seX.tu 'mews 'sa~w~ us fra.gi~'me~.tus ki ko~'po~.e~j~ 'mew 'seX
Um acerto não justifica um erro. E vice-versa.	u~ a'seX.tu 'na~w~ Zus.Ti'fi.ka u~ 'e.Ru, i 'vi.si 'vEX.sa
Ao tentar corrigir um erro eu cometia outro, hoje em dia eu acerto pois até quando eu erro estou aprendendo...	aw te~'taX ko.Ri'Zir u~ 'e.Ru ew ko~.me'Ti.a 'ow.tru, 'o.Zi e~j~ 'Di.a ew a'sEX.tu 'pojz a'tE 'kwa~.du ew 'E.Ru es'tow a.pre~'de~.du
O erro é a ferramenta do acerto para o otimista.	u 'e.Ru E a fe.Ra~'me~.ta du a'seX.tu 'pa.ra u o.Ti~'mis.ta
Eu não sei onde errei, mas sei que errei e isso já é um grande passo rumo ao acerto.	ew 'na~w~ 'sej 'o~.Di e'Rej, majs 'sej ki e'Rej i 'i.su 'Za E u~ 'gra~.Di 'pa.su 'Ru~.mu aw a'seX.tu
Cometa erros a vida inteira e depois acerte uma única vez e será sempre lembrado pelo acerto! Erre apenas uma vez na vida e você será o senhor erro!	ko~'me.ta 'e.Ruz a 'vi.da i~'tej.ra i de'pojz a'sEX.Ti u~.ma 'u~.ni.ka 'vejz i se'ra 'se~.pri le~'bra.du 'pe.lu a'seX.tu, 'E.Ri a'pe~.naz u~.ma 'vejz na 'vi.da i vo'se se'ra u se~'Jor 'e.Ru
Amores não se explicam ao acerto E se assim for amante não mais serei Serei essa bárbara que certo Confunde o que é um amor eterno Por uma fútil paixão na sintaxe do talvez.	a~'mo.ris 'na~w~ si es'pli.ka~w~ aw a'seX.tu i si a'si~ 'for a~'ma~.Ti 'na~w~ 'majs se'rej se'rej 'E.sa 'baR.ba.ra ki 'sEX.tu ko~'fu~.Di u ki E u~ a~'mor e'tER.nu pur u~.ma 'fu.Tiw paj'Sa~w~ na si~'ta.si du taw'vejs
O acerto de contas virá, porém, não será com as pessoas, mas sim com Deus, por isso, agrade a Ele e não ao mundo.	u a'seX.tu Di 'ko~.tas vi'ra, po're~j~, 'na~w~ se'ra ko~ as pe'so.as, majs 'si~ ko~ 'dews, pur 'i.su, a'gra.Di a 'e.li i 'na~w~ aw 'mu~.du
O erro faz parte do processo que te prepara para o acerto	u 'e.Ru 'fajs 'paX.Ti du pro'sE.su ki Ti pre'pa.ra 'pa.ra u a'seX.tu
Humildade suficiente de admitir os erros é o acerto da pessoa do bem.	u~.miw'da.Di su.fi.si'e~.Ti Di a.Di~.mi'Tir uz 'e.Ruz E u a'seX.tu da pe'so.a du 'be~j~
Defina sua meta, esteja disposto a agir em direção a ela aproveitando cada acerto e mudando cada erro até conseguir atingí-la.	de'fi~.na 'su.a 'mE.ta, es'te.Za Dis'pos.tu a a'Zir e~j~ Di.re'sa~w~ a 'E.la a.pro.vej'ta~.du 'ka.da a'seX.tu i mu'da~.du 'ka.da 'e.Ru a'tE ko~.se'gir a.Ti~'Zi la
O melhor da vida é errar porque o acerto, na maioria das vezes, termina com a aventura de experimentar.	u me'LOR da 'vi.da E e'RaX puX'ke u a'seX.tu, na maj.o'ri.a das 've.zis, teR'mi~.na ko~ a a.ve~'tu.ra Di es.pe.ri~.me~'taX
toda vida é um erro nosso dever é transformala em acerto	'to.da 'vi.da E u~ 'e.Ru 'nO.su de'ver E tra~s.foR'ma.la e~j~ a'seX.tu
Hora erro acertando, hora acerto errando, e o que resplandece minha caminhada, é que em meu ponto de partida sigo Jesus que com amor e paciência, me leva a Deus como ponto de chegada	'O.ra 'E.Ru a.seX'ta~.du, 'O.ra a'sEX.tu e'Ra~.du, i u ki Res.pla~'dE.si 'mi~.Ja ka~.mi~'Ja.da, E ki e~j~ 'mew 'po~.tu Di paX'Ti.da 'si.gu Ze'zujs ki ko~ a~'mor i pa.si'e~.sja, mi 'lE.va a 'dews 'ko~.mu 'po~.tu Di Se'ga.da
Por mais sentido que faça, a vida não tem sentido algum. Planejar é um erro, viver um acerto e acordar todos os dias, uma baita sorte.	puR 'majs se~'Ti.du ki 'fa.sa, a 'vi.da 'na~w~ te~j~ se~'Ti.du aw'gu~, pla~.ne'Zar E u~ 'e.Ru, vi'ver u~ a'seX.tu i a.koR'daX 'to.duz us 'Di.as, u~.ma 'baj.ta 'sOX.Ti
A melhor maneira de aprender, será sempre após a tentativa do acerto.	a me'LOR ma~'nej.ra Di a.pre~'deX, se'ra 'se~.pri a'pOjz a te~.ta'Ti.va du a'seX.tu
Dois erros nunca farão acerto porque dois erros nunca serão iguais.	'dojz 'e.Rus 'nu~.ka fa'ra~w~ a'seX.tu puX'ke 'dojz 'e.Rus 'nu~.ka se'ra~w~ i'gwajs
Todo erro leva o homem ao acerto.	'to.du 'e.Ru 'lE.va u 'o~.me~j~ aw a'seX.tu
É muito mais fácil focar no erro alheio, do que focar no próprio acerto.	E 'mu~j~.tu 'majs 'fa.siw fo'kaR nu 'e.Ru a'Lej.u, du ki fo'kaR nu 'prO.prju a'seX.tu
Todo erro é um exemplo, mas nem todo acerto pode ser exemplar.	'to.du 'e.Ru E u~ e'ze~.plu, majs ne~j~ 'to.du a'seX.tu 'pO.Di 'ser e.ze~'plaX
De tudo o que me chateia, destaco o seguinte: Quando acerto ninguém elogia, mas quando erro todo mundo critica.	Di 'tu.du u ki mi Sa'tej.a, des'ta.ku u se'gi~.Ti, 'kwa~.du a'sEX.tu ni~'ge~j~ e.lo'Zi.a, majs 'kwa~.du 'E.Ru 'to.du 'mu~.du kri'Ti.ka
Por que quando acerto ninguém escreve? Por que quando erro ninguém esquece? Talvez seja porquê o amor pareça leve!	puX 'ke 'kwa~.du a'sEX.tu ni~'ge~j~ es'krE.vi, puX 'ke 'kwa~.du 'E.Ru ni~'ge~j~ es'kE.si, taw'vejs 'se.Za puX'ke u a~'moX pa're.sa 'lE.vi
Se te amar for um erro, estou reprovado! Se for um acerto, já sou formado. E se por acaso for um crime, que pena, fui condenado!	si Ti a~'maX 'for u~ 'e.Ru, es'tow Re.pro'va.du, si 'for u~ a'seX.tu, 'Za 'sow foR'ma.du, i si pur a'ka.zu 'for u~ 'kri~.mi, ki 'pe~.na, 'fuj ko~.de~'na.du
Exu, é o orixá que faz o erro virar acerto e o acerto virar erro.	e'Su, E u o.ri'Sa ki 'fajz u 'e.Ru vi'rar a'seX.tu i u a'seX.tu vi'rar 'e.Ru
Meu passado foi um erro meu presente é um acerto.	'mew pa'sa.du 'foj u~ 'e.Ru 'mew pre'ze~.Ti E u~ a'seX.tu
O tempo é uma flecha em movimento ela não para e não espera até que acerto o ponto final.	u 'te~.pu E u~.ma 'flE.Sa e~j~ mo.vi~'me~.tu 'E.la 'na~w~ 'pa.ra i 'na~w~ es'pE.ra a'tE ki a'sEX.tu u 'po~.tu fi~'naw
Mesmo o mais terrível dos meus erros cometidos na tentativa de um acerto foram mesmos dolorosos do que a inércia que minhas dúvidas trouxeram para minha existência.	'mez.mu u 'majs te'Ri.vew dus 'mewz 'e.Rus ko~.me'Ti.dus na te~.ta'Ti.va Di u~ a'seX.tu 'fo.ra~w~ 'mez.mus do.lo'rO.zus du ki a i~'nEX.sja ki 'mi~.Jas 'du.vi.das trow'sE.ra~w~ 'pa.ra 'mi~.Ja e.zis'te~.sja
O teu acerto, não te faz melhor do que ninguém que errou !	u 'tew a'seX.tu, 'na~w~ Ti 'fajz me'LOR du ki ni~'ge~j~ ki e'Row
Entre a distância do erro para o acerto está a busca. A busca em descobrir, em aprender. A vida é nada senão uma busca constante.	'e~.tri a Dis'ta~.sja du 'e.Ru 'pa.ra u a'seX.tu es'ta a 'bus.ka, a 'bus.ka e~j~ des.ko'briX, e~j~ a.pre~'deX, a 'vi.da E 'na.da se~'na~w~ u~.ma 'bus.ka ko~s'ta~.Ti
Com a tristeza aprendi que nem todo acerto, acerta. E nem todo errar é erro.	ko~ a tris'te.za a.pre~'Di ki ne~j~ 'to.du a'seX.tu, a'sEX.ta, i ne~j~ 'to.du e'Rar E 'e.Ru
Na vida, para superar um problema, o primeiro passo para o acerto é reconhecer que o erro existe e precisa ser corrigido!	na 'vi.da, 'pa.ra su.pe'rar u~ pro'ble~.ma, u pri~'mej.ru 'pa.su 'pa.ra u a'seX.tu E Re.ko~.Je'seX ki u 'e.Ru e'zis.Ti i pre'si.za 'seX ko.Ri'Zi.du
Eu erro, eu caio, mas eu sempre me levanto e acerto tudo aquilo que errado saiu!	ew 'E.Ru, ew 'kaj.u, majz ew 'se~.pri mi le'va~.tu i a'sEX.tu 'tu.du a'ki.lu ki e'Ra.du sa'iw
Nem sempre acerto nas palavras assim como no que sinto, mas se não sentir e se não errar nunca me sentirei vivo.	ne~j~ 'se~.pri a'sEX.tu nas pa'la.vraz a'si~ 'ko~.mu nu ki 'si~.tu, majs si 'na~w~ se~'Tir i si 'na~w~ e'RaR 'nu~.ka mi se~.Ti'rej 'vi.vu
Não se canse de tentar, mas faça a tentativa se cansar de não virar acerto.	'na~w~ si 'ka~.si Di te~'taX, majs 'fa.sa a te~.ta'Ti.va si ka~'saR Di 'na~w~ vi'rar a'seX.tu
Um erro sem punição se torna um acerto.	u~ 'e.Ru se~j~ pu~.ni'sa~w~ si 'tOR.na u~ a'seX.tu
É nas minhas horas de imperfeição que eu acerto o meu relógio humano.	E nas 'mi~.Jaz 'O.ras Di i~.peX.fej'sa~w~ ki ew a'sEX.tu u 'mew Re'lO.Zju u~'ma~.nu
Portanto, sejamos cautelosos. É na cautela que reside a chance maior do acerto. Boa sorte...	poX'ta~.tu, se'Za~.mus kaw.te'lO.zus, E na kaw'tE.la ki Re'zi.Di a 'Sa~.si maj'OR du a'seX.tu, 'bo.a 'sOX.Ti
Vontade não garante acerto. É preciso ser competente.	vo~'ta.Di 'na~w~ ga'ra~.Ti a'seX.tu, E pre'si.zu 'seX ko~.pe'te~.Ti
Com os erros aprendemos, com o acerto encinamos.	ko~ uz 'e.Ruz a.pre~'de~.mus, ko~ u a'seX.tu e~.si~'na~.mus
E de todas as pessoas por quem eu poderia ter me apaixonado, cometi o erro (e o acerto) de escolher você.	i Di 'to.daz as pe'so.as puX 'ke~j~ ew po.de'ri.a 'teR mi a.paj.So~'na.du, ko~.me'Ti u 'e.Ru, i u a'seX.tu, Di es.ko'LeR vo'se
Quero ver o que você vai dizer. Quando chegar a hora do acerto de contas.	'kE.ru 'ver u ki vo'se 'vaj Di'zeX, 'kwa~.du Se'gar a 'O.ra du a'seX.tu Di 'ko~.tas
O Acerto é o Resultado do Erro!	u a'seX.tu E u Re.zuw'ta.du du 'e.Ru
Eu acerto é pela tentativa, pois o fim é sempre um erro	ew a'sEX.tu E 'pe.la te~.ta'Ti.va, 'pojz u 'fi~ E 'se~.pri u~ 'e.Ru
O tempo é uma ponte positiva apenas para aqueles que lucidamente fazem a travessia entre seus acertos e fracassos!	u 'te~.pu E u~.ma 'po~.Ti po.zi'Ti.va a'pe~.nas 'pa.ra a'ke.lis ki lu.si.da~'me~.Ti 'fa.ze~j~ a tra.ve'si.a 'e~.tri 'sewz a'seX.tuz i fra'ka.sus
Existe muitos erros dentro de um grande acerto.	e'zis.Ti 'mu~j~.tuz 'e.Rus 'de~.tru Di u~ 'gra~.Di a'seX.tu
Aproveite cada minuto da sua vida. Até mesmo errando ou chorando, pois do erro nasce o acerto e do choro nasce a humildade, substantivos essenciais ao homem.	a.pro'vej.Ti 'ka.da mi~'nu.tu da 'su.a 'vi.da, a'tE 'mez.mu e'Ra~.du ow So'ra~.du, 'pojs du 'e.Ru 'na.si u a'seX.tu i du 'So.ru 'na.si a u~.miw'da.Di, subs.ta~'Ti.vuz e.se~.si'ajz aw 'o~.me~j~
A consequência nem sempre é um erro. Assim como um erro para o outro pode ser um acerto para você. Isso derruba a tese de que tenhamos que observar e aprender com o fracasso alheio.	a ko~.se'kwe~.sja ne~j~ 'se~.pri E u~ 'e.Ru, a'si~ 'ko~.mu u~ 'e.Ru 'pa.ra u 'ow.tru 'pO.Di 'ser u~ a'seX.tu 'pa.ra vo'se, 'i.su de'Ru.ba a 'tE.zi Di ki te~'Ja~.mus ki ob.seR'var i a.pre~'deX ko~ u fra'ka.su a'Lej.u
Fazer dar certo é tentar as possibilidades de viver o erro como uma forma de acerto.	fa'zeR 'daX 'sEX.tu E te~'tar as po.si.bi.li'da.Dis Di vi'ver u 'e.Ru 'ko~.mu u~.ma 'fOR.ma Di a'seX.tu
Aprenda: É do erro que se sai o acerto.	a'pre~.da, E du 'e.Ru ki si 'saj u a'seX.tu
Na guitarra de inproviso: erro para acertar e acerto para tocar.	na gi'ta.Ra Di i~.pro'vi.zu, 'E.Ru 'pa.ra a.seX'tar i a'sEX.tu 'pa.ra to'kaX
O erro ensina o caminho do acerto  e o fracasso mostra o caminho da segurança.	u 'e.Ru e~'si~.na u ka~'mi~.Ju du a'seX.tu i u fra'ka.su 'mOs.tra u ka~'mi~.Ju da se.gu'ra~.sa
Que todas as chegadas sejam maiores do que todas as ausências e que cada acerto valha mais que todos os erros. E que cada fim tenha um recomeço...	ki 'to.daz as Se'ga.das 'se.Za~w~ maj'O.ris du ki 'to.daz az aw'ze~.sjaz i ki 'ka.da a'seX.tu 'va.La 'majs ki 'to.duz uz 'e.Rus, i ki 'ka.da 'fi~ 'te~.Ja u~ Re.ko~'me.su
Sem o erro, o acerto não seria ninguém!!	se~j~ u 'e.Ru, u a'seX.tu 'na~w~ se'ri.a ni~'ge~j~
Casamento é um acerto de mútua fidelidade, no qual duas almas desfrutam de um concerto de paz, amor e felicidade.	ka.za~'me~.tu E u~ a'seX.tu Di 'mu.twa fi.de.li'da.Di, nu 'kwaw 'du.az 'aw.mas des'fru.ta~w~ Di u~ ko~'seX.tu Di 'pajs, a~'mor i fe.li.si'da.Di
Nao falo de ninguém mesmo, seja positivamente ou negativamente, dois erros não formam um acerto.	'naw 'fa.lu Di ni~'ge~j~ 'mez.mu, 'se.Za po.zi.Ti.va~'me~.Ti ow ne.ga.Ti.va~'me~.Ti, 'dojz 'e.Rus 'na~w~ 'fOR.ma~w~ u~ a'seX.tu
É melhor a ilusão do acerto, do que a certeza do erro.	E me'LOr a i.lu'za~w~ du a'seX.tu, du ki a seX'te.za du 'e.Ru
Quem sente falta, procura. Quem erra, busca o acerto. Quem faz derramar uma lágrima, cuida. Agora quem ama meu caro, simplesmente ama.	'ke~j~ 'se~.Ti 'faw.ta, pro'ku.ra, 'ke~j~ 'E.Ra, 'bus.ka u a'seX.tu, 'ke~j~ 'fajz de.Ra~'mar u~.ma 'la.gri~.ma, 'kuj.da, a'gO.ra 'ke~j~ 'a~.ma 'mew 'ka.ru, si~.pliz'me~.Ti 'a~.ma
O fruto do acerto é viver da benção da atitude acertada, o fruto do erro é viver na misericórdia do tempo da cura, por ter errado!	u 'fru.tu du a'seX.tu E vi'veR da be~'sa~w~ da a.Ti'tu.Di a.seX'ta.da, u 'fru.tu du 'e.Ru E vi'veR na mi.ze.ri'kOR.Dja du 'te~.pu da 'ku.ra, puX 'ter e'Ra.du
As vezes a certeza gera incerteza, as vezes o erro vira acerto, e sempre que você acha que está perdido, é onde se encontra.	as 've.ziz a seX'te.za 'ZE.ra i~.seX'te.za, as 've.ziz u 'e.Ru 'vi.ra a'seX.tu, i 'se~.pri ki vo'se 'a.Sa ki es'ta peR'Di.du, E 'o~.Di si e~'ko~.tra
Da tristeza a felicidade, da ignorância o respeito, do erro o acerto, da perda o recomeço, da vida eu reconheço é que vale a pena viver.	da tris'te.za a fe.li.si'da.Di, da i.gi~.no'ra~.sja u Res'pej.tu, du 'e.Ru u a'seX.tu, da 'peR.da u Re.ko~'me.su, da 'vi.da ew Re.ko~'Je.su E ki 'va.li a 'pe~.na vi'veX
errar é um belo caminho para o acerto.	e'Rar E u~ 'bE.lu ka~'mi~.Ju 'pa.ra u a'seX.tu
O erro de hoje é o acerto de amanhã.	u 'e.Ru Di 'o.Zi E u a'seX.tu Di a~.ma~'Ja~
As pessoas erram porque ainda não descobriram o caminho do acerto.	as pe'so.az 'E.Ra~w~ puX'ke a'i~.da 'na~w~ des.ko'bri.ra~w~ u ka~'mi~.Ju du a'seX.tu
Escrevo, pinto, choro, brigo, me arrependo, amo com a mesma intensidade que odeio acerto e erro resumindo sou humano, e é exatamente isso que as não conseguem aceitar!	es'kre.vu, 'pi~.tu, 'SO.ru, 'bri.gu, mi a.Re'pe~.du, 'a~.mu ko~ a 'mez.ma i~.te~.si'da.Di ki o'dej.u a'sEX.tu i 'E.Ru Re.zu~'mi~.du 'sow u~'ma~.nu, i E e.za.ta~'me~.Ti 'i.su ki as 'na~w~ ko~'sE.ge~j~ a.sej'taX
O erro é um acerto garantido!	u 'e.Ru E u~ a'seX.tu ga.ra~'Ti.du
Cuidado, os seus erros podem ajudar outros a chegar ao acerto.	kuj'da.du, us 'sewz 'e.Rus 'pO.de~j~ a.Zu'dar 'ow.truz a Se'gar aw a'seX.tu
Um novo erro não justifica um anterior, pois na vida real, dois erros jamais farão um acerto...	u~ 'no.vu 'e.Ru 'na~w~ Zus.Ti'fi.ka u~ a~.te.ri'oX, 'pojs na 'vi.da Re'aw, 'dojz 'e.Ru.Za~'majs fa'ra~w~ u~ a'seX.tu
Não existe certo e nem errado o que existe são tentativas de acerto mesmo que seja através dos erros.	'na~w~ e'zis.Ti 'sEX.tu i ne~j~ e'Ra.du u ki e'zis.Ti 'sa~w~ te~.ta'Ti.vas Di a'seX.tu 'mez.mu ki 'se.Za a.tra'vEjs duz 'e.Rus
Quando começamos a reconhecer o próprio erro, é sinal de que entramos numa jornada de mais acerto.	'kwa~.du ko~.me'sa~.muz a Re.ko~.Je'ser u 'prO.prju 'e.Ru, E si~'naw Di ki e~'tra~.mus 'nu~.ma ZoR'na.da Di 'majz a'seX.tu
Errar na tentativa do acerto é louvável. Errar ao pleno discaso é deplorável.	e'RaR na te~.ta'Ti.va du a'seX.tu E low'va.vew, e'Rar aw 'ple~.nu Dis'ka.zu E de.plo'ra.vew
Hoje, eu consigo transmitir tudo que eu aprendir com meus erros, assim dando brilho aos meus acertos.	'o.Zi, ew ko~'si.gu tra~z.mi'TiX 'tu.du ki ew a.pre~'DiX ko~ 'mewz 'e.Rus, a'si~ 'da~.du 'bri.Lu aws 'mewz a'seX.tus
Um erro cometido hoje pode ser um acerto lembrado amanhã	u~ 'e.Ru ko~.me'Ti.du 'o.Zi 'pO.Di 'ser u~ a'seX.tu le~'bra.du a~.ma~'Ja~
Em um mundo tão contrastante O acerto não é mais, O mais importante Nada vale mais que o aprendizado	e~j~ u~ 'mu~.du 'ta~w~ ko~.tras'ta~.Ti u a'seX.tu 'na~w~ E 'majs, u 'majz i~.poX'ta~.Ti 'na.da 'va.li 'majs ki u a.pre~.Di'za.du
Sorte é quando o seu erro se torna um acerto	'sOX.Ti E 'kwa~.du u 'sew 'e.Ru si 'tOR.na u~ a'seX.tu
Ninguém é perfeito, estamos nessa vida tropeçando entre o erro e o acerto.	ni~'ge~j~ E peX'fej.tu, es'ta~.mus 'nE.sa 'vi.da tro.pe'sa~.du 'e~.tri u 'e.Ru i u a'seX.tu
O maior medo do homem é errar no erro, pois no erro só tem concerto quando tem acerto.	u maj'OR 'me.du du 'o~.me~j~ E e'RaR nu 'e.Ru, 'pojs nu 'e.Ru 'sO te~j~ ko~'seX.tu 'kwa~.du te~j~ a'seX.tu
No final dá tudo certo de algum jeito. Eu me acerto, eu tropeço e não passo do chão, eu suporto a colisão, da verdade na contra-mão, de tanto tropeçar já até sei como cair.	nu fi~'naw 'da 'tu.du 'sEX.tu Di aw'gu~ 'Zej.tu, ew mi a'sEX.tu, ew tro'pE.su i 'na~w~ 'pa.su du 'Sa~w~, ew su'pOX.tu a ko.li'za~w~, da veR'da.Di na 'ko~.tra 'ma~w~, Di 'ta~.tu tro.pe'saR 'Za a'tE 'sej 'ko~.mu ka'iX
Os erros de cada um vem da tentativa de acerto, erro sempre no desejo infinito de acertar e sair na conquista dos meus desejos!	uz 'e.Rus Di 'ka.da 'u~ 've~j~ da te~.ta'Ti.va Di a'seX.tu, 'E.Ru 'se~.pri nu de'ze.Zu i~.fi~'ni.tu Di a.seX'tar i sa'iR na ko~'kis.ta dus 'mews de'ze.Zus
Quando o acerto pensou em vir, o erro veio e ensinou como se faz, assim nasceu a perfeição.	'kwa~.du u a'seX.tu pe~'sow e~j~ 'viX, u 'e.Ru 'vej.u i e~.si~'now 'ko~.mu si 'fajs, a'si~ na'sew a peX.fej'sa~w~
É bem diferente errar tentando acertar e errar visando acerto próprio!	E 'be~j~ Di.fe're~.Ti e'RaX te~'ta~.du a.seX'tar i e'RaR vi'za~.du a'seX.tu 'prO.prju
Cometemos vários erros chamados de paixões até encontrar o acerto que chamamos de amor.	ko~.me'te~.mus 'va.rjuz 'e.Ru.Sa~'ma.dus Di paj'So~j~z a'tE e~.ko~'trar u a'seX.tu ki Sa~'ma~.mus Di a~'moX
Bússola é pretexto para acerto. Instinto é contexto para não se perder. Bússola é direção, Instinto é decisão.	'bu.so.la E pre'tes.tu 'pa.ra a'seX.tu, i~s'Ti~.tu E ko~'tes.tu 'pa.ra 'na~w~ si peR'deX, 'bu.so.la E Di.re'sa~w~, i~s'Ti~.tu E de.si'za~w~
Quando eu choro ou rio, acerto ou erro, eu estou produzindo vida. Sinto a morte quando eu não produzo nada.	'kwa~.du ew 'SO.ru ow 'Ri.u, a'sEX.tu ow 'E.Ru, ew es'tow pro.du'zi~.du 'vi.da, 'si~.tu a 'mOX.Ti 'kwa~.du ew 'na~w~ pro'du.zu 'na.da
O erro é apenas uma oportunidade de acerto.	u 'e.Ru E a'pe~.naz u~.ma o.poX.tu~.ni'da.Di Di a'seX.tu
Se sou também parte de tudo aquilo que me comove. Sou também o acerto de todas as minhas tentativas.	si 'sow ta~'be~j~ 'paX.Ti Di 'tu.du a'ki.lu ki mi ko~'mO.vi, 'sow ta~'be~j~ u a'seX.tu Di 'to.daz as 'mi~.Jas te~.ta'Ti.vas
E se hoje não der certo? Amanhã acordo e tento novamente! Quem sabe um dia eu acerto!?	i si 'o.Zi 'na~w~ 'dEX 'sEX.tu, a~.ma~'Ja~ a'kOR.du i 'te~.tu nO.va~'me~.Ti, 'ke~j~ 'sa.bi u~ 'Di.a ew a'sEX.tu
Um erro, uma chance Um acerto, a vitória Outro erro, o calabouço.	u~ 'e.Ru, u~.ma 'Sa~.si u~ a'seX.tu, a vi'tO.rja 'ow.tru 'e.Ru, u ka.la'bow.su
Só existem erros porque não existe a preocupação do acerto desde o seu nascedouro, buscamos culpados mesmo quando não sabemos para que caminho seguir.	'sO e'zis.te~j~ 'e.Rus puX'ke 'na~w~ e'zis.Ti a prew.ku.pa'sa~w~ du a'seX.tu 'dez.Di u 'sew na.se'dow.ru, bus'ka~.mus kuw'pa.dus 'mez.mu 'kwa~.du 'na~w~ sa'be~.mus 'pa.ra ki ka~'mi~.Ju se'giX
Uma infinidade de erros não faz um acerto sequer.	u~.ma i~.fi~.ni'da.Di Di 'e.Rus 'na~w~ 'fajz u~ a'seX.tu se'kEX
Se dermos um zoom na palavra ACERTO, veremos milhares de vezes a palavra erro.	si 'dER.muz u~ 'zu~w~ na pa'la.vra a'seX.tu, ve're~.mus mi'La.ris Di 've.ziz a pa'la.vra 'e.Ru
Todos nós teremos um acerto de contas, Que o nosso saldo em tal momento; Esteja positivo para com Deus.	'to.dus 'nOjs te're~.muz u~ a'seX.tu Di 'ko~.tas, ki u 'nO.su 'saw.du e~j~ 'taw mo~'me~.tu, es'te.Za po.zi'Ti.vu 'pa.ra ko~ 'dews
99 erros, 1001 aprendizados. 01 Acerto, objetivo alcançado!	no've~.ta i 'nO.vi 'e.Rus, 'miw i 'u~ a.pre~.Di'za.dus, 'u~ a'seX.tu, ob.Ze'Ti.vu aw.ka~'sa.du
O erro é o único caminho para a construção de um sólido e resistente acerto.	u 'e.Ru E u 'u~.ni.ku ka~'mi~.Ju 'pa.ra a ko~s.tru'sa~w~ Di u~ 'sO.li.du i Re.zis'te~.Ti a'seX.tu
Nessas predições de que o mundo vai acabar em certas datas, há sempre o acerto para quem morre nelas.	'nE.sas pre.Di'so~j~s Di ki u 'mu~.du 'vaj a.ka'bar e~j~ 'sEX.tas 'da.tas, 'a 'se~.pri u a'seX.tu 'pa.ra 'ke~j~ 'mO.Ri 'nE.las
Cada erro é um degrau para o acerto e cada acerto é mais um degrau para o sucesso.	'ka.da 'e.Ru E u~ de'graw 'pa.ra u a'seX.tu i 'ka.da a'seX.tu E 'majz 'u~ de'graw 'pa.ra u su'sE.su
Vale muito um pequeno acerto com lealdade do que vários acertos desleais.	'va.li 'mu~j~.tu u~ pe'ke~.nu a'seX.tu ko~ le.aw'da.Di du ki 'va.rjuz a'seX.tus dez.le'ajs
De todos os meus erros, tu és o meu único acerto.	Di 'to.duz us 'mewz 'e.Rus, 'tu 'Ejz u 'mew 'u~.ni.ku a'seX.tu
O insensato atenta à 1 erro entre 9 acertos, o sensato parabeniza pelo 1 acerto entre 9 erros.	u i~.se~'sa.tu a'te~.ta a 'u~ 'e.Ru 'e~.tri 'nO.vi a'seX.tus, u se~'sa.tu pa.ra.be~'ni.za 'pe.lu 'u~ a'seX.tu 'e~.tri 'nO.vi 'e.Rus
Não sou perfeita e tampouco dona da razão. Apenas acerto mais pelo simples fato de estar disposta a ouvir e a escutar os diversos lados das histórias e analisá-las.	'na~w~ 'sow peX'fej.ta i ta~'pow.ku 'do~.na da Ra'za~w~, a'pe~.naz a'sEX.tu 'majs 'pe.lu 'si~.plis 'fa.tu Di es'taR Dis'pOs.ta a ow'vir i a es.ku'tar us Di'vEX.sus 'la.dus daz is'tO.rjaz i a~.na.li'za las
um dia os sonhos podem morrer quem dera eu saber de tal ensinamento a certo tempo, talvez tenha sido bom, pois me limitaria a experiência de me frustrar frustrado estou	u~ 'Di.a us 'so~.Jus 'pO.de~j~ mo'ReX 'ke~j~ 'dE.ra ew sa'beR Di 'taw e~.si~.na~'me~.tu a 'sEX.tu 'te~.pu, taw'vejs 'te~.Ja 'si.du 'bo~, 'pojs mi li~.mi.ta'ri.a a es.pe.ri'e~.sja Di mi frus'traX frus'tra.du es'tow
Um erro é o acerto em pleno vigor da juventude.	u~ 'e.Ru E u a'seX.tu e~j~ 'ple~.nu vi'goR da Zu.ve~'tu.Di
Intenção não é erro nem acerto, não é nada.	i~.te~'sa~w~ 'na~w~ E 'e.Ru ne~j~ a'seX.tu, 'na~w~ E 'na.da
Quanto mais treinado, maior será o valor do acerto.	'kwa~.tu 'majs trej~'na.du, maj'OX se'ra u va'loR du a'seX.tu
o maior erro do seres humano é não saber aceitar o erro mas o maior acerto é saber pedir descupa.	u maj'Or 'e.Ru du 'se.riz u~'ma~.nu E 'na~w~ sa'ber a.sej'tar u 'e.Ru majz u maj'Or a'seX.tu E sa'beX pe'DiR des'ku.pa
O maior acerto é reconhecer o erro	u maj'Or a'seX.tu E Re.ko~.Je'ser u 'e.Ru
Um erro que se erra junto é esquecido, um acerto isolado se torna excluído.	u~ 'e.Ru ki si 'E.Ra 'Zu~.tu E es.ke'si.du, u~ a'seX.tu i.zo'la.du si 'tOR.na es.klu'i.du
Deve-se procurar somente pensar e falar com acerto, sem querer sujeitar os outros ao nosso gosto e a nossos sentimentos. É uma empresa demasiado grande.	'dE.vi si pro.ku'raX sO~'me~.Ti pe~'sar i fa'laX ko~ a'seX.tu, se~j~ ke'reX su.Zej'tar uz 'ow.truz aw 'nO.su 'gos.tu i a 'nO.sus se~.Ti~'me~.tus, E u~.ma e~'pre.za de~.ma.zi'a.du 'gra~.Di
Ainda mais, você sorrindo desse jeito Não tem acerto Pode levar Sou seu...	a'i~.da 'majs, vo'se so'Ri~.du 'de.si 'Zej.tu 'na~w~ te~j~ a'seX.tu 'pO.Di le'vaX 'sow 'sew
Não há erro quando o acerto e a ambição...	'na~w~ 'a 'e.Ru 'kwa~.du u a'seX.tu i a a~.bi'sa~w~
Você não se torna vencedor por conta das quantidades de acerto; mas sim pelas vezes que superou seus erros.	vo'se 'na~w~ si 'tOR.na ve~.se'doX puX 'ko~.ta das kwa~.Ti'da.Dis Di a'seX.tu, majs 'si~ 'pe.las 've.zis ki su.pe'row 'sewz 'e.Rus
O que seria do ser humano sem os erros da vida? Creio que não haveria nenhum acerto.	u ki se'ri.a du 'ser u~'ma~.nu se~j~ uz 'e.Rus da 'vi.da, 'krej.u ki 'na~w~ a.ve'ri.a ne~'Ju~ a'seX.tu
Me encontrar em milhões de desencontros. Saber onde está o acerto em tantos erros. Procurar ser no meio de tanto não ser. Sempre ir em tantas voltas.	mi e~.ko~'trar e~j~ mi'Lo~j~s Di de.ze~'ko~.trus, sa'ber 'o~.Di es'ta u a'seX.tu e~j~ 'ta~.tuz 'e.Rus, pro.ku'raX 'seR nu 'mej.u Di 'ta~.tu 'na~w~ 'seX, 'se~.pri 'ir e~j~ 'ta~.tas 'vOw.tas
Tão certo que um dia me acerto Desacertos fazem parte do nosso dia a dia E se findam nos acertos das nossas matemáticas.	'ta~w~ 'sEX.tu ki u~ 'Di.a mi a'sEX.tu de.za'seX.tus 'fa.ze~j~ 'paX.Ti du 'nO.su 'Di.a a 'Di.a i si 'fi~.da~w~ nuz a'seX.tus das 'nO.sas ma.te~'ma.Ti.kas
Para alguns o tempo é a única forma de apagar seus erros, enquanto que, para outros, o acerto é pessoal e imediato.	'pa.ra aw'gu~z u 'te~.pu E a 'u~.ni.ka 'fOR.ma Di a.pa'gaX 'sewz 'e.Rus, e~'kwa~.tu ki, 'pa.ra 'ow.trus, u a'seX.tu E pe.so'aw i i~.me.Di'a.tu
Não me repito, sou único e imperfeito em cada erros e verdadeiro em cada acerto	'na~w~ mi Re'pi.tu, 'sow 'u~.ni.ku i i~.peX'fej.tu e~j~ 'ka.da 'e.Ruz i veR.da'dej.ru e~j~ 'ka.da a'seX.tu
Em todo acerto há um erro, é como uma paixão devastadora que te destrói mas te mantem vivo.	e~j~ 'to.du a'seX.tu 'a u~ 'e.Ru, E 'ko~.mu u~.ma paj'Sa~w~ de.vas.ta'do.ra ki Ti des'trOj majs Ti ma~'te~j~ 'vi.vu
O erro de ontem é a certeza do acerto de hoje.	u 'e.Ru Di 'o~.te~j~ E a seX'te.za du a'seX.tu Di 'o.Zi
O medo de errar nos priva do acerto.	u 'me.du Di e'RaR nus 'pri.va du a'seX.tu
Errar é meu melhor acerto.	e'Rar E 'mew me'LOr a'seX.tu
O acerto é a soma de tentativas e erros, com algumas pitadas de persistência...	u a'seX.tu E a 'so~.ma Di te~.ta'Ti.vaz i 'e.Rus, ko~ aw'gu~.mas pi'ta.das Di peX.sis'te~.sja
Você tem que saber conviver com os seus erros antes de cometê-los. Ou colher os frutos dos acerto da mesma forma.	vo'se te~j~ ki sa'beX ko~.vi'veX ko~ us 'sewz 'e.Ruz 'a~.Tis Di ko~me'te lus, ow ko'Ler us 'fru.tus duz a'seX.tu da 'mez.ma 'fOR.ma
Acertos e erros são estados momentâneos. O acerto nas mãos do ignorante torna-se uma soberba vitória. O erro nas mãos do sábio torna-se uma estratégia de glória.	a'seX.tuz i 'e.Rus 'sa~w~ es'ta.dus mo~.me~'ta~.njus, u a'seX.tu nas 'ma~w~s du i.gi~.no'ra~.Ti 'tOR.na si u~.ma so'beR.ba vi'tO.rja, u 'e.Ru nas 'ma~w~s du 'sa.bju 'tOR.na si u~.ma es.tra'tE.Zja Di 'glO.rja
Atrás do erro ou de um acerto, surgem você. E você sempre tem a possibilidade de escolher o que mais lhe atrai.	a'trajs du 'e.Ru ow Di u~ a'seX.tu, 'suR.Ze~j~ vo'se, i vo'se 'se~.pri te~j~ a po.si.bi.li'da.Di Di es.ko'Ler u ki 'majs Li a'traj
Um grande erro é a base de um grande acerto...	u~ 'gra~.Di 'e.Ru E a 'ba.zi Di u~ 'gra~.Di a'seX.tu
Se permita admitir seu maior erro , para que o aprendizado traga seu melhor acerto.	si peR'mi.ta a.Di~.mi'TiX 'sew maj'Or 'e.Ru, 'pa.ra ki u a.pre~.Di'za.du 'tra.ga 'sew me'LOr a'seX.tu
O risco é um acerto, as consequências são um risco. Não tem nada de errado. Errado mesmo, é ficar enraizado, sem perspectivas!!	u 'Ris.ku E u~ a'seX.tu, as ko~.se'kwe~.sjas 'sa~w~ u~ 'Ris.ku, 'na~w~ te~j~ 'na.da Di e'Ra.du, e'Ra.du 'mez.mu, E fi'kar e~.Raj'za.du, se~j~ peXs.pek'Ti.vas
Eu nunca acerto a chave de abrir está porta do seu coração...	ew 'nu~.ka a'sEX.tu a 'Sa.vi Di a'brir es'ta 'pOX.ta du 'sew ko.ra'sa~w~
A maior recompensa para o erro é o acerto.	a maj'O.Re.ko~'pe~.sa 'pa.ra u 'e.Ru E u a'seX.tu
Saber reconhecer o erro, é o primeiro passo para o acerto.	sa'be.Re.ko~.Je'ser u 'e.Ru, E u pri~'mej.ru 'pa.su 'pa.ra u a'seX.tu
O livre arbítrio é um direito dos humanos de permanecer no erro sem avistar o acerto.	u 'li.vri aR'bi.trju E u~ Di'rej.tu duz u~'ma~.nus Di peR.ma~.ne'seR nu 'e.Ru se~j~ a.vis'tar u a'seX.tu
Cuidado. O que lhe parece motivo de acerto, pode ser a sua grande derrocada. Reveja suas apostas.	kuj'da.du, u ki Li pa'rE.si mo'Ti.vu Di a'seX.tu, 'pO.Di 'ser a 'su.a 'gra~.Di de.Ro'ka.da, Re've.Za 'su.az a'pOs.tas
Assim, como pagamos por cada erro , também somos recompensados por cada acerto.	a'si~, 'ko~.mu pa'ga~.mus puX 'ka.da 'e.Ru, ta~'be~j~ 'so~.mus Re.ko~.pe~'sa.dus puX 'ka.da a'seX.tu
Melhor a certeza do erro, do que a ilusão do acerto.	me'LOr a seX'te.za du 'e.Ru, du ki a i.lu'za~w~ du a'seX.tu
Aquele que não reconhece os seus erros nunca conhecerá o acerto !	a'ke.li ki 'na~w~ Re.ko~'JE.si us 'sewz 'e.Rus 'nu~.ka ko~.Je.se'ra u a'seX.tu
Professor de matemática é morto por acerto de contas	pro.fe'soR Di ma.te~'ma.Ti.ka E 'moX.tu pur a'seX.tu Di 'ko~.tas
Oportunidade, é uma porta para a possibilidade de erro ou acerto que sempre te leva a uma consequência irrefutável	o.poX.tu~.ni'da.Di, E u~.ma 'pOX.ta 'pa.ra a po.si.bi.li'da.Di Di 'e.Ru ow a'seX.tu ki 'se~.pri Ti 'lE.va a u~.ma ko~.se'kwe~.sja i.Re.fu'ta.vew
Sempre acerto quando intuo que vai dar ERRADO!	'se~.pri a'sEX.tu 'kwa~.du i~'tu.u ki 'vaj 'dar e'Ra.du
O erro é muito mais poderoso que o acerto. Ele deixa consequências e sequelas. O acerto se normaliza rapidamente e logo mais ninguém notará.	u 'e.Ru E 'mu~j~.tu 'majs po.de'ro.zu ki u a'seX.tu, 'e.li 'dej.Sa ko~.se'kwe~.sjaz i se'kwE.las, u a'seX.tu si noR.ma'li.za Ra.pi.da~'me~.Ti i 'lO.gu 'majs ni~'ge~j~ no.ta'ra
Somos feitos para errar, para corrigir, para acertar e para decidir entre o erro e o acerto.	'so~.mus 'fej.tus 'pa.ra e'RaX, 'pa.ra ko.Ri'ZiX, 'pa.ra a.seX'tar i 'pa.ra de.si'Dir 'e~.tri u 'e.Ru i u a'seX.tu
Nesta vida o que mais me entres teço, quando eu erro ninguém se esquece, mas quando eu acerto ninguém se lembra	'nEs.ta 'vi.da u ki 'majs mi 'e~.tris 'te.su, 'kwa~.du ew 'E.Ru ni~'ge~j~ si es'kE.si, majs 'kwa~.du ew a'sEX.tu ni~'ge~j~ si 'le~.bra
A técnica de tentativa e erro deveria ser tratada como tentativa e acerto...	a 'tEk.ni.ka Di te~.ta'Ti.va i 'e.Ru de.ve'ri.a 'seX tra'ta.da 'ko~.mu te~.ta'Ti.va i a'seX.tu
Revoltar-te contra o próprio erro pode levar-te ao acerto, contra o erro alheio ao erro	Re.vow'taX Ti 'ko~.tra u 'prO.prju 'e.Ru 'pO.Di le'vaX Ti aw a'seX.tu, 'ko~.tra u 'e.Ru a'Lej.u aw 'e.Ru
Mais vale o erro no caminho da excelência do que o acerto no rumo da excrescência.	'majs 'va.li u 'e.Ru nu ka~'mi~.Ju da e.se'le~.sja du ki u a'seX.tu nu 'Ru~.mu da es.kre'se~.sja
Quando se tem a humildade de reconhecer um erro, certamente está se praticando o maior acerto.	'kwa~.du si te~j~ a u~.miw'da.Di Di Re.ko~.Je'ser u~ 'e.Ru, sEX.ta~'me~.Ti es'ta si pra.Ti'ka~.du u maj'Or a'seX.tu
Quem pisa no próximo esquece que o acerto é feito com Deus.	'ke~j~ 'pi.za nu 'prO.si~.mu es'kE.si ki u a'seX.tu E 'fej.tu ko~ 'dews
Nas coisas da vida as vezes acerto, as vezes erro mas vou vivendo e aprendendo dentro das minhas possibilidades, e Deus lá de cima vai vendo que estou tentando ser melhor, a cada novo dia eu renasço.	nas 'koj.zas da 'vi.da as 've.ziz a'sEX.tu, as 've.ziz 'E.Ru majs 'vow vi've~.du i a.pre~'de~.du 'de~.tru das 'mi~.Jas po.si.bi.li'da.Dis, i 'dews 'la Di 'si~.ma 'vaj 've~.du ki es'tow te~'ta~.du 'seR me'LOX, a 'ka.da 'no.vu 'Di.a ew Re~'na.su
Quando a lágrima lava a face, O orgulho enche o peito. De todos os erros também há o acerto. Divino e lindo amor, que supera barreiras, ainda estará a existir!	'kwa~.du a 'la.gri~.ma 'la.va a 'fa.si, u oR'gu.Lu 'e~.Si u 'pej.tu, Di 'to.duz uz 'e.Rus ta~'be~j~ 'a u a'seX.tu, Di'vi~.nu i 'li~.du a~'moX, ki su'pE.ra ba'Rej.ras, a'i~.da es.ta'ra a e.zis'TiX
Eu não vou lhe dizer Que não tenho defeitos Mas com eles me arrumo Me acerto, me ajeito Meu problema é um segredo Guardado no peito Que se chama paixão...	ew 'na~w~ 'vow Li Di'zeX ki 'na~w~ 'te~.Ju de'fej.tus majs ko~ 'e.lis mi a'Ru~.mu mi a'sEX.tu, mi a'Zej.tu 'mew pro'ble~.ma E u~ se'gre.du gwaR'da.du nu 'pej.tu ki si 'Sa~.ma paj'Sa~w~
Ao agirmos conscientemente no erro o inconsciente grita pedindo socorro ao acerto	aw a'ZiR.mus ko~.si.e~.Ti~'me~.Ti nu 'e.Ru u i~.ko~.si'e~.Ti 'gri.ta pe'Di~.du so'ko.Ru aw a'seX.tu
O segredo para sempre acertar é fazer de cada erro um acerto	u se'gre.du 'pa.ra 'se~.pri a.seX'tar E fa'zeR Di 'ka.da 'e.Ru u~ a'seX.tu
No pé de cada erro que se comete, existe o acerto que procura corrigir e colocar no rumo certo, de qualquer forma vem a disciplina.	nu 'pE Di 'ka.da 'e.Ru ki si ko~'mE.Ti, e'zis.Ti u a'seX.tu ki pro'ku.ra ko.Ri'Zir i ko.lo'kaR nu 'Ru~.mu 'sEX.tu, Di kwaw'kEX 'fOR.ma 've~j~ a Di.si'pli~.na
Cedo ou  tarde nos reuniremos  com Deus para  um acerto de contas. É bom termos  em  mãos  as chaves  de entrada para o segundo round.	'se.du ow 'taR.Di nus Re.u~.ni're~.mus ko~ 'dews 'pa.ra u~ a'seX.tu Di 'ko~.tas, E 'bo~ 'teR.muz e~j~ 'ma~w~z as 'Sa.vis Di e~'tra.da 'pa.ra u se'gu~.du 'Ra.u~w~.Di
Não custa errado fazer a coisa certa , pois dois erros não fazem um acerto, mas dois acertos podem apagar todos erros.	'na~w~ 'kus.ta e'Ra.du fa'zer a 'koj.za 'sEX.ta, 'pojs 'dojz 'e.Rus 'na~w~ 'fa.ze~j~ u~ a'seX.tu, majs 'dojz a'sEX.tus 'pO.de~j~ a.pa'gaX 'to.duz 'e.Rus
De tanto quererem que eu me corrigisse, deixei os erros de lado, já não erro mais, e nem acerto	Di 'ta~.tu ke're.re~j~ ki ew mi ko.Ri'Zi.si, dej'Sej uz 'e.Rus Di 'la.du, 'Za 'na~w~ 'E.Ru 'majs, i ne~j~ a'sEX.tu
Ter um alvo não siginifica acerto certeiro Não adianta ter um alvo sem mira precisa  Sem munição pra uma troca necessária ...	'ter u~ 'aw.vu 'na~w~ si.gi~.ni'fi.ka a'seX.tu seX'tej.ru 'na~w~ a.Di'a~.ta 'ter u~ 'aw.vu se~j~ 'mi.ra pre'si.za se~j~ mu~.ni'sa~w~ pra u~.ma 'trO.ka ne.se'sa.rja
A liberdade é o primeiro passo para o erro, o erro é um passo em direção ao acerto.	a li.beR'da.Di E u pri~'mej.ru 'pa.su 'pa.ra u 'e.Ru, u 'e.Ru E u~ 'pa.su e~j~ Di.re'sa~w~ aw a'seX.tu
Se de 10 tentativas  somente houve 1  acerto, as 9 tentativas foram aprendizado e aquele 1 acerto, é o amadurecimento	si Di 'dEjs te~.ta'Ti.vas sO~'me~.Ti 'ow.vi 'u~ a'seX.tu, as 'nO.vi te~.ta'Ti.vas 'fo.ra~w~ a.pre~.Di'za.du i a'ke.li 'u~ a'seX.tu, E u a~.ma.du.re.si~'me~.tu
Decerto, se nada der certo, eu acerto as coisas para que tudo dê certo. Certo?	de'sEX.tu, si 'na.da 'dEX 'sEX.tu, ew a'sEX.tu as 'koj.zas 'pa.ra ki 'tu.du 'de 'sEX.tu, 'sEX.tu
Com o tempo percebemos o que é erro, e o que é acerto.	ko~ u 'te~.pu peX.se'be~.muz u ki E 'e.Ru, i u ki E a'seX.tu
A lei do retorno é o acerto de contas com o bem ou com o mal, prevalece aquele que escapou por entre as frestas do seu coração	a 'lej du Re'toR.nu E u a'seX.tu Di 'ko~.tas ko~ u 'be~j~ ow ko~ u 'maw, pre.va'lE.si a'ke.li ki es.ka'pow pur 'e~.tri as 'frEs.tas du 'sew ko.ra'sa~w~
A Democracia é um processo de experimentação e erro, sem a qual não podemos chegar ao acerto.	a de~.mo.kra'si.a E u~ pro'sE.su Di es.pe.ri~.me~.ta'sa~w~ i 'e.Ru, se~j~ a 'kwaw 'na~w~ po'de~.mu.Se'gar aw a'seX.tu
Tudo é possível, o erro, o acerto, ganhar e perder. Mas pactuamos àquilo que nos interessa e o elevamos a aceitável. Somos todos hipócritas!	'tu.du E po'si.vew, u 'e.Ru, u a'seX.tu, ga~'Jar i peR'deX, majs pak.tu'a~.muz a'ki.lu ki nuz i~.te'rE.sa i u e.le'va~.muz a a.sej'ta.vew, 'so~.mus 'to.duz i'pO.kri.tas
Mas caráter é mais valioso, vai por mim. Entre mil erros e um acerto, nunca me confundi.	majs ka'ra.ter E 'majs va.li'o.zu, 'vaj puR 'mi~, 'e~.tri 'miw 'e.Ruz i 'u~ a'seX.tu, 'nu~.ka mi ko~.fu~'Di
Você é o erro que não devia ter acontecido, mas não se assuste, esse erro pode ser um acerto uma hora. Um acerto que tá demorando acontecer.	vo'se E u 'e.Ru ki 'na~w~ de'vi.a 'ter a.ko~.te'si.du, majs 'na~w~ si a'sus.Ti, 'e.si 'e.Ru 'pO.Di 'ser u~ a'seX.tu u~.ma 'O.ra, u~ a'seX.tu ki 'ta de~.mo'ra~.du a.ko~.te'seX
Sabe por quê isso tudo veio da minha cabeça, não sou robô. Eu falho, erro e depois acerto.	'sa.bi puX 'ke 'i.su 'tu.du 'vej.u da 'mi~.Ja ka'be.sa, 'na~w~ 'sow Ro'bo, ew 'fa.Lu, 'E.Ru i de'pojz a'sEX.tu
O acerto não é prerrogativa de quem não erra, mas de quem decide acertar. Não ter errado é um forte indício de que você sequer tentou.	u a'seX.tu 'na~w~ E pre.Ro.ga'Ti.va Di 'ke~j~ 'na~w~ 'E.Ra, majs Di 'ke~j~ de'si.Di a.seX'taX, 'na~w~ 'ter e'Ra.du E u~ 'fOX.Ti i~'Di.sju Di ki vo'se se'kEX te~'tow
A sabedoria do acerto está nas escolhas do começo. Eu decidi ser Gente!	a sa.be.do'ri.a du a'seX.tu es'ta naz es'ko.Las du ko~'me.su, ew de.si'Di 'seR 'Ze~.Ti
O acerto é fruto do conhecimento	u a'seX.tu E 'fru.tu du ko~.Je.si~'me~.tu
O rigor sem propósito traz muito mais desavenças do que acerto.	u Ri'goX se~j~ pro'pO.zi.tu 'trajz 'mu~j~.tu 'majs de.za've~.sas du ki a'seX.tu
Para a vitória basta apenas um acerto. Erre 99 vezes tentando mas acerte uma, assim você aprendeu 99 vezes para acertar.	'pa.ra a vi'tO.rja 'bas.ta a'pe~.naz 'u~ a'seX.tu, 'E.Ri no've~.ta i 'nO.vi 've.zis te~'ta~.du majz a'sEX.Ti u~.ma, a'si~ vo'se a.pre~'dew no've~.ta i 'nO.vi 've.zis 'pa.ra a.seX'taX
Quanto melhor for o juste do foco, mais preciso será o acerto do alvo.	'kwa~.tu me'LOX 'for u 'Zus.Ti du 'fO.ku, 'majs pre'si.zu se'ra u a'seX.tu du 'aw.vu
Meu querido  Meu cheiro Meu porto  Meu homem  Meu maior erro Meu acerto também   Meu lugar de paz Meu amor	'mew ke'ri.du 'mew 'Sej.ru 'mew 'poX.tu 'mew 'o~.me~j~ 'mew maj'Or 'e.Ru 'mew a'seX.tu ta~'be~j~ 'mew lu'gaR Di 'pajz 'mew a~'moX
Luta e esperança são forças irmãs. Acreditemos! A vida sempre permite o acerto, àqueles que se mantém firmes em seus propósitos de paz e bem!...	'lu.ta i es.pe'ra~.sa 'sa~w~ 'foX.saz iR'ma~j~s, a.kre.Di'te~.mus, a 'vi.da 'se~.pri peR'mi.Ti u a'seX.tu, a'ke.lis ki si ma~'te~j~ 'fiR.miz e~j~ 'sews pro'pO.zi.tus Di 'pajz i 'be~j~
Levo muitas pancadas, mas quando acerto o ponto fraco de um...	'lE.vu 'mu~j~.tas pa~'ka.das, majs 'kwa~.du a'sEX.tu u 'po~.tu 'fra.ku Di 'u~
O ser humano é um erro, acerto, qualidade, defeito.	u 'ser u~'ma~.nu E u~ 'e.Ru, a'seX.tu, kwa.li'da.Di, de'fej.tu
É por um erro que se nota a fraqueza então também será pelo acerto que notará a força, pois antes dogmas , e status , seres errôneos em ações livres, mais redimidos pelo arrependimento.	E pur u~ 'e.Ru ki si 'nO.ta a fra'ke.za e~'ta~w~ ta~'be~j~ se'ra 'pe.lu a'seX.tu ki no.ta'ra a 'foX.sa, 'pojz 'a~.Tis 'dO.gi~.mas, i 'sta.tus, 'se.riz e'Ro~.njuz e~j~ a'so~j~s 'li.vris, 'majs Re.Di~'mi.dus 'pe.lu a.Re.pe~.Di~'me~.tu
Com o erro eu aprendo e o acerto me ensina. NN	ko~ u 'e.Ru ew a'pre~.du i u a'seX.tu mi e~'si~.na, 'e~.ni 'e~.ni
Os erros existem, para que você eficazmente refaça, aprenda, transforme, até chegar ao acerto. Nara Nubia Alencar Queiroz  narinha. 164	uz 'e.Ruz e'zis.te~j~, 'pa.ra ki vo'se e.fi.kaz'me~.Ti Re'fa.sa, a'pre~.da, tra~s'fOR.mi, a'tE Se'gar aw a'seX.tu, 'na.ra nu'bi.a a.le~'kaX kej'rOjz na'ri~.Ja, 'se~.tu i se'se~.ta i 'kwa.tru
Meu maior acerto esteve na constância de meus erros	'mew maj'Or a'seX.tu es'te.vi na ko~s'ta~.sja Di 'mewz 'e.Rus
Durante a vida erramos e acertamos, porém, devemos focar no acerto e desviar do erro.	du'ra~.Ti a 'vi.da e'Ra~.muz i a.seX'ta~.mus, po're~j~, de've~.mus fo'kaR nu a'seX.tu i dez.vi'aR du 'e.Ru
O acerto é meu, o erro é a consequência do mérito, o medo é falta de êxito. A prudência é o equilíbrio que põe na balança o sim ou o não.	u a'seX.tu E 'mew, u 'e.Ru E a ko~.se'kwe~.sja du 'mE.ri.tu, u 'me.du E 'faw.ta Di 'e.zi.tu, a pru'de~.sja E u e.ki'li.brju ki 'po~j~ na ba'la~.sa u 'si~ ow u 'na~w~
A traição acaba com o relacionamento, o orgulho destrói toda chance de acerto, mas o perdão é fundamental para a relação fluir.	a traj'sa~w~ a'ka.ba ko~ u Re.la.si.o~.na~'me~.tu, u oR'gu.Lu des'trOj 'to.da 'Sa~.si Di a'seX.tu, majz u peR'da~w~ E fu~.da~.me~'taw 'pa.ra a Re.la'sa~w~ flu'iX
Você ganha uma vida para cada segundo. Um ciclo eterno de erro e acerto. Determinado por você mesmo.	vo'se 'ga~.Ja u~.ma 'vi.da 'pa.ra 'ka.da se'gu~.du, u~ 'si.klu e'tER.nu Di 'e.Ru i a'seX.tu, de.teR.mi~'na.du puR vo'se 'mez.mu
Nosso maior erro é confiar, Nosso maior acerto é acreditar, nossa maior virtude é se recuperar.	'nO.su maj'Or 'e.Ru E ko~.fi'aX, 'nO.su maj'Or a'seX.tu E a.kre.Di'taX, 'nO.sa maj'OR viX'tu.Di E si Re.ku.pe'raX
Pra perder o cliente basta um erro e para mantê-lo o acerto deve ser constante.	pra peR'der u kli'e~.Ti 'bas.ta 'u~ 'e.Ru i 'pa.ra ma~'te lu u a'seX.tu 'dE.vi 'seX ko~s'ta~.Ti
O sucesso não acontece em função dos acertos, mas pela ausência dos erros; o erro impede o acerto e o acerto não evita o erro. Não errar é mais lucrativo!	u su'sE.su 'na~w~ a.ko~'tE.si e~j~ fu~'sa~w~ duz a'seX.tus, majs 'pe.la aw'ze~.sja duz 'e.Rus, u 'e.Ru i~'pE.Di u a'seX.tu i u a'seX.tu 'na~w~ e'vi.ta u 'e.Ru, 'na~w~ e'Rar E 'majs lu.kra'Ti.vu
O acerto é a conclusão dos erros cometidos pelas tentativas de tentar acertar	u a'seX.tu E a ko~.klu'za~w~ duz 'e.Rus ko~.me'Ti.dus 'pe.las te~.ta'Ti.vas Di te~'tar a.seX'taX
efêmero  Para todos os  efeitos sou efêmero e brasileiro, a noite me liberto do incerto e acerto o meu diagnóstico, astro sem constelação poeta de boteco em ascensão.	e'fe~.me.ru 'pa.ra 'to.duz uz e'fej.tus 'sow e'fe~.me.ru i bra.zi'lej.ru, a 'noj.Ti mi li'bEX.tu du i~'sEX.tu i a'sEX.tu u 'mew Di.a.gi~'nos.Ti.ku, 'as.tru se~j~ ko~s.te.la'sa~w~ po'E.ta Di bo'tE.ku e~j~ a.se~'sa~w~
Grita o meu erro e cala-se em meu acerto - o contrário é um caso exponencial.	'gri.ta u 'mew 'e.Ru i 'ka.la si e~j~ 'mew a'seX.tu, u ko~'tra.rju E u~ 'ka.zu es.po~.ne~.si'aw
Quanto maiores forem as tentativas, mais próximas serão as probabilidades de acerto.	'kwa~.tu maj'O.ris 'fo.re~j~ as te~.ta'Ti.vas, 'majs 'prO.si~.mas se'ra~w~ as pro.ba.bi.li'da.Dis Di a'seX.tu
Para fugir do erro basta desafiar o acerto.	'pa.ra fu'ZiR du 'e.Ru 'bas.ta de.za.fi'ar u a'seX.tu
Talvez um dos maiores erros do homem tenha ocorrido em um acerto.	taw'vejz u~ dus maj'O.riz 'e.Rus du 'o~.me~j~ 'te~.Ja o.ko'Ri.du e~j~ u~ a'seX.tu
Se o acerto e o erro fazem parte do aprendizado, o Brasil já tem doutorado	si u a'seX.tu i u 'e.Ru 'fa.ze~j~ 'paX.Ti du a.pre~.Di'za.du, u bra'ziw 'Za te~j~ dow.to'ra.du
Acerto não traz conhecimento. O que é certo para você, pode não ser para o outro.	a'seX.tu 'na~w~ 'trajs ko~.Je.si~'me~.tu, u ki E 'sEX.tu 'pa.ra vo'se, 'pO.Di 'na~w~ 'seX 'pa.ra u 'ow.tru
A Jurisprudência e o acerto da justeza e a clareza da verdade dos torgados!!!	a Zu.ris.pru'de~.sja i u a'seX.tu da Zus'te.za i a kla're.za da veR'da.Di dus toR'ga.dus
Certo de que acertaria o acerto com meu patrão, acertei-o na cara por não ter acertado os cálculos da minha rescisão.	'sEX.tu Di ki a.seX.ta'ri.a u a'seX.tu ko~ 'mew pa'tra~w~, a.seX'tej u na 'ka.ra puR 'na~w~ 'ter a.seX'ta.du us 'kaw.ku.lus da 'mi~.Ja Re.si'za~w~
O acerto é consequência de um erro.	u a'seX.tu E ko~.se'kwe~.sja Di u~ 'e.Ru
Há sempre a hora do acerto e a hora do fracasso. Quando a vez do fracasso chegar, está em você decidir se prefere superar e obter o sucesso, ou reclamar e se tornar um fracassado por completo.	'a 'se~.pri a 'O.ra du a'seX.tu i a 'O.ra du fra'ka.su, 'kwa~.du a 'vejz du fra'ka.su Se'gaX, es'ta e~j~ vo'se de.si'DiX si pre'fE.ri su.pe'rar i ob'ter u su'sE.su, ow Re.kla~'mar i si toR'nar u~ fra.ka'sa.du puX ko~'plE.tu
100 tentativas, um acerto. Melhor que sem tentativas	'se~j~ te~.ta'Ti.vas, 'u~ a'seX.tu, me'LOX ki se~j~ te~.ta'Ti.vas
