É preciso demorar um tempo preparando o solo se quiser que ele acolha a semente.	E pre'si.zu de~.mo'rar u~ 'te~.pu pre.pa'ra~.du u 'sO.lu si ki'zEX ki 'e.li a'ko.La a se~'me~.Ti
Não sei por que resistimos a isso, por que resistimos a você.	'na~w~ 'sej puX 'ke Re.zis'Ti~.muz a 'i.su, puX 'ke Re.zis'Ti~.muz a vo'se
Agora parece meio idiota.	a'gO.ra pa'rE.si 'mej.u i.Di'O.ta
Tudo tem a ver com o momento da graça, Mack.	'tu.du te~j~ a 'veX ko~ u mo~'me~.tu da 'gra.sa, 'mE.ki
Se houvesse apenas um ser humano no universo, o sentido de tempo seria bastante simples.	si ow'vE.si a'pe~.naz 'u~ 'ser u~'ma~.nu nu u~.ni'vEX.su, u se~'Ti.du Di 'te~.pu se'ri.a bas'ta~.Ti 'si~.plis
Mas acrescente apenas mais um e, bem, você conhece a história.	majz a.kre'se~.Ti a'pe~.nas 'majz 'u~ i, 'be~j~, vo'se ko~'JE.si a is'tO.rja
Cada escolha cria ondulações ao longo do tempo e dos relacionamentos, ricocheteando em outras escolhas.	'ka.da es'ko.La 'kri.a o~.du.la'so~j~z aw 'lo~.gu du 'te~.pu i dus Re.la.si.o~.na~'me~.tus, Ri.ko.Se.te'a~.du e~j~ 'ow.traz es'ko.Las
E, a partir do que parece uma confusao enorme, Papai tece uma tapeçaria magnífica.	i, a paX'TiR du ki pa'rE.si u~.ma ko~.fu'zaw e~'nOR.mi, pa'paj 'tE.si u~.ma ta.pe.sa'ri.a ma.gi~'ni.fi.ka
Só papai pode resolver tudo isso e ela o faz com graça.	'sO pa'paj 'pO.Di Re.zow'veX 'tu.du 'i.su i 'E.la u 'fajs ko~ 'gra.sa
Então acho que tudo que posso fazer é seguí-la, concluiu Mack.	e~'ta~w~ 'a.Su ki 'tu.du ki 'pO.su fa'zer E se'gi la, ko~.klu'iw 'mE.ki
É, esse é o ponto.	E, 'e.si E u 'po~.tu
Agora você está começando a entender o que significa ser realmente humano.	a'gO.ra vo'se es'ta ko~.me'sa~.du a e~.te~'der u ki si.gi~.ni'fi.ka 'se.Re.aw'me~.Ti u~'ma~.nu
Chegaram à extremidade do cais e Jesus saltou nele.	Se'ga.ra~w~ a es.tre~.mi'da.Di du 'kajz i Ze'zujs saw'tow 'ne.li
Virando-se para ajudar Mack.	vi'ra~.du si 'pa.ra a.Zu'daR 'mE.ki
Juntos, sentaram-se na beira e balançaram os pés descalços na água, olhando os efeitos do vento na superfície do lago.	'Zu~.tus, se~'ta.ra~w~ si na 'bej.ra i ba.la~'sa.ra~w~ us 'pEjs des'kaw.sus na 'a.gwa, o'La~.du uz e'fej.tus du 've~.tu na su.peX'fi.si du 'la.gu
Mack foi o primeiro a romper o silêncio.	'mE.ki 'foj u pri~'mej.ru a Ro~'per u si'le~.sju
Eu estava vendo o céu quando vi Missy?	ew es'ta.va 've~.du u 'sEw 'kwa~.du 'vi 'mi.si
Era muito parecido com isso aqui.	'E.ra 'mu~j~.tu pa.re'si.du ko~ 'i.su a'ki
Bom, Mack, nosso destino final não é a imagem do Céu que você tem na cabeça.	'bo~, 'mE.ki, 'nO.su des'Ti~.nu fi~'naw 'na~w~ E a i~'ma.Ze~j~ du 'sEw ki vo'se te~j~ na ka'be.sa
Você sabe, a imagem de portões adornados e ruas de ouro.	vo'se 'sa.bi, a i~'ma.Ze~j~ Di poX'to~j~z a.doR'na.duz i 'Ru.as Di 'ow.ru
O Céu é uma nova purificação do universo, de modo que vai se parecer bastante com isso aqui.	u 'sEw E u~.ma 'nO.va pu.ri.fi.ka'sa~w~ du u~.ni'vEX.su, Di 'mO.du ki 'vaj si pa.re'seR bas'ta~.Ti ko~ 'i.su a'ki
Então que história é essa de portões adornados e ruas de ouro?	e~'ta~w~ ki is'tO.rja E 'E.sa Di poX'to~j~z a.doR'na.duz i 'Ru.as Di 'ow.ru
Esta, irmão, começou Jesus, deitando-se no cais e fechando os olhos por causa do calor e da claridade do dia, é uma imagem de mim e da mulher por quem eu sou apaixonado.	'Es.ta, iR'ma~w~, ko~.me'sow Ze'zujs, dej'ta~.du si nu 'kajz i fe'Sa~.du uz 'O.Lus puX 'kaw.za du ka'lor i da kla.ri'da.Di du 'Di.a, E u~.ma i~'ma.Ze~j~ Di 'mi~ i da mu'LEX puX 'ke~j~ ew 'sow a.paj.So~'na.du
Mack olhou para ver se ele estava brincando, mas obviamente não estava.	'mE.ki o'Low 'pa.ra 'veX si 'e.li es'ta.va bri~'ka~.du, majz Ob.vi.a~'me~.Ti 'na~w~ es'ta.va
É uma imagem da minha noiva, a Igreja: indivíduos que juntos formam uma cidade espiritual com um rio vivo fluindo no meio e nas duas margens, árvores crescendo com frutos que curam as feridas e os sofrimentos das nações.	E u~.ma i~'ma.Ze~j~ da 'mi~.Ja 'noj.va, a i'gre.Za, i~.Di'vi.dwus ki 'Zu~.tus 'fOR.ma~w~ u~.ma si'da.Di es.pi.ri.tu'aw ko~ u~ 'Ri.u 'vi.vu flu'i~.du nu 'mej.u i nas 'du.as 'maR.Ze~s, 'aR.vo.ris kre'se~.du ko~ 'fru.tus ki 'ku.ra~w~ as fe'ri.daz i us so.fri~'me~.tus das na'so~j~s
Essa cidade está sempre aberta e cada portão que dá acesso a ela é feito de uma única pérola...	'E.sa si'da.Di es'ta 'se~.pri a'bEX.ta i 'ka.da poX'ta~w~ ki 'da a'sE.su a 'E.la E 'fej.tu Di u~.ma 'u~.ni.ka 'pE.ro.la
Ele abriu um olho e olhou para Mack.	'e.li a'briw u~ 'o.Lu i o'Low 'pa.ra 'mE.ki
Isso sou eu!	'i.su 'sow ew
Ele percebeu a dúvida de Mack e explicou:	'e.li peX.se'bew a 'du.vi.da Di 'mE.ki i es.pli'kow
Pérolas, Mack. A única pedra preciosa feita de dor, sofrimento e, finalmente, morte.	'pE.ro.las, 'mE.ki, a 'u~.ni.ka 'pE.dra pre.si'O.za 'fej.ta Di 'doX, so.fri~'me~.tu i, fi~.naw'me~.Ti, 'mOX.Ti
Entendi. Você é a entrada, mas...	e~.te~'Di, vo'se E a e~'tra.da, majs
Mack parou, procurando as palavras certas.	'mE.ki pa'row, pro.ku'ra~.du as pa'la.vras 'sEX.tas
Você está falando da Igreja como essa mulher por quem está apaixonado.	vo'se es'ta fa'la~.du da i'gre.Za 'ko~.mu 'E.sa mu'LEX puX 'ke~j~ es'ta a.paj.So~'na.du
Tenho quase certeza que não conheço essa Igreja.	'te~.Ju 'kwa.zi seX'te.za ki 'na~w~ ko~'Je.su 'E.sa i'gre.Za
Ele se virou ligeiramente para o outro lado.	'e.li si vi'row li.Zej.ra~'me~.Ti 'pa.ra u 'ow.tru 'la.du
Não é certamente o lugar aonde eu vou aos domingos.	'na~w~ E sEX.ta~'me~.Ti u lu'gar a'o~.Di ew 'vow aws do~'mi~.gus
Disse mais para si mesmo, sem saber se era seguro falar em voz alta.	'Di.si 'majs 'pa.ra 'si 'mez.mu, se~j~ sa'beX si 'E.ra se'gu.ru fa'lar e~j~ 'vOjz 'aw.ta
Mack, isso é porque você só está vendo a instituição, que é um sistema feito pelo ser humano.	'mE.ki, 'i.su E puX'ke vo'se 'sO es'ta 've~.du a i~s.Ti.tuj'sa~w~, ki E u~ sis'te~.ma 'fej.tu 'pe.lu 'ser u~'ma~.nu
Não foi isso que eu vim construir.	'na~w~ 'foj 'i.su ki ew 'vi~ ko~s.tru'iX
Mack ficou meio abalado ouvindo Jesus falar de igreja desse modo, mas isso não chegou a surpreendê-lo.	'mE.ki fi'kow 'mej.u a.ba'la.du ow'vi~.du Ze'zujs fa'laR Di i'gre.Za 'de.si 'mO.du, majz 'i.su 'na~w~ Se'gow a suX.pre.e~'de lu
De fato, foi um alívio.	Di 'fa.tu, 'foj u~ a'li.vju
Então como posso fazer parte dessa Igreja? Dessa mulher pela qual você parece estar tão apaixonado?	e~'ta~w~ 'ko~.mu 'pO.su fa'zeX 'paX.Ti 'dE.sa i'gre.Za, 'dE.sa mu'LEX 'pe.la 'kwaw vo'se pa'rE.si es'taX 'ta~w~ a.paj.So~'na.du
É simples, Mack.	E 'si~.plis, 'mE.ki
É exatamente o que estamos fazendo agora, simplesmente isso, sendo abertos e disponíveis um para o outro.	E e.za.ta~'me~.Ti u ki es'ta~.mus fa'ze~.du a'gO.ra, si~.pliz'me~.Ti 'i.su, 'se~.du a'bEX.tuz i Dis.po~'ni.vejz 'u~ 'pa.ra u 'ow.tru
Minha Igreja têm a ver com as pessoas e a vida tem a ver com os relacionamentos.	'mi~.Ja i'gre.Za 'te~j~ a 'veX ko~ as pe'so.az i a 'vi.da te~j~ a 'veX ko~ us Re.la.si.o~.na~'me~.tus
Você pode construí-la.	vo'se 'pO.Di ko~s.tru'i la
É o meu trabalho e, na verdade, sou bastante bom nisso.	E u 'mew tra'ba.Lu i, na veR'da.Di, 'sow bas'ta~.Ti 'bo~ 'ni.su
Disse Jesus com um risinho.	'Di.si Ze'zujs ko~ u~ Ri'zi~.Ju
Para Mack essas palavras foram como um sopro de ar puro!	'pa.ra 'mE.ki 'E.sas pa'la.vras 'fo.ra~w~ 'ko~.mu u~ 'so.pru Di 'aX 'pu.ru
Não um monte de rituais exaustivos e uma longa lista de exigências, nada de reuniões intermináveis com pessoas desconhecidas.	'na~w~ u~ 'mo~.Ti Di Ri.tu'ajz e.zaws'Ti.vuz i u~.ma 'lo~.ga 'lis.ta Di e.zi'Ze~.sjas, 'na.da Di Re.u~.ni'o~j~z i~.teR.mi~'na.vejs ko~ pe'so.as des.ko~.Je'si.das
Simplesmente compartilhar a vida.	si~.pliz'me~.Ti ko~.paX.Ti'Lar a 'vi.da
Talvez tivesse entendido mal.	taw'vejs Ti'vE.si e~.te~'Di.du 'maw
Parecia simples demais.	pa.re'si.a 'si~.plis de~'majs
Por isso pensou duas vezes antes de mexer com o que estava começando a entender.	pur 'i.su pe~'sow 'du.as 've.ziz 'a~.Tis Di me'SeX ko~ u ki es'ta.va ko~.me'sa~.du a e~.te~'deX
Fazer seu monte confuso de perguntas nesse momento seria como jogar um bocado de lama num pequeno lago de águas límpidas.	fa'zeX 'sew 'mo~.Ti ko~'fu.zu Di peR'gu~.tas 'ne.si mo~'me~.tu se'ri.a 'ko~.mu Zo'gar u~ bo'ka.du Di 'la~.ma nu~ pe'ke~.nu 'la.gu Di 'a.gwas 'li~.pi.das
Foi tudo que disse.	'foj 'tu.du ki 'Di.si
Mack, você não precisa entender tudo. Simplesmente esteja comigo.	'mE.ki, vo'se 'na~w~ pre'si.za e~.te~'deX 'tu.du, si~.pliz'me~.Ti es'te.Za ko~'mi.gu
Depois de um momento ele decidiu se juntar a Jesus e deitou-se de costas ao lado dele, abrigando os olhos do sol para espiar as nuvens que passavam no início da tarde.	de'pojs Di u~ mo~'me~.tu 'e.li de.si'Diw si Zu~'tar a Ze'zujz i dej'tow si Di 'kOs.taz aw 'la.du 'de.li, a.bri'ga~.du uz 'O.Lus du 'sOw 'pa.ra es.pi'ar as 'nu.ve~s ki pa'sa.va~w~ nu i~'ni.sju da 'taR.Di
Bom, para ser honesto, admitiu, não estou desapontado, porque nunca me senti atraído pela rua do ouro.	'bo~, 'pa.ra 'ser o~'nEs.tu, a.Di~.mi'Tiw, 'na~w~ es'tow de.za.po~'ta.du, puX'ke 'nu~.ka mi se~'Ti a.tra'i.du 'pe.la 'Ru.a du 'ow.ru
Sempre achei meio chato.	'se~.pri a'Sej 'mej.u 'Sa.tu
Maravilhoso mesmo é estar aqui com você.	ma.ra.vi'Lo.zu 'mez.mu E es'tar a'ki ko~ vo'se
Um silêncio baixou enquanto Mack absorvia o momento.	u~ si'le~.sju baj'Sow e~'kwa~.tu 'mE.ki ab.soR'vi.a u mo~'me~.tu
Podia ouvir o sussurro do vento acariciando as árvores e o riso do riacho ali perto derramando-se no lago.	po'Di.a ow'vir u su'su.Ru du 've~.tu a.ka.ri.si'a~.du az 'aR.vo.riz i u 'Ri.zu du Ri'a.Su a'li 'pEX.tu de.Ra~'ma~.du si nu 'la.gu
O dia estava majestoso e o cenário era incrível.	u 'Di.a es'ta.va ma.Zes'to.zu i u se~'na.rju 'E.ra i~'kri.vew
Realmente desejo entender.	Re.aw'me~.Ti de'ze.Zu e~.te~'deX
Quer dizer, acho que o modo como vocês são é muito diferente de todo o negócio religioso em que fui criado e com o qual me acostumei.	'kER Di'zeX, 'a.Su ki u 'mO.du 'ko~.mu vo'sejs 'sa~w~ E 'mu~j~.tu Di.fe're~.Ti Di 'to.du u ne'gO.sju Re.li.Zi'o.zu e~j~ ki 'fuj kri'a.du i ko~ u 'kwaw mi a.kos.tu~'mej
Por mais bem-intencionada que seja, você sabe que a máquina religiosa é capaz de engolir as pessoas!	puR 'majs 'be~j~ i~.te~.si.o~'na.da ki 'se.Za, vo'se 'sa.bi ki a 'ma.ki~.na Re.li.Zi'O.za E ka'pajz Di e~.go'lir as pe'so.as
Disse Jesus num tom meio cortante.	'Di.si Ze'zujs nu~ 'to~ 'mej.u koX'ta~.Ti
Uma quantidade enorme das coisas que são feitas em meu nome não tem nada a ver comigo.	u~.ma kwa~.Ti'da.Di e~'nOR.mi das 'koj.zas ki 'sa~w~ 'fej.taz e~j~ 'mew 'no~.mi 'na~w~ te~j~ 'na.da a 'veX ko~'mi.gu
E frequentemente são muito contrárias aos meus propósitos.	i fre.kwe~.Ti~'me~.Ti 'sa~w~ 'mu~j~.tu ko~'tra.rjaz aws 'mews pro'pO.zi.tus
Você não gosta muito de religião e de instituições? perguntou Mack, sem saber se estava fazendo uma pergunta ou uma afirmação.	vo'se 'na~w~ 'gOs.ta 'mu~j~.tu Di Re.li.Zi'a~w~ i Di i~s.Ti.tuj'so~j~s, peR.gu~'tow 'mE.ki, se~j~ sa'beX si es'ta.va fa'ze~.du u~.ma peR'gu~.ta ow u~.ma a.fiR.ma'sa~w~
Eu não crio instituições.	ew 'na~w~ 'kri.u i~s.Ti.tuj'so~j~s
Nunca criei, nunca criarei.	'nu~.ka kri'ej, 'nu~.ka kri.a'rej
E a instituição do casamento?	i a i~s.Ti.tuj'sa~w~ du ka.za~'me~.tu
O casamento não é uma instituição.	u ka.za~'me~.tu 'na~w~ E u~.ma i~s.Ti.tuj'sa~w~
É um relacionamento.	E u~ Re.la.si.o~.na~'me~.tu
Jesus fez uma pausa e retomou, com a voz firme e paciente:	Ze'zujs 'fejz u~.ma 'paw.za i Re.to~'mow, ko~ a 'vOjs 'fiR.mi i pa.si'e~.Ti
Como eu disse, não crio instituições.	'ko~.mu ew 'Di.si, 'na~w~ 'kri.u i~s.Ti.tuj'so~j~s
Essa é uma ocupação dos que querem brincar de Deus.	'E.sa E u~.ma o.ku.pa'sa~w~ dus ki 'kE.re~j~ bri~'kaR Di 'dews
Portanto, não, não gosto muito de religiões e também não gosto de política nem de economia.	poX'ta~.tu, 'na~w~, 'na~w~ 'gOs.tu 'mu~j~.tu Di Re.li.Zi'o~j~z i ta~'be~j~ 'na~w~ 'gos.tu Di po'li.Ti.ka ne~j~ Di e.ko~.no~'mi.a
A expressão de Jesus ficou notavelmente sombria.	a es.pre'sa~w~ Di Ze'zujs fi'kow no.ta.vew'me~.Ti so~'bri.a
E por que deveria gostar?	i puX 'ke de.ve'ri.a gos'taX
É a trindade de terrores criada pelo ser humano que assola a Terra e engana aqueles de quem eu gosto.	E a tri~'da.Di Di te'Ro.ris kri'a.da 'pe.lu 'ser u~'ma~.nu ki a'sO.la a 'tE.Ra i e~'ga~.na a'ke.lis Di 'ke~j~ ew 'gOs.tu
Quantos tormentos e ansiedades relacionados a uma dessas três coisas as pessoas enfrentam!	'kwa~.tus toR'me~.tuz i a~.si.e'da.Dis Re.la.si.o~'na.duz a u~.ma 'dE.sas 'trejs 'koj.zaz as pe'so.az e~'fre~.ta~w~
Não sabia o que dizer.	'na~w~ sa'bi.a u ki Di'zeX
Tudo parecia um pouco excessivo.	'tu.du pa.re'si.a u~ 'pow.ku e.se'si.vu
Notando que os olhos de Mack estavam ficando vidrados, Jesus baixou o tom.	no'ta~.du ki uz 'O.Lus Di 'mE.ki es'ta.va~w~ fi'ka~.du vi'dra.dus, Ze'zujs baj'Sow u 'to~
Falando de modo simples, religião, política e economia são ferramentas terríveis que muitos usam para sustentar suas ilusões de segurança e controle.	fa'la~.du Di 'mO.du 'si~.plis, Re.li.Zi'a~w~, po'li.Ti.ka i e.ko~.no~'mi.a 'sa~w~ fe.Ra~'me~.tas te'Ri.vejs ki 'mu~j~.tuz 'u.za~w~ 'pa.ra sus.te~'taX 'su.az i.lu'zo~j~s Di se.gu'ra~.sa i ko~'tro.li
As pessoas tem medo da incerteza, do futuro.	as pe'so.as te~j~ 'me.du da i~.seX'te.za, du fu'tu.ru
Essas instituições, essas estruturas e ideologias são um esforço inútil de criar algum sentimento de certeza e segurança onde nada disso existe.	'E.saz i~s.Ti.tuj'so~j~s, 'E.saz es.tru'tu.raz i i.de.o.lo'Zi.as 'sa~w~ u~ es'foX.su i~'nu.Tiw Di kri'ar aw'gu~ se~.Ti~'me~.tu Di seX'te.za i se.gu'ra~.sa 'o~.Di 'na.da 'Di.su e'zis.Ti
É tudo falso!	E 'tu.du 'faw.su
Uau! Era tudo que Mack conseguia pensar.	u'aw, 'E.ra 'tu.du ki 'mE.ki ko~.se'gi.a pe~'saX
A paisagem que ele e praticamente todo mundo que ele conhecia haviam buscado para administrar e orientar a vida estava sendo reduzida a pouco mais do que entulho.	a paj'za.Ze~j~ ki 'e.li i pra.Ti.ka~'me~.Ti 'to.du 'mu~.du ki 'e.li ko~.Je'si.a a'vi.a~w~ bus'ka.du 'pa.ra a.Di~.mi~.nis'trar i o.ri.e~'tar a 'vi.da es'ta.va 'se~.du Re.du'zi.da a 'pow.ku 'majs du ki e~'tu.Lu
Então? Transformou a palavra numa pergunta.	e~'ta~w~, tra~s.foR'mow a pa'la.vra 'nu~.ma peR'gu~.ta
Eu vim lhes dar a vida na totalidade.	ew 'vi~ Lis 'dar a 'vi.da na to.ta.li'da.Di
Minha vida.	'mi~.Ja 'vi.da
Mack ainda estava se esforçando para entender.	'mE.ki a'i~.da es'ta.va si es.foX'sa~.du 'pa.ra e~.te~'deX
A simplicidade e a pureza de desfrutar de uma amizade crescente.	a si~.pli.si'da.Di i a pu're.za Di des.fru'taR Di u~.ma a~.mi'za.Di kre'se~.Ti
Ah, entendi!	'a, e~.te~'Di
Se você tentar viver isso sem mim, sem o diálogo constante que estabelecemos ao compartilhar esta jornada juntos, será como tentar andar sobre a água sozinho.	si vo'se te~'taR vi'ver 'i.su se~j~ 'mi~, se~j~ u Di'a.lo.gu ko~s'ta~.Ti ki es.ta.be.le'se~.muz aw ko~.paX.Ti'Lar 'Es.ta ZoR'na.da 'Zu~.tus, se'ra 'ko~.mu te~'tar a~'daX 'so.bri a 'a.gwa sO'zi~.Ju
Você não pode!	vo'se 'na~w~ 'pO.Di
E quando tenta, por mais bem-intencionado que seja, vai afundar.	i 'kwa~.du 'te~.ta, puR 'majs 'be~j~ i~.te~.si.o~'na.du ki 'se.Za, 'vaj a.fu~'daX
Apesar de saber a resposta, Jesus perguntou:	a.pe'zaR Di sa'ber a Res'pOs.ta, Ze'zujs peR.gu~'tow
Você já tentou salvar alguém que estivesse se afogando?	vo'se 'Za te~'tow saw'var aw'ge~j~ ki es.Ti'vE.si si a.fo'ga~.du
Os músculos de Mack se retesaram instantaneamente.	us 'mus.ku.lus Di 'mE.ki si Re.te'za.ra~w~ i~s.ta~.ta~.ne.a~'me~.Ti
Ele não gostava de se lembrar de Josh e da canoa, e um sentimento de pânico subitamente jorrou da lembrança.	'e.li 'na~w~ gos'ta.va Di si le~'braR Di 'ZOS i da ka~'no.a, i u~ se~.Ti~'me~.tu Di 'pa~.ni.ku su.bi.ta~'me~.Ti Zo'Row da le~'bra~.sa
É extremamente difícil resgatar alguém, a não ser que a pessoa esteja disposta a confiar em você.	E es.tre~.ma~'me~.Ti Di'fi.siw Rez.ga'tar aw'ge~j~, a 'na~w~ 'seX ki a pe'so.a es'te.Za Dis'pOs.ta a ko~.fi'ar e~j~ vo'se
É, sem dúvida.	E, se~j~ 'du.vi.da
É só isso que eu lhe peço.	E 'sO 'i.su ki ew Li 'pe.su
Quando você começar a afundar, deixe-me resgatá-lo	'kwa~.du vo'se ko~.me'sar a a.fu~'daX, 'dej.Si mi Res.ga'ta lu
Parecia um pedido simples, mas Mack estava acostumado a ser o salva-vidas e não o afogado.	pa.re'si.a u~ pe'Di.du 'si~.plis, majs 'mE.ki es'ta.va a.kos.tu~'ma.du a 'ser u 'saw.va 'vi.daz i 'na~w~ u a.fo'ga.du
Jesus, não sei bem como...	Ze'zujs, 'na~w~ 'sej 'be~j~ 'ko~.mu
Deixe-me mostrar.	'dej.Si mi mos'traX
Basta continuar me dando o pouco que você têm e juntos vamos vê-lo crescer.	'bas.ta ko~.Ti~.nu'aR mi 'da~.du u 'pow.ku ki vo'se 'te~j~ i 'Zu~.tus 'va~.mus 've lu kre'seX
Mack começou a calçar as meias e os sapatos.	'mE.ki ko~.me'sow a kaw'sar as 'mej.az i us sa'pa.tus
Sentado aqui com você, neste momento, não parece tão difícil.	se~'ta.du a'ki ko~ vo'se, 'nes.Ti mo~'me~.tu, 'na~w~ pa'rE.si 'ta~w~ Di'fi.siw
Mas quando penso na minha vida normal, em casa, não sei como manter o que você sugere.	majs 'kwa~.du 'pe~.su na 'mi~.Ja 'vi.da noR'maw, e~j~ 'ka.za, 'na~w~ 'sej 'ko~.mu ma~'ter u ki vo'se su'ZE.ri
Estou preso na mesma necessidade de controle que todo mundo têm.	es'tow 'pre.zu na 'mez.ma ne.se.si'da.Di Di ko~'tro.li ki 'to.du 'mu~.du 'te~j~
Não sei como mudar tudo isso.	'na~w~ 'sej 'ko~.mu mu'daX 'tu.du 'i.su
Ninguém está pedindo que mude!	ni~'ge~j~ es'ta pe'Di~.du ki 'mu.Di
Disse Jesus com ternura.	'Di.si Ze'zujs ko~ teR'nu.ra
Esta é uma tarefa para Sarayu e ela sabe como fazer sem agredir ninguém.	'Es.ta E u~.ma ta'rE.fa 'pa.ra sa.ra'ju i 'E.la 'sa.bi 'ko~.mu fa'zeX se~j~ a.gre'DiR ni~'ge~j~
O importante é saber que tudo é um processo e não um acontecimento.	u i~.poX'ta~.Ti E sa'beX ki 'tu.du E u~ pro'sE.su i 'na~w~ u~ a.ko~.te.si~'me~.tu
Só quero que você confie em mim o pouco que puder e que cresça no amor pelas pessoas ao seu redor com o mesmo amor que compartilho com você.	'sO 'kE.ru ki vo'se ko~'fi.i e~j~ 'mi~ u 'pow.ku ki pu'dEr i ki 'kre.sa nu a~'moX 'pe.las pe'so.az aw 'sew Re'dOX ko~ u 'mez.mu a~'moX ki ko~.paX'Ti.Lu ko~ vo'se
Não cabe a você mudá-las nem convencê-las.	'na~w~ 'ka.bi a vo'se mu'da las ne~j~ ko~.ve~'se las
Você está livre para amar sem qualquer obrigação.	vo'se es'ta 'li.vri 'pa.ra a~'maX se~j~ kwaw'kEr o.bri.ga'sa~w~
É isso que quero aprender.	E 'i.su ki 'kE.ru a.pre~'deX
É mesmo. Jesus piscou.	E 'mez.mu, Ze'zujs pis'kow
Jesus se levantou, espreguiçou-se e Mack o imitou.	Ze'zujs si le.va~'tow, es.pre.gi'sow si i 'mE.ki u i~.mi'tow
Quantas mentiras me contaram! admitiu ele.	'kwa~.tas me~'Ti.ras mi ko~'ta.ra~w~, a.Di~.mi'Tiw 'e.li
Jesus olhou para ele, puxou-o e o abraçou.	Ze'zujz o'Low 'pa.ra 'e.li, pu'Sow u i u a.bra'sow
Eu sei, Mack, a mim também.	ew 'sej, 'mE.ki, a 'mi~ ta~'be~j~
Simplesmente não acreditei nelas.	si~.pliz'me~.Ti 'na~w~ a.kre.Di'tej 'nE.las
Juntos, começaram a andar pelo cais.	'Zu~.tus, ko~.me'sa.ra~w~ a a~'daX 'pe.lu 'kajs
Quando se aproximavam da margem voltaram a diminuir o passo.	'kwa~.du si a.pro.si~'ma.va~w~ da 'maR.Ze~j~ vow'ta.ra~w~ a Di~.mi~.nu'ir u 'pa.su
Jesus colocou a mão no ombro de Mack e virou-o gentilmente, até ficarem cara a cara.	Ze'zujs ko.lo'kow a 'ma~w~ nu 'o~.bru Di 'mE.ki i vi'row u Ze~.Tiw'me~.Ti, a'tE fi'ka.re~j~ 'ka.ra a 'ka.ra
Mack, o sistema do mundo é o que é.	'mE.ki, u sis'te~.ma du 'mu~.du E u ki E
As instituições, as ideologias e todos os esforços vãos e inúteis da humanidade estão em toda parte e é impossível deixar de interagir com tudo isso.	az i~s.Ti.tuj'so~j~s, az i.de.o.lo'Zi.az i 'to.duz uz es'fOX.sus 'va~w~z i i~'nu.tejs da u~.ma~.ni'da.Di es'ta~w~ e~j~ 'to.da 'paX.Ti i E i~.po'si.vew dej'SaR Di i~.te.ra'ZiX ko~ 'tu.du 'i.su
Mas eu posso lhe dar liberdade para superar qualquer sistema de poder em que você se encontre, seja ele religioso, econômico, social ou político.	majz ew 'pO.su Li 'daR li.beR'da.Di 'pa.ra su.pe'raX kwaw'kEX sis'te~.ma Di po'der e~j~ ki vo'se si e~'ko~.tri, 'se.Za 'e.li Re.li.Zi'o.zu, e.ko~'no~.mi.ku, so.si'aw ow po'li.Ti.ku
Você terá uma liberdade cada vez maior de estar dentro ou fora de todos os tipos de sistemas e de se mover livremente entre eles.	vo'se te'ra u~.ma li.beR'da.Di 'ka.da 'vejz maj'OR Di es'taR 'de~.tru ow 'fO.ra Di 'to.duz us 'Ti.pus Di sis'te~.maz i Di si mo'veR li.vri~'me~.Ti 'e~.tri 'e.lis
Juntos, você e eu podemos estar dentro do sistema e não fazer parte dele.	'Zu~.tus, vo'se i ew po'de~.muz es'taR 'de~.tru du sis'te~.ma i 'na~w~ fa'zeX 'paX.Ti 'de.li
Mas tanta gente de quem eu gosto parece fazer parte do sistema!	majs 'ta~.ta 'Ze~.Ti Di 'ke~j~ ew 'gOs.tu pa'rE.si fa'zeX 'paX.Ti du sis'te~.ma
Mack estava pensando nos amigos, nas pessoas da igreja que haviam expressado amor por ele e sua família.	'mE.ki es'ta.va pe~'sa~.du nuz a~'mi.gus, nas pe'so.as da i'gre.Za ki a'vi.a~w~ es.pre'sa.du a~'moX pur 'e.li i 'su.a fa~'mi.lja
Sabia que elas amavam Jesus, mas que também eram totalmente vendidas para a atividade religiosa e o patriotismo.	sa'bi.a ki 'E.laz a~'ma.va~w~ Ze'zujs, majs ki ta~'be~j~ 'E.ra~w~ to.taw'me~.Ti ve~'Di.das 'pa.ra a a.Ti.vi'da.Di Re.li.Zi'O.za i u pa.tri.o'Tiz.mu
Mack, eu as amo.	'mE.ki, ew az 'a~.mu
E você comete um erro julgando-as.	i vo'se ko~'mE.Ti u~ 'e.Ru Zuw'ga~.du as
Devemos encontrar modos de amar e servir os que estão dentro do sistema, não acha?	de've~.muz e~.ko~'traR 'mO.dus Di a~'mar i seR'vir us ki es'ta~w~ 'de~.tru du sis'te~.ma, 'na~w~ 'a.Sa
Lembre-se, as pessoas que me conhecem são aquelas que estão livres para viver e amar sem qualquer compromisso.	'le~.bri si, as pe'so.as ki mi ko~'JE.se~j~ 'sa~w~ a'kE.las ki es'ta~w~ 'li.vris 'pa.ra vi'ver i a~'maX se~j~ kwaw'kEX ko~.pro~'mi.su
É isso que significa ser cristão?	E 'i.su ki si.gi~.ni'fi.ka 'seX kris'ta~w~
Achou-se meio idiota ao dizer isso, mas era como se estivesse tentando resumir tudo na cabeça.	a'Sow si 'mej.u i.Di'O.ta aw Di'zer 'i.su, majz 'E.ra 'ko~.mu si es.Ti'vE.si te~'ta~.du Re.zu~'miX 'tu.du na ka'be.sa
Quem disse alguma coisa sobre ser cristão?	'ke~j~ 'Di.si aw'gu~.ma 'koj.za 'so.bri 'seX kris'ta~w~
Eu não sou cristão.	ew 'na~w~ 'sow kris'ta~w~
A idéia pareceu estranha e inesperada para Mack e ele não pôde evitar uma risada.	a i'dEj.a pa.re'sew es'tra~.Ja i i~.nes.pe'ra.da 'pa.ra 'mE.ki i 'e.li 'na~w~ 'po.Di e.vi'tar u~.ma Ri'za.da
Não, acho que não é.	'na~w~, 'a.Su ki 'na~w~ E
Chegaram a porta da carpintaria.	Se'ga.ra~w~ a 'pOX.ta da kaX.pi~.ta'ri.a
De novo Jesus parou.	Di 'no.vu Ze'zujs pa'row
Os que me amam estão em todos os sistemas que existem.	us ki mi 'a~.ma~w~ es'ta~w~ e~j~ 'to.duz us sis'te~.mas ki e'zis.te~j~
São budistas ou mórmons, batistas ou muçulmanos, democratas, republicanos e muitos que não votam nem fazem parte de qualquer instituição religiosa.	'sa~w~ bu'Dis.taz ow 'mOR.mo~s, ba'Tis.taz ow mu.suw'ma~.nus, de~.mo'kra.tas, Re.pu.bli'ka~.nuz i 'mu~j~.tus ki 'na~w~ 'vO.ta~w~ ne~j~ 'fa.ze~j~ 'paX.Ti Di kwaw'kEr i~s.Ti.tuj'sa~w~ Re.li.Zi'O.za
Tenho seguidores que foram assassinos e muitos que eram hipócritas.	'te~.Ju se.gi'do.ris ki 'fo.ra~w~ a.sa'si~.nuz i 'mu~j~.tus ki 'E.ra~w~ i'pO.kri.tas
Há banqueiros, jogadores, americanos e iraquianos, judeus e palestinos.	'a ba~'kej.rus, Zo.ga'do.ris, a~.me.ri'ka~.nuz i i.ra.ki'a~.nus, Zu'dewz i pa.les'Ti~.nus
Não tenho desejo de torná-los cristãos, mas quero me juntar a eles em seu processo para se transformarem em filhos e filhas do Papai, em irmãos e irmãs, em meus amados.	'na~w~ 'te~.Ju de'ze.Zu Di toR'na lus kris'ta~w~s, majs 'kE.ru mi Zu~'tar a 'e.liz e~j~ 'sew pro'sE.su 'pa.ra si tra~s.foR'ma.re~j~ e~j~ 'fi.Luz i 'fi.Las du pa'paj, e~j~ iR'ma~w~z i iR'ma~j~s, e~j~ 'mewz a~'ma.dus
De jeito nenhum, sorriu Jesus enquanto estendia a mão para a porta da oficina.	Di 'Zej.tu ne~'Ju~, so'Riw Ze'zujz e~'kwa~.tu es.te~'Di.a a 'ma~w~ 'pa.ra a 'pOX.ta da o.fi'si~.na
A maioria das estradas não leva a lugar nenhum.	a maj.o'ri.a daz es'tra.das 'na~w~ 'lE.va a lu'gaR ne~'Ju~
O que isso significa é que eu viajarei por qualquer estrada para encontrar vocês.	u ki 'i.su si.gi~.ni'fi.ka E ki ew vi.a.Za'rej puX kwaw'kEr es'tra.da 'pa.ra e~.ko~'traR vo'sejs
Fez uma pausa.	'fejz u~.ma 'paw.za
Mack, tenho algumas coisas para terminar na carpintaria; encontro você mais tarde.	'mE.ki, 'te~.Ju aw'gu~.mas 'koj.zas 'pa.ra teR.mi~'naR na kaX.pi~.ta'ri.a, e~'ko~.tru vo'se 'majs 'taR.Di
Certo. O que quer que eu faça?	'sEX.tu, u ki 'kEX ki ew 'fa.sa
O que quiser, Mack, a tarde é sua.	u ki ki'zEX, 'mE.ki, a 'taR.Di E 'su.a
Jesus deu-lhe um tapa no ombro e riu.	Ze'zujs 'dew Li u~ 'ta.pa nu 'o~.bru i 'Riw
Uma última coisa: lembra-se de antes, quando me agradeceu por tê-lo deixado ver Missy?	u~.ma 'uw.Ti~.ma 'koj.za, 'le~.bra si Di 'a~.Tis, 'kwa~.du mi a.gra.de'sew puR 'te lu dej'Sa.du 'veR 'mi.si
Foi idéia de papai.	'foj i'dEj.a Di pa'paj
Depois de dizer isso ele se virou e acenou por cima do ombro enquanto entrava na oficina.	de'pojs Di Di'zer 'i.su 'e.li si vi'row i a.se~'now puX 'si~.ma du 'o~.bru e~'kwa~.tu e~'tra.va na o.fi'si~.na
Mack soube instantâneamente o que queria fazer e foi para a cabana, em busca de Papai.	'mE.ki 'sow.bi i~s.ta~'ta~.ne.a~.me~.Ti u ki ke'ri.a fa'zer i 'foj 'pa.ra a ka'ba~.na, e~j~ 'bus.ka Di pa'paj
Enquanto se aproximava da cabana, Mack sentiu um cheiro delicioso que se desprendia de alguma coisa no forno.	e~'kwa~.tu si a.pro.si~'ma.va da ka'ba~.na, 'mE.ki se~'Tiw u~ 'Sej.ru de.li.si'o.zu ki si des.pre~'Di.a Di aw'gu~.ma 'koj.za nu 'foR.nu
Talvez tivesse se passado apenas uma hora desde o almoço, mas era como se ele não tivesse comido havia horas.	taw'vejs Ti'vE.si si pa'sa.du a'pe~.naz u~.ma 'O.ra 'dez.Di u aw'mo.su, majz 'E.ra 'ko~.mu si 'e.li 'na~w~ Ti'vE.si ko~'mi.du a'vi.a 'O.ras
O aroma da comida o conduziu até a cozinha.	u a'ro~.ma da ko~'mi.da u ko~.du'ziw a'tE a ko'zi~.Ja
Mas quando chegou a porta dos fundos ficou surpreso e desapontado ao ver que o local estava vazio.	majs 'kwa~.du Se'gow a 'pOX.ta dus 'fu~.dus fi'kow suX'pre.zu i de.za.po~'ta.du aw 'veX ki u lo'kaw es'ta.va va'zi.u
Tem alguém aí? chamou.	te~j~ aw'ge~j~ a'i, Sa~'mow
Estou na varanda, Mack, a voz de Papai veio através da janela aberta.	es'tow na va'ra~.da, 'mE.ki, a 'vOjz Di pa'paj 'vej.u a.tra'vEjs da Za~'nE.la a'bEX.ta
Pegue alguma coisa para beber e venha para cá.	'pE.gi aw'gu~.ma 'koj.za 'pa.ra be'ber i 've~.Ja 'pa.ra 'ka
Papai estava reclinada numa velha cadeira, de olhos fechados, absorvendo o sol.	pa'paj es'ta.va Re.kli~'na.da 'nu~.ma 'vE.La ka'dej.ra, Di 'O.Lus fe'Sa.dus, ab.soR've~.du u 'sOw
O que é isso?	u ki E 'i.su
Deus tem tempo de pegar um solzinho?	'dews te~j~ 'te~.pu Di pe'gar u~ sow'zi~.Ju
Não tem nada melhor para fazer nesta tarde?	'na~w~ te~j~ 'na.da me'LOX 'pa.ra fa'zeR 'nEs.ta 'taR.Di
Você não faz idéia do que estou fazendo neste momento.	vo'se 'na~w~ 'fajz i'dEj.a du ki es'tow fa'ze~.du 'nes.Ti mo~'me~.tu
Mack se encaminhou para outra cadeira do lado oposto e, enquanto ele se sentava, Papai abriu um dos olhos.	'mE.ki si e~.ka~.mi~'Jow 'pa.ra 'ow.tra ka'dej.ra du 'la.du o'pos.tu i, e~'kwa~.tu 'e.li si se~'ta.va, pa'paj a'briw 'u~ duz 'O.Lus
Sobre uma mesinha entre os dois havia uma bandeja cheia de bolos de aparência maravilhosa, manteiga fresca e vários tipos de geléia.	'so.bri u~.ma me'zi~.Ja 'e~.tri us 'dojz a'vi.a u~.ma ba~'de.Za 'Sej.a Di 'bo.lus Di a.pa're~.sja ma.ra.vi'LO.za, ma~'tej.ga 'fres.ka i 'va.rjus 'Ti.pus Di Ze'lEj.a
Uau, o cheiro é fantástico! exclamou ele.	u'aw, u 'Sej.ru E fa~'tas.Ti.ku, es.kla~'mow 'e.li
Pode mergulhar de cabeça.	'pO.Di meR.gu'LaR Di ka'be.sa
É uma receita que peguei da sua bisavó.	E u~.ma Re'sej.ta ki pe'gej da 'su.a bi.za'vO
Ela riu.	'E.la 'Riw
Mack mordeu um dos bolinhos.	'mE.ki moR'dew 'u~ dus bo'li~.Jus
Ainda estava quente e praticamente derreteu na boca.	a'i~.da es'ta.va 'ke~.Ti i pra.Ti.ka~'me~.Ti de.Re'tew na 'bo.ka
Uau! Isso é bom! Obrigado!	u'aw, 'i.su E 'bo~, o.bri'ga.du
Bom, você terá de agradecer à sua bisavó quando a vir.	'bo~, vo'se te'ra Di a.gra.de'ser a 'su.a bi.za'vO 'kwa~.du a 'viX
Espero que não seja muito em breve, disse Mack entre duas mordidas.	es'pE.ru ki 'na~w~ 'se.Za 'mu~j~.tu e~j~ 'brE.vi, 'Di.si 'mE.ki 'e~.tri 'du.as moR'Di.das
Você não gostaria de saber? perguntou Papai com uma piscadela brincalhona e voltando a fechar os olhos.	vo'se 'na~w~ gos.ta'ri.a Di sa'beX, peR.gu~'tow pa'paj ko~ u~.ma pis.ka'dE.la bri~.ka'Lo~.na i vow'ta~.du a fe'Sar uz 'O.Lus
Enquanto comia outro bolinho, Mack juntou coragem para abrir o coração.	e~'kwa~.tu ko~'mi.a 'ow.tru bo'li~.Ju, 'mE.ki Zu~'tow ko'ra.Ze~j~ 'pa.ra a'brir u ko.ra'sa~w~
Perguntou e, pela primeira vez, chamar Deus de Papai não pareceu estranho.	peR.gu~'tow i, 'pe.la pri~'mej.ra 'vejs, Sa~'maR 'dews Di pa'paj 'na~w~ pa.re'sew es'tra~.Ju
Sim, Mack? respondeu ela, abrindo os olhos e sorrindo com prazer.	'si~, 'mE.ki, Res.po~'dew 'E.la, a'bri~.du uz 'O.Luz i so'Ri~.du ko~ pra'zeX
Eu fui muito duro com você.	ew 'fuj 'mu~j~.tu 'du.ru ko~ vo'se
Humm, Sophia deve tê-lo afetado.	Ruw~, so'fi.a 'dE.vi 'te lu a.fe'ta.du
Nem fale!	ne~j~ 'fa.li
Eu não fazia idéia de que estava julgando você.	ew 'na~w~ fa'zi.a i'dEj.a Di ki es'ta.va Zuw'ga~.du vo'se
Foi terrivelmente arrogante.	'foj te.Ri.vew'me~.Ti a.Ro'ga~.Ti
Porque você estava mesmo, respondeu Papai com um sorriso.	puX'ke vo'se es'ta.va 'mez.mu, Res.po~'dew pa'paj ko~ u~ so'Ri.zu
Sinto muito. Eu realmente não fazia idéia...	'si~.tu 'mu~j~.tu, ew Re.aw'me~.Ti 'na~w~ fa'zi.a i'dEj.a
Mack balançou a cabeça, triste.	'mE.ki ba.la~'sow a ka'be.sa, 'tris.Ti
Mas agora isso está no passado, que é o lugar onde deve estar.	majz a'gO.ra 'i.su es'ta nu pa'sa.du, ki E u lu'gar 'o~.Di 'dE.vi es'taX
Não quero que fique triste com isso, Mack.	'na~w~ 'kE.ru ki 'fi.ki 'tris.Ti ko~ 'i.su, 'mE.ki
Só quero que possamos crescer juntos.	'sO 'kE.ru ki po'sa~.mus kre'seR 'Zu~.tus
Também quero, disse Mack pegando outro bolinho.	ta~'be~j~ 'kE.ru, 'Di.si 'mE.ki pe'ga~.du 'ow.tru bo'li~.Ju
Não vai comer nenhum?	'na~w~ 'vaj ko~'meR ne~'Ju~
Não, vá em frente.	'na~w~, 'va e~j~ 'fre~.Ti
Você sabe como é, a gente vai provando uma coisa e outra e acaba usando todo o apetite. Aproveite.	vo'se 'sa.bi 'ko~.mu E, a 'Ze~.Ti 'vaj pro'va~.du u~.ma 'koj.za i 'ow.tra i a'ka.ba u'za~.du 'to.du u a.pe'Ti.Ti, a.pro'vej.Ti
Empurrou a bandeja na direção dele.	e~.pu'Row a ba~'de.Za na Di.re'sa~w~ 'de.li
Mack pegou mais um bolinho e recostou-se para saboreá-lo.	'mE.ki pe'gow 'majz u~ bo'li~.Ju i Re.kos'tow si 'pa.ra sa.bo.re'a lu
Jesus disse que foi você quem me deu um tempo com Missy esta tarde.	Ze'zujs 'Di.si ki 'foj vo'se 'ke~j~ mi 'dew u~ 'te~.pu ko~ 'mi.si 'Es.ta 'taR.Di
Não sei como agradecer!	'na~w~ 'sej 'ko~.mu a.gra.de'seX
Ah, de nada, querido.	'a, Di 'na.da, ke'ri.du
Isso também me deu uma grande alegria!	'i.su ta~'be~j~ mi 'dew u~.ma 'gra~.Di a.le'gri.a
Eu estava tão ansiosa para colocar vocês dois juntos que mal conseguia esperar.	ew es'ta.va 'ta~w~ a~.si'O.za 'pa.ra ko.lo'kaR vo'sejs 'doj'Zu~.tus ki 'maw ko~.se'gi.a es.pe'raX
Gostaria tanto que Nan estivesse aqui!	gos.ta'ri.a 'ta~.tu ki 'na~ es.Ti'vE.si a'ki
Teria sido perfeito! concordou Papai, empolgada.	te'ri.a 'si.du peX'fej.tu, ko~.koR'dow pa'paj, e~.pow'ga.da
Ficaram em silêncio por alguns instantes.	fi'ka.ra~w~ e~j~ si'le~.sju pur aw'gu~z i~s'ta~.Tis
Missy não é especial?	'mi.si 'na~w~ E es.pe.si'aw
Ela balançou a cabeça sorrindo.	'E.la ba.la~'sow a ka'be.sa so'Ri~.du
Minha nossa, gosto especialmente daquela menina.	'mi~.Ja 'nO.sa, 'gOs.tu es.pe.si.aw'me~.Ti da'kE.la me~'ni~.na
Mack deu um sorriso largo e pensou na sua princesa atrás da cachoeira.	'mE.ki 'dew u~ so'Ri.zu 'laR.gu i pe~'sow na 'su.a pri~'se.za a'trajs da ka.So'ej.ra
Espere um minuto!	es'pE.ri u~ mi~'nu.tu
Papai ficou olhando enquanto as peças se encaixavam.	pa'paj fi'kow o'La~.du e~'kwa~.tu as 'pE.sas si e~.kaj'Sa.va~w~
Obviamente você conhece o fascínio da minha filha por cachoeiras e pela lenda da princesa Multnomah.	Ob.vi.a~'me~.Ti vo'se ko~'JE.si u fa'si~.nju da 'mi~.Ja 'fi.La puX ka.So'ej.raz i 'pe.la 'le~.da da pri~'se.za muw.Ti~.no~'ma
Papai assentiu.	pa'paj a.se~'Tiw
É disso que se trata?	E 'Di.su ki si 'tra.ta
Ela teve de morrer para que você me mudasse?	'E.la 'te.vi Di mo'ReX 'pa.ra ki vo'se mi mu'da.si
Espere aí, Mack. Papai se inclinou.	es'pE.ri a'i, 'mE.ki, pa'paj si i~.kli~'now
Não é assim que eu faço as coisas.	'na~w~ E a'si~ ki ew 'fa.su as 'koj.zas
Mas ela adorava tanto aquela história!	majz 'E.la a.do'ra.va 'ta~.tu a'kE.la is'tO.rja
Claro que sim.	'kla.ru ki 'si~
As histórias sobre uma pessoa disposta a trocar sua vida pela de outra são um fio de ouro em seu mundo e revelam tanto suas necessidades quanto o meu coração.	az is'tO.rjas 'so.bri u~.ma pe'so.a Dis'pOs.ta a tro'kaX 'su.a 'vi.da 'pe.la Di 'ow.tra 'sa~w~ u~ 'fi.u Di 'ow.ru e~j~ 'sew 'mu~.du i Re'vE.la~w~ 'ta~.tu 'su.as ne.se.si'da.Dis 'kwa~.tu u 'mew ko.ra'sa~w~
Mas se ela não tivesse morrido eu não estaria aqui agora...	majs si 'E.la 'na~w~ Ti'vE.si mo'Ri.du ew 'na~w~ es.ta'ri.a a'ki a'gO.ra
Mack, eu crio um bem incrível a partir de tragédias indescritíveis.	'mE.ki, ew 'kri.u u~ 'be~j~ i~'kri.vew a paX'TiR Di tra'ZE.Djaz i~.des.kri'Ti.vejs
Mas isso não significa que as orquestre.	majz 'i.su 'na~w~ si.gi~.ni'fi.ka ki az oX'kEs.tri
Nunca pense que o fato de eu usar algo para um bem maior significa que eu o provoquei ou que preciso dele para realizar meus propósitos.	'nu~.ka 'pe~.si ki u 'fa.tu Di ew u'zar 'aw.gu 'pa.ra u~ 'be~j~ maj'OX si.gi~.ni'fi.ka ki ew u pro.vo'kej ow ki pre'si.zu 'de.li 'pa.ra Re.a.li'zaR 'mews pro'pO.zi.tus
A graça não depende da existência do sofrimento, mas onde há sofrimento você encontrará a graça de inúmeras maneiras.	a 'gra.sa 'na~w~ de'pe~.Di da e.zis'te~.sja du so.fri~'me~.tu, majz 'o~.Di 'a so.fri~'me~.tu vo'se e~.ko~.tra'ra a 'gra.sa Di i~'nu~.me.ras ma~'nej.ras
Na verdade, isso é um alívio.	na veR'da.Di, 'i.su E u~ a'li.vju
Eu não suportaria pensar que minha dor poderia ter cortado a vida dela.	ew 'na~w~ su.poX.ta'ri.a pe~'saX ki 'mi~.Ja 'doX po.de'ri.a 'teX koX'ta.du a 'vi.da 'dE.la
Ela não foi seu sacrifício, Mack.	'E.la 'na~w~ 'foj 'sew sa.kri'fi.sju, 'mE.ki
Ela é e sempre será sua alegria.	'E.la E i 'se~.pri se'ra 'su.a a.le'gri.a
Este é um propósito suficiente para Missy.	'es.Ti E u~ pro'pO.zi.tu su.fi.si'e~.Ti 'pa.ra 'mi.si
Mack se recostou de novo na cadeira, examinando a vista da varanda.	'mE.ki si Re.kos'tow Di 'no.vu na ka'dej.ra, e.za~.mi~'na~.du a 'vis.ta da va'ra~.da
Estou me sentindo preenchido!	es'tow mi se~'Ti~.du pre.e~'Si.du
Bom, você comeu quase todos os bolinhos.	'bo~, vo'se ko~'mew 'kwa.zi 'to.duz us bo'li~.Jus
Não é isso, ele riu, e você sabe.	'na~w~ E 'i.su, 'e.li 'Riw, i vo'se 'sa.bi
O mundo simplesmente parece mil vezes mais luminoso e estou me sentindo mil vezes mais leve.	u 'mu~.du si~.pliz'me~.Ti pa'rE.si 'miw 've.zis 'majs lu~.mi~'no.zu i es'tow mi se~'Ti~.du 'miw 've.zis 'majs 'lE.vi
E está, Mack!	i es'ta, 'mE.ki
Não é fácil ser o juiz de todo o mundo.	'na~w~ E 'fa.siw 'ser u Zu'iz Di 'to.du u 'mu~.du
O sorriso de Papai tranquilizou Mack, que se sentia pisando em terreno seguro.	u so'Ri.zu Di pa'paj tra~.kwi.li'zow 'mE.ki, ki si se~'Ti.a pi'za~.du e~j~ te'Re~.nu se'gu.ru
Ou julgar você.	ow Zuw'gaR vo'se
Havia me enganado totalmente com relacão a quem você é na minha vida.	a'vi.a mi e~.ga~'na.du to.taw'me~.Ti ko~ Re.la'ka~w~ a 'ke~j~ vo'se E na 'mi~.Ja 'vi.da
Não totalmente, Mack.	'na~w~ to.taw'me~.Ti, 'mE.ki
Nós tivemos alguns momentos maravilhosos também.	'nOjs Ti've~.muz aw'gu~s mo~'me~.tus ma.ra.vi'LO.zus ta~'be~j~
Mas sempre gostei mais de Jesus do que de você.	majs 'se~.pri gos'tej 'majs Di Ze'zujs du ki Di vo'se
Ele parecia tão bondoso e você tão...	'e.li pa.re'si.a 'ta~w~ bo~'do.zu i vo'se 'ta~w~
Má? É triste, não é?	'ma, E 'tris.Ti, 'na~w~ E
Jesus veio para mostrar como eu sou, e a maioria só acredita nisso com relação a ele.	Ze'zujs 'vej.u 'pa.ra mos'traX 'ko~.mu ew 'sow, i a maj.o'ri.a 'sO a.kre'Di.ta 'ni.su ko~ Re.la'sa~w~ a 'e.li
Ainda acham que fazemos o gênero policial bom policial mau, especialmente as pessoas religiosas.	a'i~.da 'a.Sa~w~ ki fa'ze~.muz u 'Ze~.ne.ru po.li.si'aw bo~ po.li.si'aw 'maw, es.pe.si.aw'me~.Ti as pe'so.as Re.li.Zi'O.zas
Quando querem que os outros façam o que elas acham certo, precisam de um Deus severo.	'kwa~.du 'kE.re~j~ ki uz 'ow.trus 'fa.sa~w~ u ki 'E.laz 'a.Sa~w~ 'sEX.tu, pre'si.za~w~ Di u~ 'dews se'vE.ru
Quando precisam de perdão, correm para Jesus.	'kwa~.du pre'si.za~w~ Di peR'da~w~, 'kO.Re~j~ 'pa.ra Ze'zujs
É isso mesmo, concordou Mack.	E 'i.su 'mez.mu, ko~.koR'dow 'mE.ki
Mas nós estávamos nele.	majs 'nOjz es'ta.va~.mus 'ne.li
Ele refletia exatamente o meu coração.	'e.li Re.fle'Ti.a e.za.ta~'me~.Ti u 'mew ko.ra'sa~w~
Eu amo vocês e os convido a me amarem.	ew 'a~.mu vo'sejz i us ko~'vi.du a mi a~'ma.re~j~
Mas por que eu?	majs puX 'ke ew
Quer dizer, por que Mackenzie Allen Phillips?	'kER Di'zeX, puX 'ke ma'ke~.zi 'a.le~ 'fi.lips
Por que você ama alguém tão ferrado?	puX 'ke vo'se 'a~.ma aw'ge~j~ 'ta~w~ fe'Ra.du
Porque é isso que o amor faz, respondeu Papai.	puX'ke E 'i.su ki u a~'moX 'fajs, Res.po~'dew pa'paj
Lembre-se, Mackenzie, eu não fico pensando nas escolhas que você fará.	'le~.bri si, ma'ke~.zi, ew 'na~w~ 'fi.ku pe~'sa~.du naz es'ko.Las ki vo'se fa'ra
Eu já sei.	ew 'Za 'sej
Vamos imaginar, por exemplo, que estou tentando ensinar você a não se esconder dentro de mentiras, ela piscou.	'va~.muz i~.ma.Zi~'naX, pur e'ze~.plu, ki es'tow te~'ta~.du e~.si~'naR vo'se a 'na~w~ si es.ko~'deR 'de~.tru Di me~'Ti.ras, 'E.la pis'kow
E digamos que eu sei que você vai ter que passar por 47 situações antes de me ouvir com clareza suficiente para concordar comigo e mudar.	i Di'ga~.mus ki ew 'sej ki vo'se 'vaj 'teX ki pa'saX puX kwa're~.ta i 'sE.Ti si.tu.a'so~j~z 'a~.Tis Di mi ow'viX ko~ kla're.za su.fi.si'e~.Ti 'pa.ra ko~.koR'daX ko~'mi.gu i mu'daX
Então, quando na primeira vez você não me ouve, não fico frustrada nem desapontada, fico empolgada.	e~'ta~w~, 'kwa~.du na pri~'mej.ra 'vejz vo'se 'na~w~ mi 'ow.vi, 'na~w~ 'fi.ku frus'tra.da ne~j~ de.za.po~'ta.da, 'fi.ku e~.pow'ga.da
Só faltam 46 vezes.	'sO 'faw.ta~w~ kwa're~.ta i 'sejs 've.zis
E essa primeira vez será um tijolo para construir uma ponte de cura que um dia, que hoje, você atravessará.	i 'E.sa pri~'mej.ra 'vejs se'ra u~ Ti'Zo.lu 'pa.ra ko~s.tru'ir u~.ma 'po~.Ti Di 'ku.ra ki u~ 'Di.a, ki 'o.Zi, vo'se a.tra.ve.sa'ra
Certo, agora estou me sentindo culpado, admitiu ele.	'sEX.tu, a'gO.ra es'tow mi se~'Ti~.du kuw'pa.du, a.Di~.mi'Tiw 'e.li
Sério, Mackenzie, isso não têm nada a ver com culpa.	'sE.rju, ma'ke~.zi, 'i.su 'na~w~ 'te~j~ 'na.da a 'veX ko~ 'kuw.pa
A culpa jamais vai ajudá-lo a encontrar a liberdade em mim.	a 'kuw.pa Za~'majs 'vaj a.Zu'da lu a e~.ko~'trar a li.beR'da.Di e~j~ 'mi~
O máximo de que ela é capaz é fazer você se esforçar mais para se ajustar a alguma ética exterior.	u 'ma.si~.mu Di ki 'E.la E ka'pajz E fa'zeR vo'se si es.foX'saR 'majs 'pa.ra si a.Zus'tar a aw'gu~.ma 'E.Ti.ka es.te.ri'oX
Eu me importo com o interior.	ew mi i~'pOX.tu ko~ u i~.te.ri'oX
Mas o que você disse...	majz u ki vo'se 'Di.si
Quero dizer, sobre se esconder atrás de mentiras.	'kE.ru Di'zeX, 'so.bri si es.ko~'der a'trajs Di me~'Ti.ras
Acho que fiz isso, de um modo ou de outro, durante a maior parte da vida.	'a.Su ki 'fiz 'i.su, Di u~ 'mO.du ow Di 'ow.tru, du'ra~.Ti a maj'OX 'paX.Ti da 'vi.da
Querido, você é um sobrevivente.	ke'ri.du, vo'se E u~ so.bre.vi've~.Ti
Não há vergonha nisso.	'na~w~ 'a veR'go~.Ja 'ni.su
Seu pai machucou você de um modo feroz.	'sew 'paj ma.Su'kow vo'se Di u~ 'mO.du fe'rOjs
A vida machucou você.	a 'vi.da ma.Su'kow vo'se
As mentiras são um dos lugares mais fáceis para onde os sobreviventes correm.	as me~'Ti.ras 'sa~w~ 'u~ dus lu'ga.ris 'majs 'fa.sejs 'pa.ra 'o~.Di us so.bre.vi've~.Tis 'kO.Re~j~
Elas dão um sentimento de segurança, um lugar onde você só precisa contar consigo mesmo.	'E.las 'da~w~ u~ se~.Ti~'me~.tu Di se.gu'ra~.sa, u~ lu'gar 'o~.Di vo'se 'sO pre'si.za ko~'taX ko~'si.gu 'mez.mu
Mas é um lugar escuro, não é?	majz E u~ lu'gar es'ku.ru, 'na~w~ E
Demais, murmurou Mack balançando a cabeça.	de~'majs, muR.mu'row 'mE.ki ba.la~'sa~.du a ka'be.sa
Mas você está disposto a abrir mão do poder e da segurança que esse lugar lhe promete?	majs vo'se es'ta Dis'pos.tu a a'briR 'ma~w~ du po'der i da se.gu'ra~.sa ki 'e.si lu'gaR Li pro~'mE.Ti
Esta é a questão.	'Es.ta E a kes'ta~w~
Como assim? perguntou Mack olhando-a.	'ko~.mu a'si~, peR.gu~'tow 'mE.ki o'La~.du a
As mentiras são uma pequena fortaleza onde você pode se sentir seguro e poderoso.	as me~'Ti.ras 'sa~w~ u~.ma pe'ke~.na foX.ta'le.za 'o~.Di vo'se 'pO.Di si se~'TiX se'gu.ru i po.de'ro.zu
Dentro de sua pequena fortaleza de mentiras você tenta governar sua vida e manipular os outros.	'de~.tru Di 'su.a pe'ke~.na foX.ta'le.za Di me~'Ti.ras vo'se 'te~.ta go.veR'naX 'su.a 'vi.da i ma~.ni.pu'lar uz 'ow.trus
Mas a fortaleza precisa de muros, por isso você constrói alguns.	majz a foX.ta'le.za pre'si.za Di 'mu.rus, pur 'i.su vo'se ko~s'trOj aw'gu~s
Os muros são as justificativas para suas mentiras.	us 'mu.rus 'sa~w~ a.Zus.Ti.fi.ka'Ti.vas 'pa.ra 'su.as me~'Ti.ras
Você sabe, como se estivesse fazendo isso para proteger alguém que você ama ou para impedir que essa pessoa sinta dor.	vo'se 'sa.bi, 'ko~.mu si es.Ti'vE.si fa'ze~.du 'i.su 'pa.ra pro.te'Zer aw'ge~j~ ki vo'se 'a~.ma ow 'pa.ra i~.pe'DiX ki 'E.sa pe'so.a 'si~.ta 'doX
Qualquer coisa que funcione para que você se sinta bem com as mentiras.	kwaw'kEX 'koj.za ki fu~.si'o~.ni 'pa.ra ki vo'se si 'si~.ta 'be~j~ ko~ as me~'Ti.ras
Mas o motivo pelo qual não contei a Nan sobre o bilhete foi porque isso iria lhe causar muita dor.	majz u mo'Ti.vu 'pe.lu 'kwaw 'na~w~ ko~'tej a 'na~ 'so.bri u bi'Le.Ti 'foj puX'ke 'i.su i'ri.a Li kaw'zaR 'mu~j~.ta 'doX
Está vendo, Mackenzie, como você precisa se justificar?	es'ta 've~.du, ma'ke~.zi, 'ko~.mu vo'se pre'si.za si Zus.Ti.fi'kaX
O que você disse é uma mentira descarada, mas você não consegue ver.	u ki vo'se 'Di.si E u~.ma me~'Ti.ra des.ka'ra.da, majs vo'se 'na~w~ ko~'sE.gi 'veX
Ela se inclinou para a frente.	'E.la si i~.kli~'now 'pa.ra a 'fre~.Ti
Quer que eu lhe diga qual é a verdade?	'kEX ki ew Li 'Di.ga 'kwaw E a veR'da.Di
Mack sabia que Papai estava indo fundo, mas ainda assim sentiu alívio e ficou tentado a quase rir alto.	'mE.ki sa'bi.a ki pa'paj es'ta.va 'i~.du 'fu~.du, majz a'i~.da a'si~ se~'Tiw a'li.vju i fi'kow te~'ta.du a 'kwa.zi 'Rir 'aw.tu
Estava a vontade.	es'ta.va a vo~'ta.Di
na ã ão, respondeu lentamente e deu um risinho para ela.	na a~ 'a~w~, Res.po~'dew le~.ta~'me~.Ti i 'dew u~ Ri'zi~.Ju 'pa.ra 'E.la
Mas vá em frente, de qualquer modo.	majs 'va e~j~ 'fre~.Ti, Di kwaw'kER 'mO.du
Ela sorriu de volta, depois ficou séria.	'E.la so'Riw Di 'vOw.ta, de'pojs fi'kow 'sE.rja
A verdade, Mack, é que o motivo real para você ter mentido a Nan não foi para evitar que ela sofresse.	a veR'da.Di, 'mE.ki, E ki u mo'Ti.vu Re'aw 'pa.ra vo'se 'teR me~'Ti.du a 'na~ 'na~w~ 'foj 'pa.ra e.vi'taX ki 'E.la so'fre.si
O verdadeiro motivo foi que você estava com medo de enfrentar as emoções que poderiam surgir, tanto as dela quanto as suas.	u veR.da'dej.ru mo'Ti.vu 'foj ki vo'se es'ta.va ko~ 'me.du Di e~.fre~'tar az e~.mo'so~j~s ki po.de'ri.a~w~ suR'ZiX, 'ta~.tu as 'dE.la 'kwa~.tu as 'su.as
As emoções o amedrontam Mack.	az e~.mo'so~j~z u a~.me'dro~.ta~w~ 'mE.ki
Você mentiu para se proteger e não para protegê-la!	vo'se me~'Tiw 'pa.ra si pro.te'Zer i 'na~w~ 'pa.ra pro.te'Ze la
Ele se recostou.	'e.li si Re.kos'tow
Papai estava absolutamente certa.	pa'paj es'ta.va ab.so.lu.ta~'me~.Ti 'sEX.ta
E, além disso, continuou ela, uma mentira dessas é desamor.	i, a'le~j~ 'Di.su, ko~.Ti~.nu'ow 'E.la, u~.ma me~'Ti.ra 'dE.saz E de.za~'moX
Tendo como justificativa o fato de se importar com Nan, sua mentira prejudicou seu relacionamento com ela e o relacionamento dela comigo.	'te~.du 'ko~.mu Zus.Ti.fi.ka'Ti.va u 'fa.tu Di si i~.poX'taX ko~ 'na~, 'su.a me~'Ti.ra pre.Zu.Di'kow 'sew Re.la.si.o~.na~'me~.tu ko~ 'E.la i u Re.la.si.o~.na~'me~.tu 'dE.la ko~'mi.gu
Se você tivesse contado, talvez ela estivesse conosco aqui, agora.	si vo'se Ti'vE.si ko~'ta.du, taw'vejz 'E.la es.Ti'vE.si ko~'nos.ku a'ki, a'gO.ra
Você queria que ela viesse tambem?	vo'se ke'ri.a ki 'E.la vi'E.si ta~'be~j~
Isso seria uma decisão sua e dela, se ela tivesse tido a chance de tomá-lo.	'i.su se'ri.a u~.ma de.si'za~w~ 'su.a i 'dE.la, si 'E.la Ti'vE.si 'Ti.du a 'Sa~.si Di to~'ma lu
O ponto, Mack, é que você não sabe o que teria acontecido porque estava ocupado demais tentando proteger a Nan.	u 'po~.tu, 'mE.ki, E ki vo'se 'na~w~ 'sa.bi u ki te'ri.a a.ko~.te'si.du puX'ke es'ta.va o.ku'pa.du de~'majs te~'ta~.du pro.te'Zer a 'na~
De novo ele estava afundando na culpa.	Di 'no.vu 'e.li es'ta.va a.fu~'da~.du na 'kuw.pa
Então o que faço agora?	e~'ta~w~ u ki 'fa.su a'gO.ra
Conte a ela, Mackenzie.	'ko~.Ti a 'E.la, ma'ke~.zi
Enfrente o medo de sair do escuro e conte a ela, peça perdão e deixe que o perdão dela o cure.	e~'fre~.Ti u 'me.du Di sa'iR du es'ku.ru i 'ko~.Ti a 'E.la, 'pE.sa peR'da~w~ i 'dej.Si ki u peR'da~w~ 'dE.la u 'ku.ri
Peça que ela ore por você, Mack.	'pE.sa ki 'E.la 'O.ri puR vo'se, 'mE.ki
Assuma os riscos da honestidade.	a'su~.ma us 'Ris.kus da o~.nes.Ti'da.Di
Quando fizer outra besteira, peça perdão de novo.	'kwa~.du fi'zEr 'ow.tra bes'tej.ra, 'pE.sa peR'da~w~ Di 'no.vu
É um processo, querido, e a vida é suficientemente real sem precisar ser obscurecida por mentiras.	E u~ pro'sE.su, ke'ri.du, i a 'vi.da E su.fi.si.e~.Ti~'me~.Ti Re'aw se~j~ pre.si'zaX 'ser obs.ku.re'si.da puR me~'Ti.ras
É, lembre-se eu sou maior do que as suas mentiras.	E, 'le~.bri si ew 'sow maj'OR du ki as 'su.as me~'Ti.ras
Posso agir para além delas.	'pO.su a'ZiX 'pa.ra a'le~j~ 'dE.las
Mas isso não as torna certas nem impede o dano que elas causam ou a dor que provocam nos outros.	majz 'i.su 'na~w~ as 'tOR.na 'sEX.tas ne~j~ i~'pE.Di u 'da~.nu ki 'E.las 'kaw.za~w~ ow a 'doX ki pro'vO.ka~w~ nuz 'ow.trus
E se ela não me perdoar?	i si 'E.la 'na~w~ mi peR.do'aX
Mack sabia que esse era um medo muito profundo com o qual convivia.	'mE.ki sa'bi.a ki 'e.si 'E.ra u~ 'me.du 'mu~j~.tu pro'fu~.du ko~ u 'kwaw ko~.vi'vi.a
Era mais seguro continuar lançando novas mentiras na pilha crescente das velhas.	'E.ra 'majs se'gu.ru ko~.Ti~.nu'aR la~'sa~.du 'nO.vas me~'Ti.ras na 'pi.La kre'se~.Ti das 'vE.Las
Ah, esse é o risco da fé, Mack.	'a, 'e.si E u 'Ris.ku da 'fE, 'mE.ki
A fé não cresce na casa da certeza.	a 'fE 'na~w~ 'krE.si na 'ka.za da seX'te.za
Não estou aqui para lhe dizer que Nan vai perdoá-lo.	'na~w~ es'tow a'ki 'pa.ra Li Di'zeX ki 'na~ 'vaj peR.do'a lu
Talvez ela não queira ou não possa, mas minha vida dentro de você vai tomar conta do risco e da incerteza para transformá-lo.	taw'vejz 'E.la 'na~w~ 'kej.ra ow 'na~w~ 'pO.sa, majs 'mi~.Ja 'vi.da 'de~.tru Di vo'se 'vaj to~'maX 'ko~.ta du 'Ris.ku i da i~.seX'te.za 'pa.ra tra~s.foR'ma lu
Por meio de suas escolhas, você passará a ser um contador de verdades e esse será um milagre muito maior do que ressuscitar os mortos.	puR 'mej.u Di 'su.az es'ko.Las, vo'se pa.sa'ra a 'ser u~ ko~.ta'doR Di veR'da.Diz i 'e.si se'ra u~ mi'la.gri 'mu~j~.tu maj'OR du ki Re.su.si'tar us 'mOX.tus
Mack se recostou e deixou que as palavras assentassem.	'mE.ki si Re.kos'tow i dej'Sow ki as pa'la.vraz a.se~'ta.se~j~
Por favor, perdoe-me, disse finalmente.	puX fa'voX, peR'do.i mi, 'Di.si fi~.naw'me~.Ti
Já fiz isso há muito tempo, Mack.	'Za 'fiz 'i.su 'a 'mu~j~.tu 'te~.pu, 'mE.ki
Se não acredita, pergunte a Jesus.	si 'na~w~ a.kre'Di.ta, peR'gu~.Ti a Ze'zujs
Ele estava lá.	'e.li es'ta.va 'la
Mack tomou um gole de café, surpreso ao descobrir que a bebida continuava quente.	'mE.ki to~'mow u~ 'gO.li Di ka'fE, suX'pre.zu aw des.ko'briX ki a be'bi.da ko~.Ti~.nu'a.va 'ke~.Ti
Mas eu me esforcei tremendamente para trancar você do lado de fora da minha vida.	majz ew mi es.foX'sej tre~.me~.da~'me~.Ti 'pa.ra tra~'kaR vo'se du 'la.du Di 'fO.ra da 'mi~.Ja 'vi.da
As pessoas são persistentes quando se trata de garantir sua independência imaginária.	as pe'so.as 'sa~w~ peX.sis'te~.Tis 'kwa~.du si 'tra.ta Di ga.ra~'TiX 'su.a i~.de.pe~'de~.sja i~.ma.Zi~'na.rja
Elas acumulam e guardam a doença como se fosse um bem precioso.	'E.laz a.ku~'mu.la~w~ i 'gwaR.da~w~ a do'e~.sa 'ko~.mu si 'fo.si u~ 'be~j~ pre.si'o.zu
Encontram sua identidade e seu valor na mutilação e os guardam com cada grama de força que possuem.	e~'ko~.tra~w~ 'su.a i.de~.Ti'da.Di i 'sew va'loR na mu.Ti.la'sa~w~ i us 'gwaR.da~w~ ko~ 'ka.da 'gra~.ma Di 'foX.sa ki po'su.e~j~
Não é de espantar que a graça seja tão pouco atraente.	'na~w~ E Di es.pa~'taX ki a 'gra.sa 'se.Za 'ta~w~ 'pow.ku a.tra'e~.Ti
Nesse sentido você tentou trancar a porta do seu coração por dentro.	'ne.si se~'Ti.du vo'se te~'tow tra~'kar a 'pOX.ta du 'sew ko.ra'sa~w~ puR 'de~.tru
Mas não consegui.	majs 'na~w~ ko~.se'gi
Porque meu amor é muito maior do que sua estupidez, disse Papai, com uma piscadela.	puX'ke 'mew a~'mor E 'mu~j~.tu maj'OR du ki 'su.a es.tu.pi'dejs, 'Di.si pa'paj, ko~ u~.ma pis.ka'dE.la
Eu usei suas escolhas para atingir meus propósitos.	ew u'zej 'su.az es'ko.Las 'pa.ra a.Ti~'ZiR 'mews pro'pO.zi.tus
Há muitas pessoas como você, Mackenzie, que terminam se trancando num lugar muito pequeno com um monstro que acabara traindo-as, que não as preencherá nem lhes dará o que elas imaginavam.	'a 'mu~j~.tas pe'so.as 'ko~.mu vo'se, ma'ke~.zi, ki teR'mi~.na~w~ si tra~'ka~.du nu~ lu'gaR 'mu~j~.tu pe'ke~.nu ko~ u~ 'mo~s.tru ki a.ka'ba.ra tra'i~.du as, ki 'na~w~ as pre.e~.Se'ra ne~j~ Lis da'ra u ki 'E.laz i~.ma.Zi~'na.va~w~
Quando ficam prisioneiras de um terror desses, têm de novo a oportunidade de retornar para mim.	'kwa~.du 'fi.ka~w~ pri.zi.o~'nej.ras Di u~ te'RoR 'de.sis, 'te~j~ Di 'no.vu a o.poX.tu~.ni'da.Di Di Re.toR'naX 'pa.ra 'mi~
O tesouro em que elas confiavam se tornará seu desastre.	u te'zow.ru e~j~ ki 'E.las ko~.fi'a.va~w~ si toR.na'ra 'sew de'zas.tri
Então você usa a dor para forçar as pessoas a voltar?	e~'ta~w~ vo'se 'u.za a 'doX 'pa.ra foX'sar as pe'so.az a vow'taX
Era óbvio que Mack não aprovava isso.	'E.ra 'Ob.vju ki 'mE.ki 'na~w~ a.pro'va.va 'i.su
Papai se inclinou e tocou gentilmente a mão de Mack.	pa'paj si i~.kli~'now i to'kow Ze~.Tiw'me~.Ti a 'ma~w~ Di 'mE.ki
Querido, eu também o perdoei por pensar que eu poderia ser assim.	ke'ri.du, ew ta~'be~j~ u peR.do'ej puX pe~'saX ki ew po.de'ri.a 'ser a'si~
Entendo como é difícil para você começar a perceber, quanto mais imaginar, o que são o verdadeiro amor e a bondade.	e~'te~.du 'ko~.mu E Di'fi.siw 'pa.ra vo'se ko~.me'sar a peX.se'beX, 'kwa~.tu 'majz i~.ma.Zi~'naX, u ki 'sa~w~ u veR.da'dej.ru a~'mor i a bo~'da.Di
Porque você está tão perdido em suas percepções da realidade e ao mesmo tempo tão seguro de seus julgamentos.	puX'ke vo'se es'ta 'ta~w~ peR'Di.du e~j~ 'su.as peX.sep'so~j~s da Re.a.li'da.Di i aw 'mez.mu 'te~.pu 'ta~w~ se'gu.ru Di 'sew.Zuw.ga~'me~.tus
O amor verdadeiro nunca força.	u a~'moR veR.da'dej.ru 'nu~.ka 'fOX.sa
Ela apertou a mão dele e se recostou na cadeira.	'E.la a.peX'tow a 'ma~w~ 'de.li i si Re.kos'tow na ka'dej.ra
Mas, se eu entendi o que está dizendo, as consequências de nosso egoísmo fazem parte do processo que nos leva ao fim de nossas ilusões e nos ajuda a encontrar você.	majs, si ew e~.te~'Di u ki es'ta Di'ze~.du, as ko~.se'kwe~.sjas Di 'nO.su e.go'iz.mu 'fa.ze~j~ 'paX.Ti du pro'sE.su ki nus 'lE.va aw 'fi~ Di 'nO.saz i.lu'zo~j~z i nuz a'Zu.da a e~.ko~'traR vo'se
É por isso que você não impede as coisas ruins que nos acontecem?	E pur 'i.su ki vo'se 'na~w~ i~'pE.Di as 'koj.zas Ru'i~s ki nuz a.ko~'tE.se~j~
Por isso não me avisou que Missy estava correndo perigo nem nos ajudou a encontrá-la?	pur 'i.su 'na~w~ mi a.vi'zow ki 'mi.si es'ta.va ko'Re~.du pe'ri.gu ne~j~ nuz a.Zu'dow a e~.ko~'tra la
O tom de acusação estava ausente da voz de Mack.	u 'to~ Di a.ku.za'sa~w~ es'ta.va aw'ze~.Ti da 'vOjz Di 'mE.ki
Se ao menos fosse tão simples, Mackenzie!	si aw 'me~.nus 'fo.si 'ta~w~ 'si~.plis, ma'ke~.zi
Ninguém sabe de que horrores eu salvei o mundo, porque as pessoas não podem ver as coisas que jamais aconteceram.	ni~'ge~j~ 'sa.bi Di ki o'Ro.riz ew saw'vej u 'mu~.du, puX'ke as pe'so.as 'na~w~ 'pO.de~j~ 'ver as 'koj.zas ki Za~'majz a.ko~.te'se.ra~w~
Todo o mal decorre da independência e a independência foi a escolha que vocês fizeram.	'to.du u 'maw de'kO.Ri da i~.de.pe~'de~.sja i a i~.de.pe~'de~.sja 'foj a es'ko.La ki vo'sejs fi'zE.ra~w~
O mundo não é um playground onde eu mantenho todos os meus filhos livres do mal.	u 'mu~.du 'na~w~ E u~ plej'graw~.Di 'o~.Di ew ma~'te~.Ju 'to.duz us 'mews 'fi.Lus 'li.vris du 'maw
O mal é o caos, mas não terá a palavra final.	u 'maw E u 'kaws, majs 'na~w~ te'ra a pa'la.vra fi~'naw
Se eu eliminar as consequências das escolhas das pessoas, destruo a possibilidade do amor.	si ew e.li~.mi~'nar as ko~.se'kwe~.sjas daz es'ko.Las das pe'so.as, des'tru.u a po.si.bi.li'da.Di du a~'moX
O amor forçado não é amor.	u a~'moX foX'sa.du 'na~w~ E a~'moX
Mack passou as mãos pelos cabelos e suspirou.	'mE.ki pa'sow as 'ma~w~s 'pe.lus ka'be.luz i sus.pi'row
É simplesmente muito difícil de entender.	E si~.pliz'me~.Ti 'mu~j~.tu Di'fi.siw Di e~.te~'deX
Querido, deixe-me dizer um dos motivos pelos quais isso é tão difícil de entender.	ke'ri.du, 'dej.Si mi Di'zer u~ dus mo'Ti.vus 'pe.lus 'kwajz 'i.su E 'ta~w~ Di'fi.siw Di e~.te~'deX
É porque você tem uma visão muito pequena do que significa ser humano.	E puX'ke vo'se te~j~ u~.ma vi'za~w~ 'mu~j~.tu pe'ke~.na du ki si.gi~.ni'fi.ka 'ser u~'ma~.nu
Você e a Criação são incríveis, quer você entenda ou não.	vo'se i a kri.a'sa~w~ 'sa~w~ i~'kri.vejs, 'kER vo'se e~'te~.da ow 'na~w~
Vocês são absolutamente maravilhosos.	vo'sejs 'sa~w~ ab.so.lu.ta~'me~.Ti ma.ra.vi'LO.zus
Só porque fazem escolhas horrendas e destrutivas, isso não significa que mereçam menos respeito pelo que são por essência:	'sO puX'ke 'fa.ze~j~ es'ko.Laz o'Re~.daz i des.tru'Ti.vas, 'i.su 'na~w~ si.gi~.ni'fi.ka ki me're.sa~w~ 'me~.nus Res'pej.tu 'pe.lu ki 'sa~w~ pur e'se~.sja
o auge da minha Criação e o centro do meu afeto.	u 'aw.Zi da 'mi~.Ja kri.a'sa~w~ i u 'se~.tru du 'mew a'fE.tu
Então, que escolhas não deveriam ter sido feitas, Mackenzie?	e~'ta~w~, ki es'ko.Las 'na~w~ de.ve'ri.a~w~ 'teX 'si.du 'fej.tas, ma'ke~.zi
Será que eu nunca deveria ter criado?	se'ra ki ew 'nu~.ka de.ve'ri.a 'teX kri'a.du
Será que Adão deveria ter sido impedido antes de escolher a independência?	se'ra ki a'da~w~ de.ve'ri.a 'teX 'si.du i~.pe'Di.du 'a~.Tis Di es.ko'Ler a i~.de.pe~'de~.sja
Que tal a escolha de ter outra filha, ou a escolha de seu pai de espancar o filho?	ki 'taw a es'ko.La Di 'ter 'ow.tra 'fi.La, ow a es'ko.La Di 'sew 'paj Di es.pa~'kar u 'fi.Lu
Você exige sua independência, mas depois reclama por eu amá-lo o bastante para responder ao seu pedido.	vo'se e'zi.Zi 'su.a i~.de.pe~'de~.sja, majs de'pojs Re'kla~.ma pur ew a~'ma lu u bas'ta~.Ti 'pa.ra Res.po~'der aw 'sew pe'Di.du
Já ouvi isso antes.	'Za ow'vi 'i.su 'a~.Tis
Papai sorriu de volta e pegou um pedaço de bolo.	pa'paj so'Riw Di 'vOw.ta i pe'gow u~ pe'da.su Di 'bo.lu
Eu disse que Sophia mexeu com você.	ew 'Di.si ki so'fi.a me'Sew ko~ vo'se
Mackenzie, meus propósitos não existem para o meu conforto nem para o seu.	ma'ke~.zi, 'mews pro'pO.zi.tus 'na~w~ e'zis.te~j~ 'pa.ra u 'mew ko~'foX.tu ne~j~ 'pa.ra u 'sew
Meus propósitos são sempre e somente uma expressão de amor.	'mews pro'pO.zi.tus 'sa~w~ 'se~.pri i sO~'me~.Ti u~.ma es.pre'sa~w~ Di a~'moX
Eu me proponho a trabalhar a vida a partir da morte, a trazer a liberdade de dentro do que está partido, a transformar à escuridão em luz.	ew mi pro'po~.Ju a tra.ba'Lar a 'vi.da a paX'TiR da 'mOX.Ti, a tra'zer a li.beR'da.Di Di 'de~.tru du ki es'ta paX'Ti.du, a tra~s.foR'mar a es.ku.ri'da~w~ e~j~ 'lujs
O que você vê como caos, eu vejo como desdobramento.	u ki vo'se 've 'ko~.mu 'kaws, ew 've.Zu 'ko~.mu dez.do.bra~'me~.tu
Está falando de Jesus, não é? perguntou Mack baixinho.	es'ta fa'la~.du Di Ze'zujs, 'na~w~ E, peR.gu~'tow 'mE.ki baj'Si~.Ju
É, eu adoro aquele garoto.	E, ew a'dO.ru a'ke.li ga'ro.tu
Papai afastou o olhar e balançou a cabeça.	pa'paj a.fas'tow u o'Lar i ba.la~'sow a ka'be.sa
Tudo tem a ver com ele, você sabe.	'tu.du te~j~ a 'veX ko~ 'e.li, vo'se 'sa.bi
Um dia vocês vão entender do que ele abriu mão.	u~ 'Di.a vo'sejs 'va~w~ e~.te~'deR du ki 'e.li a'briw 'ma~w~
Simplesmente não existem palavras.	si~.pliz'me~.Ti 'na~w~ e'zis.te~j~ pa'la.vras
Mack podia sentir as emoções crescendo.	'mE.ki po'Di.a se~'Tir az e~.mo'so~j~s kre'se~.du
Algo o tocou profundamente ao ouvir Papai falar do filho.	'aw.gu u to'kow pro.fu~.da~'me~.Ti aw ow'viX pa'paj fa'laR du 'fi.Lu
Hesitou antes de perguntar, mas finalmente rompeu o silêncio:	e.zi'tow 'a~.Tis Di peR.gu~'taX, majs fi~.naw'me~.Ti Ro~'pew u si'le~.sju
Papai, pode me ajudar a entender uma coisa?	pa'paj, 'pO.Di mi a.Zu'dar a e~.te~'der u~.ma 'koj.za
O que exatamente Jesus realizou ao morrer?	u ki e.za.ta~'me~.Ti Ze'zujs Re.a.li'zow aw mo'ReX
Ela ainda estava olhando para a floresta.	'E.la a'i~.da es'ta.va o'La~.du 'pa.ra a flo'rEs.ta
Ah, e balançou a mão...	'a, i ba.la~'sow a 'ma~w~
Não muita coisa.	'na~w~ 'mu~j~.ta 'koj.za
Apenas a essência de tudo que o amor se propunha desde antes dos alicerces da Criação, declarou Papai em tom casual.	a'pe~.naz a e'se~.sja Di 'tu.du ki u a~'moX si pro'pu~.Ja 'dez.Di 'a~.Tis duz a.li'sEX.sis da kri.a'sa~w~, de.kla'row pa'paj e~j~ 'to~ ka.zu'aw
Depois se virou e sorriu.	de'pojs si vi'row i so'Riw
Uau, isso é amplo demais.	u'aw, 'i.su E 'a~.plu de~'majs
Em vez de ficar chateado, Papai sorriu para ele.	e~j~ 'vejz Di fi'kaX Sa.te'a.du, pa'paj so'Riw 'pa.ra 'e.li
Nossa, você esta ficando metidinho!	'nO.sa, vo'se 'Es.ta fi'ka~.du me.Ti'Di~.Ju
A gente dá a mão e eles logo querem o braço.	a 'Ze~.Ti 'da a 'ma~w~ i 'e.lis 'lO.gu 'kE.re~j~ u 'bra.su
Mack devolveu o sorriso, mas não disse nada.	'mE.ki de.vow'vew u so'Ri.zu, majs 'na~w~ 'Di.si 'na.da
Como falei, tudo tem a ver com ele.	'ko~.mu fa'lej, 'tu.du te~j~ a 'veX ko~ 'e.li
A Criação e a história tem tudo a ver com Jesus.	a kri.a'sa~w~ i a is'tO.rja te~j~ 'tu.du a 'veX ko~ Ze'zujs
Ele é o centro de nosso propósito e nele agora somos totalmente humanos, de modo que o nosso propósito e o destino de vocês estão ligados para sempre.	'e.li E u 'se~.tru Di 'nO.su pro'pO.zi.tu i 'ne.li a'gO.ra 'so~.mus to.taw'me~.Ti u~'ma~.nus, Di 'mO.du ki u 'nO.su pro'pO.zi.tu i u des'Ti~.nu Di vo'sejz es'ta~w~ li'ga.dus 'pa.ra 'se~.pri
Não existe qualquer outro plano.	'na~w~ e'zis.Ti kwaw'kEr 'ow.tru 'pla~.nu
Parece bem arriscado, comentou Mack.	pa'rE.si 'be~j~ a.Ris'ka.du, ko~.me~'tow 'mE.ki
Talvez para vocês, mas não para mim.	taw'vejs 'pa.ra vo'sejs, majs 'na~w~ 'pa.ra 'mi~
Nunca houve dúvida de que conseguirei o que eu desejava desde o início.	'nu~.ka 'ow.vi 'du.vi.da Di ki ko~.se.gi'rej u ki ew de.ze'Za.va 'dez.Di u i~'ni.sju
Papai se inclinou e cruzou os braços sobre a mesa.	pa'paj si i~.kli~'now i kru'zow us 'bra.sus 'so.bri a 'me.za
Querido, você perguntou o que Jesus realizou na cruz.	ke'ri.du, vo'se peR.gu~'tow u ki Ze'zujs Re.a.li'zow na 'krujs
Então agora me ouça com cuidado:	e~'ta~w~ a'gO.ra mi 'ow.sa ko~ kuj'da.du
A morte dele e sua ressurreição foram a razão pela qual eu agora estou totalmente reconciliado com o mundo.	a 'mOX.Ti 'de.li i 'su.a Re.su.Rej'sa~w~ 'fo.ra~w~ a Ra'za~w~ 'pe.la 'kwaw ew a'gO.ra es'tow to.taw'me~.Ti Re.ko~.si.li'a.du ko~ u 'mu~.du
Com o mundo inteiro?	ko~ u 'mu~.du i~'tej.ru
Quer dizer, com os que acreditam em você, não é?	'kER Di'zeX, ko~ us ki a.kre'Di.ta~w~ e~j~ vo'se, 'na~w~ E
Com o mundo inteiro, Mack.	ko~ u 'mu~.du i~'tej.ru, 'mE.ki
Estou dizendo que a reconciliação é uma rua de mão dupla e eu fiz a minha parte, totalmente, completamente, definitivamente.	es'tow Di'ze~.du ki a Re.ko~.si.li.a'sa~w~ E u~.ma 'Ru.a Di 'ma~w~ 'du.pla i ew 'fiz a 'mi~.Ja 'paX.Ti, to.taw'me~.Ti, ko~.plE.ta~'me~.Ti, de.fi~.ni.Ti.va~'me~.Ti
Não é da natureza do amor forçar um relacionamento, mas é da natureza do amor abrir o caminho.	'na~w~ E da na.tu're.za du a~'moX foX'sar u~ Re.la.si.o~.na~'me~.tu, majz E da na.tu're.za du a~'mor a'brir u ka~'mi~.Ju
Após dizer isso, Papai levantou-se e pegou alguns pratos para levar para a cozinha.	a'pOjs Di'zer 'i.su, pa'paj le.va~'tow si i pe'gow aw'gu~s 'pra.tus 'pa.ra le'vaX 'pa.ra a ko'zi~.Ja
Mack balançou a cabeça e ergueu os olhos.	'mE.ki ba.la~'sow a ka'be.sa i eR'gew uz 'O.Lus
Então eu realmente não entendo o que é reconciliação e realmente morro de medo de emoções.	e~'ta~w~ ew Re.aw'me~.Ti 'na~w~ e~'te~.du u ki E Re.ko~.si.li.a'sa~w~ i Re.aw'me~.Ti 'mo.Ru Di 'me.du Di e~.mo'so~j~s
É isso?	E 'i.su
Papai não respondeu imediatamente, mas balançou a cabeça.	pa'paj 'na~w~ Res.po~'dew i~.me.Di.a.ta~'me~.Ti, majs ba.la~'sow a ka'be.sa
Mack a ouviu resmungar e murmurar, como se falasse com ela mesma:	'mE.ki a ow'viw Rez.mu~'gar i muR.mu'raX, 'ko~.mu si fa'la.si ko~ 'E.la 'mez.ma
Homens! Algumas vezes são tão idiotas!	'o~.me~s, aw'gu~.mas 've.zis 'sa~w~ 'ta~w~ i.Di'O.tas
Ele não podia acreditar.	'e.li 'na~w~ po'Di.a a.kre.Di'taX
Ouvi Deus me chamar de idiota?	ow'vi 'dews mi Sa~'maR Di i.Di'O.ta
Gritou pela porta de tela.	gri'tow 'pe.la 'pOX.ta Di 'tE.la
Viu-a dar de ombros antes de desaparecer na virada do corredor.	'viw a 'daR Di 'o~.bruz 'a~.Tis Di de.za.pa.re'seR na vi'ra.da du ko.Re'doX
Depois ela gritou em sua direção:	de'pojz 'E.la gri'tow e~j~ 'su.a Di.re'sa~w~
Se a carapuça serve, querido.	si a ka.ra'pu.sa 'sER.vi, ke'ri.du
Sim senhor, se a carapuça serve...	'si~ se~'JoX, si a ka.ra'pu.sa 'sER.vi
Mack riu e se recostou na cadeira.	'mE.ki 'Riw i si Re.kos'tow na ka'dej.ra
Sentia-se exausto.	se~'Ti.a si e'zaws.tu
O tanque do cérebro estava mais do que cheio, assim como o estômago.	u 'ta~.ki du 'sE.re.bru es'ta.va 'majs du ki 'Sej.u, a'si~ 'ko~.mu u es'to~.ma.gu
Levou o resto dos pratos para a cozinha, depositou-os na bancada, deu um beijo no rosto de Papai e foi para a porta dos fundos.	le'vow u 'REs.tu dus 'pra.tus 'pa.ra a ko'zi~.Ja, de.po.zi'tow us na ba~'ka.da, 'dew u~ 'bej.Zu nu 'Ros.tu Di pa'paj i 'foj 'pa.ra a 'pOX.ta dus 'fu~.dus
Deus é um verbo.	'dewz E u~ 'vER.bu
Mack saiu para o sol do meio da tarde.	'mE.ki sa'iw 'pa.ra u 'sOw du 'mej.u da 'taR.Di
Sentia uma mistura estranha, como se estivesse ao mesmo tempo torcido como um trapo e plenamente vivo.	se~'Ti.a u~.ma mis'tu.ra es'tra~.Ja, 'ko~.mu si es.Ti'vE.si aw 'mez.mu 'te~.pu toX'si.du 'ko~.mu u~ 'tra.pu i ple~.na~'me~.Ti 'vi.vu
Que dia incrível tinha sido aquele e ainda estavam no meio da tarde!	ki 'Di.a i~'kri.vew 'Ti~.Ja 'si.du a'ke.li i a'i~.da es'ta.va~w~ nu 'mej.u da 'taR.Di
Por um momento ficou indeciso, antes de ir até o lago.	pur u~ mo~'me~.tu fi'kow i~.de'si.zu, 'a~.Tis Di 'ir a'tE u 'la.gu
Quando viu as canoas amarradas ao cais sentiu certa resistência, mas a ideia de entrar em uma e passear pelo lago o energizou pela primeira vez em anos.	'kwa~.du 'viw as ka~'no.az a~.ma'Ra.daz aw 'kajs se~'Tiw 'sEX.ta Re.zis'te~.sja, majz a i'dEj.a Di e~'trar e~j~ u~.ma i pa.se'aX 'pe.lu 'la.gu u e~.neR.Zi'zow 'pe.la pri~'mej.ra 'vejz e~j~ 'a~.nus
Desamarrando a última, na extremidade do cais, entrou cautelosamente e começou a remar para o outro lado.	de.za~.ma'Ra~.du a 'uw.Ti~.ma, na es.tre~.mi'da.Di du 'kajs, e~'trow kaw.te.lO.za~'me~.Ti i ko~.me'sow a Re~'maX 'pa.ra u 'ow.tru 'la.du
Nas duas horas seguintes circulou pelo lago, explorando recantos e fendas.	nas 'du.az 'O.ras se'gi~.Tis siX.ku'low 'pe.lu 'la.gu, es.plo'ra~.du Re'ka~.tuz i 'fe~.das
Encontrou dois rios e alguns córregos que, vindo de cima, alimentavam o lago e a seguir o esvaziavam na direção das bacias inferiores.	e~.ko~'trow 'dojs 'Ri.uz i aw'gu~s 'kO.Re.gus ki, 'vi~.du Di 'si~.ma, a.li~.me~'ta.va~w~ u 'la.gu i a se'gir u ez.va.zi'a.va~w~ na Di.re'sa~w~ das ba'si.az i~.fe.ri'o.ris
Descobriu um lugar perfeito para ficar à deriva olhando a cachoeira.	des.ko'briw u~ lu'gaX peX'fej.tu 'pa.ra fi'kar a de'ri.va o'La~.du a ka.So'ej.ra
Flores alpinas brotavam em toda parte, acrescentando manchas de cor à paisagem.	'flo.riz aw'pi~.nas bro'ta.va~w~ e~j~ 'to.da 'paX.Ti, a.kre.se~'ta~.du 'ma~.Sas Di 'kor a paj'za.Ze~j~
Era o sentimento de paz mais intenso e consistente que Mack experimentava havia uma enormidade de tempo, se é que já havia experimentado.	'E.ra u se~.Ti~'me~.tu Di 'pajz 'majz i~'te~.su i ko~.sis'te~.Ti ki 'mE.ki es.pe.ri~.me~'ta.va a'vi.a u~.ma e~.noR.mi'da.Di Di 'te~.pu, si E ki 'Za a'vi.a es.pe.ri~.me~'ta.du
Chegou a cantar algumas músicas só porque teve vontade.	Se'gow a ka~'tar aw'gu~.mas 'mu.zi.kas 'sO puX'ke 'te.vi vo~'ta.Di
Cantar também era algo que não fazia há muito tempo.	ka~'taX ta~'be~j~ 'E.ra 'aw.gu ki 'na~w~ fa'zi.a 'a 'mu~j~.tu 'te~.pu
Recuou ao passado e começou a cantarolar a musiquinha ingênua que costumava cantar para Kate:	Re.ku'ow aw pa'sa.du i ko~.me'sow a ka~.ta.ro'lar a mu.zi'ki~.Ja i~'Ze~.nwa ki kos.tu~'ma.va ka~'taX 'pa.ra 'kej.Ti
Balançou a cabeça ao pensar na filha, tão forte e tão frágil.	ba.la~'sow a ka'be.sa aw pe~'saR na 'fi.La, 'ta~w~ 'fOX.Ti i 'ta~w~ 'fra.Ziw
Imaginou qual seria o modo de alcançar o coração dela.	i~.ma.Zi~'now 'kwaw se'ri.a u 'mO.du Di aw.ka~'sar u ko.ra'sa~w~ 'dE.la
Não se surpreendia mais com a facilidade com que as lágrimas chegavam aos seus olhos.	'na~w~ si suX.pre.e~'Di.a 'majs ko~ a fa.si.li'da.Di ko~ ki as 'la.gri~.ma.Se'ga.va~w~ aws 'sewz 'O.Lus
Num determinado ponto virou-se para olhar os redemoinhos feitos pelo remo e quando se virou de novo Sarayu estava sentada na proa, olhando-o.	nu~ de.teR.mi~'na.du 'po~.tu vi'row si 'pa.ra o'Lar us Re.de~'mo.i~.Jus 'fej.tus 'pe.lu 'Re~.mu i 'kwa~.du si vi'row Di 'no.vu sa.ra'ju es'ta.va se~'ta.da na 'pro.a, o'La~.du u
Aquela presença súbita o fez dar um pulo.	a'kE.la pre'ze~.sa 'su.bi.ta u 'fejz 'dar u~ 'pu.lu
Nossa! exclamou ele.	'nO.sa, es.kla~'mow 'e.li
Você me assustou.	vo'se mi a.sus'tow
Desculpe, Mackenzie, mas o jantar está quase pronto e é hora de voltar para a cabana.	des'kuw.pi, ma'ke~.zi, majz u Za~'tar es'ta 'kwa.zi 'pro~.tu i E 'O.ra Di vow'taX 'pa.ra a ka'ba~.na
Você estava comigo o tempo todo? Perguntou Mack, consciente do jorro de adrenalina.	vo'se es'ta.va ko~'mi.gu u 'te~.pu 'to.du, peR.gu~'tow 'mE.ki, ko~.si'e~.Ti du 'Zo.Ru Di a.dre~.na'li~.na
Sempre estou com você.	'se~.pri es'tow ko~ vo'se
Então por que não percebi?	e~'ta~w~ puX 'ke 'na~w~ peX.se'bi
Ultimamente consigo saber quando você está por perto.	uw.Ti~.ma~'me~.Ti ko~'si.gu sa'beX 'kwa~.du vo'se es'ta puX 'pEX.tu
O fato de você saber ou não saber não tem nada a ver com o fato de eu estar aqui.	u 'fa.tu Di vo'se sa'ber ow 'na~w~ sa'beR 'na~w~ te~j~ 'na.da a 'veX ko~ u 'fa.tu Di ew es'tar a'ki
Algumas vezes quero que perceba especialmente a minha presença.	aw'gu~.mas 've.zis 'kE.ru ki peX'se.ba es.pe.si.aw'me~.Ti a 'mi~.Ja pre'ze~.sa
Mack assentiu, entendendo, e virou a canoa para a margem distante onde ficava a cabana.	'mE.ki a.se~'Tiw, e~.te~'de~.du, i vi'row a ka~'no.a 'pa.ra a 'maR.Ze~j~ Dis'ta~.Ti 'o~.Di fi'ka.va a ka'ba~.na
A presença dela provocava um arrepio na coluna.	a pre'ze~.sa 'dE.la pro.vo'ka.va u~ a.Re'pi.u na ko'lu~.na
Os dois sorriram simultaneamente.	us 'dojs so'Ri.ra~w~ si~.muw.ta~.ne.a~'me~.Ti
Sempre poderei ver ou ouvir você como agora, mesmo quando estiver de volta em casa?	'se~.pri po.de'rej 'ver ow ow'viR vo'se 'ko~.mu a'gO.ra, 'mez.mu 'kwa~.du es.Ti'vER Di 'vOw.ta e~j~ 'ka.za
Sarayu sorriu.	sa.ra'ju so'Riw
Mackenzie, você sempre pode falar comigo e eu sempre estarei com você, quer sinta minha presença ou não.	ma'ke~.zi, vo'se 'se~.pri 'pO.Di fa'laX ko~'mi.gu i ew 'se~.pri es.ta'rej ko~ vo'se, 'kEX 'si~.ta 'mi~.Ja pre'ze~.sa ow 'na~w~
Agora sei disso, mas vou escutar você?	a'gO.ra 'sej 'Di.su, majs 'vow es.ku'taR vo'se
Vai aprender a ouvir meus pensamentos nos seus, Mackenzie, ela garantiu.	'vaj a.pre~'der a ow'viR 'mews pe~.sa~'me~.tus nus 'sews, ma'ke~.zi, 'E.la ga.ra~'Tiw
Vai ser claro?	'vaj 'seX 'kla.ru
E se eu confundir você com outra voz?	i si ew ko~.fu~'DiR vo'se ko~ 'ow.tra 'vOjs
E se eu errar?	i si ew e'RaX
Sarayu riu e o som parecia o de água cascateando, como se fosse música.	sa.ra'ju 'Riw i u 'so~ pa.re'si.a u Di 'a.gwa kas.ka.te'a~.du, 'ko~.mu si 'fo.si 'mu.zi.ka
Claro que você vai errar.	'kla.ru ki vo'se 'vaj e'RaX
Todo mundo erra, mas vai começar a reconhecer melhor minha voz à medida que nosso relacionamento for crescendo.	'to.du 'mu~.du 'E.Ra, majs 'vaj ko~.me'sar a Re.ko~.Je'seR me'LOR 'mi~.Ja 'vOjz a me'Di.da ki 'nO.su Re.la.si.o~.na~'me~.tu 'foX kre'se~.du
Não quero errar, resmungou Mack.	'na~w~ 'kE.ru e'RaX, Rez.mu~'gow 'mE.ki
Ah, Mackenzie, os erros fazem parte da vida e Papai trabalha seus propósitos neles também.	'a, ma'ke~.zi, uz 'e.Rus 'fa.ze~j~ 'paX.Ti da 'vi.da i pa'paj tra'ba.La 'sews pro'pO.zi.tus 'ne.lis ta~'be~j~
Sarayu estava achando divertido e Mack não pôde evitar um sorriso.	sa.ra'ju es'ta.va a'Sa~.du Di.veX'Ti.du i 'mE.ki 'na~w~ 'po.Di e.vi'tar u~ so'Ri.zu
Dava para entender muito bem o que ela dizia.	'da.va 'pa.ra e~.te~'deR 'mu~j~.tu 'be~j~ u ki 'E.la Di'zi.a
Isso é muito diferente de tudo o que eu conhecia, Sarayu.	'i.su E 'mu~j~.tu Di.fe're~.Ti Di 'tu.du u ki ew ko~.Je'si.a, sa.ra'ju
Não me entenda mal, adoro o que vocês me deram neste fim de semana.	'na~w~ mi e~'te~.da 'maw, a'dO.ru u ki vo'sejs mi 'dE.ra~w~ 'nes.Ti 'fi~ Di se~'ma~.na
Mas não faço ideia de como voltar à minha vida normal.	majs 'na~w~ 'fa.su i'dEj.a Di 'ko~.mu vow'tar a 'mi~.Ja 'vi.da noR'maw
Tenho a sensação de que era mais fácil viver com Deus quando eu pensava Nele como o mestre exigente ou mesmo quando eu tinha que conviver com a solidão da Grande Tristeza.	'te~.Ju a se~.sa'sa~w~ Di ki 'E.ra 'majs 'fa.siw vi'veX ko~ 'dews 'kwa~.du ew pe~'sa.va 'ne.li 'ko~.mu u 'mEs.tri e.zi'Ze~.Ti ow 'mez.mu 'kwa~.du ew 'Ti~.Ja ki ko~.vi'veX ko~ a so.li'da~w~ da 'gra~.Di tris'te.za
Você acha?	vo'se 'a.Sa
De verdade?	Di veR'da.Di
Pelo menos dava a impressão de que as coisas estavam sob controle.	'pe.lu 'me~.nus 'da.va a i~.pre'sa~w~ Di ki as 'koj.zaz es'ta.va~w~ sob ko~'tro.li
Dava a impressão é o termo certo.	'da.va a i~.pre'sa~w~ E u 'teR.mu 'sEX.tu
O que você ganhou com isso?	u ki vo'se ga~'Jow ko~ 'i.su
A Grande Tristeza e uma dor insuportável, uma dor que se derramava até mesmo sobre as pessoas de quem você mais gosta.	a 'gra~.Di tris'te.za i u~.ma 'dor i~.su.poX'ta.vew, u~.ma 'doX ki si de.Ra~'ma.va a'tE 'mez.mu 'so.bri as pe'so.as Di 'ke~j~ vo'se 'majs 'gOs.ta
Segundo Papai, isso é porque eu tenho medo de emoções.	se'gu~.du pa'paj, 'i.su E puX'ke ew 'te~.Ju 'me.du Di e~.mo'so~j~s
Sarayu riu alto.	sa.ra'ju 'Riw 'aw.tu
Achei aquela conversinha hilariante.	a'Sej a'kE.la ko~.veX'si~.Ja i.la.ri'a~.Ti
Eu tenho medo de emoções, admitiu Mack, meio perturbado porque ela parecia não dar importância.	ew 'te~.Ju 'me.du Di e~.mo'so~j~s, a.Di~.mi'Tiw 'mE.ki, 'mej.u peX.tuR'ba.du puX'ke 'E.la pa.re'si.a 'na~w~ 'dar i~.poX'ta~.sja
Não gosto da sensação que elas produzem.	'na~w~ 'gOs.tu da se~.sa'sa~w~ ki 'E.las pro'du.ze~j~
Magoei outros por causa das minhas emoções e não consigo confiar nelas.	ma.go'ej 'ow.trus puX 'kaw.za das 'mi~.Jaz e~.mo'so~j~z i 'na~w~ ko~'si.gu ko~.fi'aR 'nE.las
Sarayu pareceu se erguer no ar.	sa.ra'ju pa.re'sew si eR'geR nu 'aX
Ainda era difícil olhar diretamente para ela, mas com o sol do fim da tarde se refletindo na água ficava ainda pior.	a'i~.da 'E.ra Di'fi.siw o'LaR Di.rE.ta~'me~.Ti 'pa.ra 'E.la, majs ko~ u 'sOw du 'fi~ da 'taR.Di si Re.fle'Ti~.du na 'a.gwa fi'ka.va a'i~.da pi'OX
As emoções são as cores da alma.	az e~.mo'so~j~s 'sa~w~ as 'ko.ris da 'aw.ma
São espetaculares e incríveis.	'sa~w~ es.pe.ta.ku'la.riz i i~'kri.vejs
Quando você não sente, o mundo fica opaco e sem cor.	'kwa~.du vo'se 'na~w~ 'se~.Ti, u 'mu~.du 'fi.ka o'pa.ku i se~j~ 'koX
Pense em como a Grande Tristeza reduziu a gama de cores na sua vida para matizes monótonos, cinza e pretos.	'pe~.si e~j~ 'ko~.mu a 'gra~.Di tris'te.za Re.du'ziw a 'ga~.ma Di 'ko.ris na 'su.a 'vi.da 'pa.ra ma'Ti.zis mo~'nO.to~.nus, 'si~.za i 'pre.tus
Então me ajude a entendê-las, implorou Mack.	e~'ta~w~ mi a'Zu.Di a e~.te~'de las, i~.plo'row 'mE.ki
Na verdade, não há muito que entender.	na veR'da.Di, 'na~w~ 'a 'mu~j~.tu ki e~.te~'deX
As emoções simplesmente são.	az e~.mo'so~j~s si~.pliz'me~.Ti 'sa~w~
Nem boas nem ruins, apenas existem.	ne~j~ 'bo.as ne~j~ Ru'i~s, a'pe~.naz e'zis.te~j~
Eis algo que vai ajudá-lo a entender melhor, Mackenzie.	'ejz 'aw.gu ki 'vaj a.Zu'da lu a e~.te~'deR me'LOX, ma'ke~.zi
Os paradigmas dão força às percepções e as percepções dão força às emoções.	us pa.ra'Di.gi~.mas 'da~w~ 'foX.sa as peX.sep'so~j~z i as peX.sep'so~j~s 'da~w~ 'foX.sa az e~.mo'so~j~s
Não se assuste, vou explicar.	'na~w~ si a'sus.Ti, 'vow es.pli'kaX
A maioria das emoções são reações àquilo que você percebe:	a maj.o'ri.a daz e~.mo'so~j~s 'sa~w~ Re.a'so~j~z a'ki.lu ki vo'se peX'sE.bi
O que acha verdadeiro numa determinada situação.	u ki 'a.Sa veR.da'dej.ru 'nu~.ma de.teR.mi~'na.da si.tu.a'sa~w~
Se sua percepção for falsa, sua reação emocional a ela também será falsa.	si 'su.a peX.sep'sa~w~ 'foX 'faw.sa, 'su.a Re.a'sa~w~ e~.mo.si.o~'naw a 'E.la ta~'be~j~ se'ra 'faw.sa
Então verifique suas percepções e, além disso, verifique a verdade de seus paradigmas, dos seus padrões, daquilo em que você acredita.	e~'ta~w~ ve.ri'fi.ki 'su.as peX.sep'so~j~z i, a'le~j~ 'Di.su, ve.ri'fi.ki a veR'da.Di Di 'sews pa.ra'Di.gi~.mas, dus 'sews pa'dro~j~s, da'ki.lu e~j~ ki vo'se a.kre'Di.ta
Só porque você acredita firmemente numa coisa não significa que ela seja verdadeira.	'sO puX'ke vo'se a.kre'Di.ta fiR.me~'me~.Ti 'nu~.ma 'koj.za 'na~w~ si.gi~.ni'fi.ka ki 'E.la 'se.Za veR.da'dej.ra
Disponha-se a reexaminar aquilo em que acredita.	Dis'po~.Ja si a Re.e.za~.mi~'nar a'ki.lu e~j~ ki a.kre'Di.ta
Quanto mais você viver na verdade, mais suas emoções irão ajudá-lo a ver com clareza.	'kwa~.tu 'majs vo'se vi'veR na veR'da.Di, 'majs 'su.az e~.mo'so~j~z i'ra~w~ a.Zu'da lu a 'veX ko~ kla're.za
Mas, mesmo então, não confie mais nelas do que em mim.	majs, 'mez.mu e~'ta~w~, 'na~w~ ko~'fi.i 'majs 'nE.las du ki e~j~ 'mi~
Mack deixou o remo girar nas mãos, permitindo que ele seguisse os movimentos da água.	'mE.ki dej'Sow u 'Re~.mu Zi'raR nas 'ma~w~s, peR.mi'Ti~.du ki 'e.li se'gi.si us mo.vi~'me~.tus da 'a.gwa
Tenho a impressão de que viver a partir do relacionamento com você, confiando e falando com você, é bem mais complicado do que simplesmente seguir as regras.	'te~.Ju a i~.pre'sa~w~ Di ki vi'ver a paX'TiR du Re.la.si.o~.na~'me~.tu ko~ vo'se, ko~.fi'a~.du i fa'la~.du ko~ vo'se, E 'be~j~ 'majs ko~.pli'ka.du du ki si~.pliz'me~.Ti se'gir as 'RE.gras
Que regras são essas, Mackenzie?	ki 'RE.gras 'sa~w~ 'E.sas, ma'ke~.zi
E quais são elas?	i 'kwajs 'sa~w~ 'E.las
Você sabe, respondeu ele com um certo sarcasmo.	vo'se 'sa.bi, Res.po~'dew 'e.li ko~ u~ 'sEX.tu saX'kaz.mu
Fazer o bem e evitar o mal, ser caridoso com os pobres, ler a Bíblia, orar e ir à igreja.	fa'zer u 'be~j~ i e.vi'tar u 'maw, 'seX ka.ri'do.zu ko~ us 'pO.bris, 'ler a 'bi.blja, o'rar i 'ir a i'gre.Za
Coisas assim.	'koj.zaz a'si~
E como isso funciona para você?	i 'ko~.mu 'i.su fu~.si'o~.na 'pa.ra vo'se
Bom, nunca fiz nada disso muito bem.	'bo~, 'nu~.ka 'fiz 'na.da 'Di.su 'mu~j~.tu 'be~j~
Tenho momentos melhores, mas sempre há algo com que estou lutando ou algo que me faz sentir culpado.	'te~.Ju mo~'me~.tus me'LO.ris, majs 'se~.pri 'a 'aw.gu ko~ ki es'tow lu'ta~.du ow 'aw.gu ki mi 'fajs se~'TiX kuw'pa.du
Acabei de pensar que precisava me esforçar mais, porém acho difícil manter essa motivação.	a.ka'bej Di pe~'saX ki pre.si'za.va mi es.foX'saR 'majs, po're~j~ 'a.Su Di'fi.siw ma~'ter 'E.sa mo.Ti.va'sa~w~
Seu tom era de censura, as palavras voando com afeto.	'sew 'to~ 'E.ra Di se~'su.ra, as pa'la.vras vo'a~.du ko~ a'fE.tu
A bíblia não lhe diz para seguir regras.	a 'bi.blja 'na~w~ Li 'Dis 'pa.ra se'gi'RE.gras
Ela é uma imagem de Jesus.	'E.la E u~.ma i~'ma.Ze~j~ Di Ze'zujs
Ainda que as palavras possam lhe dizer como Deus é e o que Ele pode querer de você, é impossível fazer isso sozinho.	a'i~.da ki as pa'la.vras 'pO.sa~w~ Li Di'zeX 'ko~.mu 'dewz E i u ki 'e.li 'pO.Di ke'reR Di vo'se, E i~.po'si.vew fa'zer 'i.su sO'zi~.Ju
A vida está Nele e em mais ninguém.	a 'vi.da es'ta 'ne.li i e~j~ 'majs ni~'ge~j~
Minha nossa, será possível que você se ache capaz de viver a retidão de Deus sozinho?	'mi~.Ja 'nO.sa, se'ra po'si.vew ki vo'se si 'a.Si ka'pajz Di vi'ver a Re.Ti'da~w~ Di 'dews sO'zi~.Ju
Mas você tem de admitir que as regras e os princípios são mais simples do que os relacionamentos.	majs vo'se te~j~ Di a.Di~.mi'TiX ki as 'RE.graz i us pri~'si.pjus 'sa~w~ 'majs 'si~.plis du ki us Re.la.si.o~.na~'me~.tus
É verdade que os relacionamentos são muito mais complicados do que as regras, mas as regras nunca vão lhe dar as respostas para as questões profundas do coração.	E veR'da.Di ki us Re.la.si.o~.na~'me~.tus 'sa~w~ 'mu~j~.tu 'majs ko~.pli'ka.dus du ki as 'RE.gras, majz as 'RE.gras 'nu~.ka 'va~w~ Li 'dar as Res'pOs.tas 'pa.ra as kes'to~j~s pro'fu~.das du ko.ra'sa~w~
E nunca irão amar você.	i 'nu~.ka i'ra~w~ a~'maR vo'se
Mergulhando a mão na água, ele brincou , vendo a repercussão de seus movimentos.	meR.gu'La~.du a 'ma~w~ na 'a.gwa, 'e.li bri~'kow, 've~.du a Re.peX.ku'sa~w~ Di 'sews mo.vi~'me~.tus
Você me virou de cabeça para baixo e pelo avesso, ou sei lá o quê.	vo'se mi vi'row Di ka'be.sa 'pa.ra 'baj.Su i 'pe.lu a've.su, ow 'sej 'la u 'ke
Mackenzie, a religião tem a ver com respostas certas e algumas dessas respostas são de fato certas.	ma'ke~.zi, a Re.li.Zi'a~w~ te~j~ a 'veX ko~ Res'pOs.tas 'sEX.taz i aw'gu~.mas 'dE.sas Res'pOs.tas 'sa~w~ Di 'fa.tu 'sEX.tas
Mas eu tenho a ver com o processo que leva você à resposta viva, e só ele é capaz de mudá-lo por dentro.	majz ew 'te~.Ju a 'veX ko~ u pro'sE.su ki 'lE.va vo'se a Res'pOs.ta 'vi.va, i 'sO 'e.li E ka'pajz Di mu'da lu puR 'de~.tru
Há muitas pessoas inteligentes que dizem um monte de coisas certas a partir do cérebro porque aprenderam com alguém quais são as respostas certas.	'a 'mu~j~.tas pe'so.az i~.te.li'Ze~.Tis ki 'Di.ze~j~ u~ 'mo~.Ti Di 'koj.zas 'sEX.taz a paX'TiR du 'sE.re.bru puX'ke a.pre~'de.ra~w~ ko~ aw'ge~j~ 'kwajs 'sa~w~ as Res'pOs.tas 'sEX.tas
Mas essas pessoas não me conhecem.	majz 'E.sas pe'so.as 'na~w~ mi ko~'JE.se~j~
Assim, na verdade, como as respostas delas podem ser certas, mesmo que estejam certas?	a'si~, na veR'da.Di, 'ko~.mu as Res'pOs.tas 'dE.las 'pO.de~j~ 'seX 'sEX.tas, 'mez.mu ki es'te.Za~w~ 'sEX.tas
Ela sorriu.	'E.la so'Riw
Ficou confuso?	fi'kow ko~'fu.zu
Mas pode ter certeza: mesmo que possam estar certas, elas estão erradas.	majs 'pO.Di 'teX seX'te.za, 'mez.mu ki 'pO.sa~w~ es'taX 'sEX.tas, 'E.laz es'ta~w~ e'Ra.das
Entendo o que você está dizendo. Eu fiz isso durante anos, depois da escola dominical.	e~'te~.du u ki vo'se es'ta Di'ze~.du, ew 'fiz 'i.su du'ra~.Ti 'a~.nus, de'pojs da es'kO.la do~.mi~.ni'kaw
Tinha as respostas certas algumas vezes, mas não conhecia vocês.	'Ti~.Ja as Res'pOs.tas 'sEX.taz aw'gu~.mas 've.zis, majs 'na~w~ ko~.Je'si.a vo'sejs
Continuaram a se mover preguiçosamente na água.	ko~.Ti~.nu'a.ra~w~ a si mo'veX pre.gi.sO.za~'me~.Ti na 'a.gwa
Então verei você de novo? perguntou ele, hesitando.	e~'ta~w~ ve'rej vo'se Di 'no.vu, peR.gu~'tow 'e.li, e.zi'ta~.du
Você pode me ver numa obra de arte, na música, no silêncio, nas pessoas, na Criação, mesmo na sua alegria e na sua tristeza.	vo'se 'pO.Di mi 'veR 'nu~.ma 'O.bra Di 'aX.Ti, na 'mu.zi.ka, nu si'le~.sju, nas pe'so.as, na kri.a'sa~w~, 'mez.mu na 'su.a a.le'gri.a i na 'su.a tris'te.za
Minha capacidade de me comunicar é ilimitada, vivendo e transformando, e tudo isso sempre estará sintonizado com a bondade e o amor de Papai.	'mi~.Ja ka.pa.si'da.Di Di mi ko~.mu~.ni'kar E i.li~.mi'ta.da, vi've~.du i tra~s.foR'ma~.du, i 'tu.du 'i.su 'se~.pri es.ta'ra si~.to~.ni'za.du ko~ a bo~'da.Di i u a~'moR Di pa'paj
E você irá me ouvir e me ver na Bíblia de modos novos.	i vo'se i'ra mi ow'vir i mi 'veR na 'bi.blja Di 'mO.dus 'nO.vus
Simplesmente não procure regras e princípios.	si~.pliz'me~.Ti 'na~w~ pro'ku.ri 'RE.graz i pri~'si.pjus
Procure o relacionamento: um modo de estar conosco.	pro'ku.ri u Re.la.si.o~.na~'me~.tu, u~ 'mO.du Di es'taX ko~'nos.ku
Mesmo assim não será o mesmo do que ter você na proa do meu barco.	'mez.mu a'si~ 'na~w~ se'ra u 'mez.mu du ki 'teR vo'se na 'pro.a du 'mew 'baX.ku
Não, mas será muito melhor do que você pode imaginar, Mackenzie.	'na~w~, majs se'ra 'mu~j~.tu me'LOR du ki vo'se 'pO.Di i~.ma.Zi~'naX, ma'ke~.zi
E, quando você finalmente dormir neste mundo, teremos uma eternidade juntos, face a face.	i, 'kwa~.du vo'se fi~.naw'me~.Ti doR'miR 'nes.Ti 'mu~.du, te're~.muz u~.ma e.teR.ni'da.Di 'Zu~.tus, 'fa.si a 'fa.si
E então ela sumiu.	i e~'ta~w~ 'E.la su~'miw
Apesar de ele saber que não havia sumido de verdade.	a.pe'zaR Di 'e.li sa'beX ki 'na~w~ a'vi.a su~'mi.du Di veR'da.Di
Então, por favor, ajude-me a viver na verdade, disse Mack em voz alta.	e~'ta~w~, puX fa'voX, a'Zu.Di mi a vi'veR na veR'da.Di, 'Di.si 'mE.ki e~j~ 'vOjz 'aw.ta
Talvez isso seja uma oração, pensou.	taw'vejz 'i.su 'se.Za u~.ma o.ra'sa~w~, pe~'sow
Quando entrou no chalé, Mack viu que Jesus e Sarayu já estavam lá, sentados em volta da mesa.	'kwa~.du e~'trow nu Sa'lE, 'mE.ki 'viw ki Ze'zujz i sa.ra'ju 'Za es'ta.va~w~ 'la, se~'ta.duz e~j~ 'vOw.ta da 'me.za
Papai estava ocupada como sempre, trazendo pratos de comidas com cheiros maravilhosos.	pa'paj es'ta.va o.ku'pa.da 'ko~.mu 'se~.pri, tra'ze~.du 'pra.tus Di ko~'mi.das ko~ 'Sej.rus ma.ra.vi'LO.zus
Era evidente a ausência de qualquer verdura.	'E.ra e.vi'de~.Ti a aw'ze~.sja Di kwaw'kER veR'du.ra
Mack foi para o banheiro se lavar e quando retornou os outros três já haviam começado a comer.	'mE.ki 'foj 'pa.ra u ba~'Jej.ru si la'var i 'kwa~.du Re.toR'now uz 'ow.trus 'trej'Za a'vi.a~w~ ko~.me'sa.du a ko~'meX
Puxou a quarta cadeira e sentou-se.	pu'Sow a 'kwaX.ta ka'dej.ra i se~'tow si
Vocês realmente não precisam comer, não é?	vo'sejs Re.aw'me~.Ti 'na~w~ pre'si.za~w~ ko~'meX, 'na~w~ E
Perguntou, enquanto começava a colocar em sua tigela algo que parecia uma fina sopa de frutos do mar, com lulas, peixes e outras iguarias indefinidas.	peR.gu~'tow, e~'kwa~.tu ko~.me'sa.va a ko.lo'kar e~j~ 'su.a Ti'ZE.la 'aw.gu ki pa.re'si.a u~.ma 'fi~.na 'so.pa Di 'fru.tus du 'maX, ko~ 'lu.las, 'pej.Siz i 'ow.traz i.gwa'ri.az i~.de.fi~'ni.das
Não precisamos fazer nada, declarou Papai com certa ênfase.	'na~w~ pre.si'za~.mus fa'zeR 'na.da, de.kla'row pa'paj ko~ 'sEX.ta 'e~.fa.zi
Então por que comem?	e~'ta~w~ puX 'ke 'ko~.me~j~
Para estar com você, querido.	'pa.ra es'taX ko~ vo'se, ke'ri.du
Você precisa comer.	vo'se pre'si.za ko~'meX
Então, que desculpa melhor para ficarmos juntos?	e~'ta~w~, ki des'kuw.pa me'LOX 'pa.ra fi'kaR.mu'Zu~.tus
E eu gosto um bocado de comida.	i ew 'gOs.tu u~ bo'ka.du Di ko~'mi.da
Nada como uns deliciosos pratos salgados para deixar felizes as papilas gustativas.	'na.da 'ko~.mu u~s de.li.si'O.zus 'pra.tus saw'ga.dus 'pa.ra dej'SaX fe'li.ziz as pa'pi.las gus.ta'Ti.vas
Acompanhe isso com um pudim de caramelo ou um tiramisu e chá quente.	a.ko~'pa~.Ji 'i.su ko~ u~ pu'Di~ Di ka.ra~'mE.lu ow u~ Ti.ra~.mi'zu i 'Sa 'ke~.Ti
Humm! Nada pode ser melhor.	w~, 'na.da 'pO.Di 'seR me'LOX
Enquanto comia, Mack ouvia a conversa animada entre os três.	e~'kwa~.tu ko~'mi.a, 'mE.ki ow'vi.a a ko~'vEX.sa a~.ni~'ma.da 'e~.tri us 'trejs
Falavam e riam como velhos amigos que se gostavam e se conheciam mais intimamente do que qualquer outro ser humano.	fa'la.va~w~ i 'Ri.a~w~ 'ko~.mu 'vE.Luz a~'mi.gus ki si gos'ta.va~w~ i si ko~.Je'si.a~w~ 'majz i~.Ti~.ma~'me~.Ti du ki kwaw'kEr 'ow.tru 'ser u~'ma~.nu
Mack sentia inveja da conversa despreocupada mas respeitosa e se perguntou o que seria necessário para compartilhar isso com Nan e talvez até com alguns amigos.	'mE.ki se~'Ti.a i~'vE.Za da ko~'vEX.sa des.prew.ku'pa.da majs Res.pej'tO.za i si peR.gu~'tow u ki se'ri.a ne.se'sa.rju 'pa.ra ko~.paX.Ti'Lar 'i.su ko~ 'na~ i taw'vejz a'tE ko~ aw'gu~z a~'mi.gus
De novo ficou pasmo com a maravilha e o puro absurdo do momento.	Di 'no.vu fi'kow 'paz.mu ko~ a ma.ra'vi.La i u 'pu.ru ab'suR.du du mo~'me~.tu
Voltavam-lhe à mente as conversas incríveis que o haviam envolvido nas 24 horas anteriores.	vow'ta.va~w~ Li a 'me~.Ti as ko~'vEX.saz i~'kri.vejs ki u a'vi.a~w~ e~.vow'vi.du nas 'vi~.Ti i 'kwa.tru 'O.raz a~.te.ri'o.ris
Só estivera ali por um dia?	'sO es.Ti'vE.ra a'li pur u~ 'Di.a
E o que deveria fazer com isso quando voltasse para casa?	i u ki de.ve'ri.a fa'zeX ko~ 'i.su 'kwa~.du vow'ta.si 'pa.ra 'ka.za
Sabia que contaria tudo a Nan.	sa'bi.a ki ko~.ta'ri.a 'tu.du a 'na~
Ela podia não acreditar e Mack não iria culpá-la, pois ele provavelmente também não acreditaria.	'E.la po'Di.a 'na~w~ a.kre.Di'tar i 'mE.ki 'na~w~ i'ri.a kuw'pa la, 'pojz 'e.li pro.va.vew'me~.Ti ta~'be~j~ 'na~w~ a.kre.Di.ta'ri.a
À medida que sua mente ia acelerando, ele sentiu que se afastava dos outros e fechou os olhos.	a me'Di.da ki 'su.a 'me~.Ti 'i.a a.se.le'ra~.du, 'e.li se~'Tiw ki si a.fas'ta.va duz 'ow.truz i fe'Sow uz 'O.Lus
Nada disso podia ser real.	'na.da 'Di.su po'Di.a 'se.Re'aw
De repente houve um silêncio de morte.	Di Re'pe~.Ti 'ow.vi u~ si'le~.sju Di 'mOX.Ti
Abriu devagar um dos olhos, esperando acordar de novo em casa.	a'briw de.va'gar 'u~ duz 'O.Lus, es.pe'ra~.du a.koR'daR Di 'no.vu e~j~ 'ka.za
Em vez disso, Papai, Jesus e Sarayu o estavam encarando com sorrisos no rosto.	e~j~ 'vejz 'Di.su, pa'paj, Ze'zujz i sa.ra'ju u es'ta.va~w~ e~.ka'ra~.du ko~ so'Ri.zus nu 'Ros.tu
Ele nem tentou se explicar.	'e.li ne~j~ te~'tow si es.pli'kaX
Sabia que eles sabiam.	sa'bi.a ki 'e.lis sa'bi.a~w~
Em vez disso, apontou para um dos pratos e perguntou:	e~j~ 'vejz 'Di.su, a.po~'tow 'pa.ra 'u~ dus 'pra.tuz i peR.gu~'tow
Posso experimentar um pouco disso?	'pO.su es.pe.ri~.me~'tar u~ 'pow.ku 'Di.su
As interações foram retomadas e dessa vez ele escutou.	az i~.te.ra'so~j~s 'fo.ra~w~ Re.to~'ma.daz i 'dE.sa 'vejz 'e.li es.ku'tow
Mas de novo sentiu que ia se afastando.	majs Di 'no.vu se~'Tiw ki 'i.a si a.fas'ta~.du
Para reagir, decidiu fazer uma pergunta.	'pa.ra Re.a'ZiX, de.si'Diw fa'zer u~.ma peR'gu~.ta
Por que vocês nos amam, os humanos?	puX 'ke vo'sejs nuz 'a~.ma~w~, uz u~'ma~.nus
Acho que o que eu quero perguntar é: por que vocês me amam, quando não tenho nada para lhes oferecer?	'a.Su ki u ki ew 'kE.ru peR.gu~'tar E, puX 'ke vo'sejs mi 'a~.ma~w~, 'kwa~.du 'na~w~ 'te~.Ju 'na.da 'pa.ra Liz o.fe.re'seX
Pense um pouco nisso, Mack, respondeu Jesus.	'pe~.si u~ 'pow.ku 'ni.su, 'mE.ki, Res.po~'dew Ze'zujs
Você não experimenta uma forte sensação de liberdade ao saber que não pode nos oferecer nada, pelo menos nada capaz de acrescentar ou diminuir o que somos?	vo'se 'na~w~ es.pe.ri~'me~.ta u~.ma 'fOX.Ti se~.sa'sa~w~ Di li.beR'da.Di aw sa'beX ki 'na~w~ 'pO.Di nuz o.fe.re'seR 'na.da, 'pe.lu 'me~.nus 'na.da ka'pajz Di a.kre.se~'tar ow Di~.mi~.nu'ir u ki 'so~.mus
Isso deve lhe trazer um grande alívio, porque elimina qualquer exigência de comportamento.	'i.su 'dE.vi Li tra'zer u~ 'gra~.Di a'li.vju, puX'ke e.li~'mi~.na kwaw'kEr e.zi'Ze~.sja Di ko~.poX.ta~'me~.tu
E você ama mais os seus filhos quando eles se comportam bem? acrescentou Papai.	i vo'se 'a~.ma 'majz us 'sews 'fi.Lus 'kwa~.du 'e.lis si ko~'pOX.ta~w~ 'be~j~, a.kre.se~'tow pa'paj
Estou entendendo.	es'tow e~.te~'de~.du
Mack fez uma pausa.	'mE.ki 'fejz u~.ma 'paw.za
Mas eu me sinto mais realizado porque eles estão na minha vida.	majz ew mi 'si~.tu 'majs Re.a.li'za.du puX'ke 'e.liz es'ta~w~ na 'mi~.Ja 'vi.da
E vocês?	i vo'sejs
Não, respondeu Papai.	'na~w~, Res.po~'dew pa'paj
Já somos totalmente realizados em nós mesmos.	'Za 'so~.mus to.taw'me~.Ti Re.a.li'za.duz e~j~ 'nOjs 'mez.mus
Vocês estão destinados a viver em comunhão também, já que são feitos à nossa imagem.	vo'sejz es'ta~w~ des.Ti~'na.duz a vi'ver e~j~ ko~.mu~'Ja~w~ ta~'be~j~, 'Za ki 'sa~w~ 'fej.tuz a 'nO.sa i~'ma.Ze~j~
Assim, sentir isso por seus filhos ou por qualquer coisa que acrescente é perfeitamente natural e certo.	a'si~, se~'Tir 'i.su puX 'sews 'fi.Luz ow puX kwaw'kEX 'koj.za ki a.kre'se~.Ti E peX.fej.ta~'me~.Ti na.tu'raw i 'sEX.tu
Lembre-se, Mackenzie, que por natureza eu não sou um ser humano, apesar de termos escolhido estar com você neste fim de semana.	'le~.bri si, ma'ke~.zi, ki puR na.tu're.za ew 'na~w~ 'sow u~ 'ser u~'ma~.nu, a.pe'zaR Di 'teR.muz es.ko'Li.du es'taX ko~ vo'se 'nes.Ti 'fi~ Di se~'ma~.na
Sou verdadeiramente humano em Jesus, mas sou algo totalmente separado em minha natureza.	'sow veR.da.dej.ra~'me~.Ti u~'ma~.nu e~j~ Ze'zujs, majs 'sow 'aw.gu to.taw'me~.Ti se.pa'ra.du e~j~ 'mi~.Ja na.tu're.za
Você sabe, claro que sabe, disse Mack em tom de desculpa, que eu só posso seguir essa linha de raciocínio até um determinado ponto e depois me perco e meu cérebro parece derreter.	vo'se 'sa.bi, 'kla.ru ki 'sa.bi, 'Di.si 'mE.ki e~j~ 'to~w~ Di des'kuw.pa, ki ew 'sO 'pO.su se'gir 'E.sa 'li~.Ja Di Ra.si.o'si~.nju a'tE u~ de.teR.mi~'na.du 'po~.tu i de'pojs mi 'peX.ku i 'mew 'sE.re.bru pa'rE.si de.Re'teX
Entendo, admitiu Papai.	e~'te~.du, a.Di~.mi'Tiw pa'paj
É impossível compreender com a mente algo que você não pode experimentar.	E i~.po'si.vew ko~.pre.e~'deX ko~ a 'me~.Ti 'aw.gu ki vo'se 'na~w~ 'pO.Di es.pe.ri~.me~'taX
Mack pensou nisso por um momento.	'mE.ki pe~'sow 'ni.su pur u~ mo~'me~.tu
Está derretendo.	es'ta de.Re'te~.du
Quando os outros pararam de rir, Mack prosseguiu:	'kwa~.du uz 'ow.trus pa'ra.ra~w~ Di 'RiX, 'mE.ki pro.se'giw
Vocês sabem como me sinto grato por tudo, mas jogaram coisas demais no meu colo neste fim de semana.	vo'sejs 'sa.be~j~ 'ko~.mu mi 'si~.tu 'gra.tu puX 'tu.du, ma.Zo'ga.ra~w~ 'koj.zas de~'majs nu 'mew 'kO.lu 'nes.Ti 'fi~ Di se~'ma~.na
O que faço quando voltar?	u ki 'fa.su 'kwa~.du vow'taX
Qual é a sua expectativa em relação a mim, agora?	'kwaw E a 'su.a es.pek.ta'Ti.va e~j~ Re.la'sa~w~ a 'mi~, a'gO.ra
Jesus e Papai se viraram para Sarayu, que estava com o garfo cheio de alguma coisa a caminho da boca.	Ze'zujz i pa'paj si vi'ra.ra~w~ 'pa.ra sa.ra'ju, ki es'ta.va ko~ u 'gaX.fu 'Sej.u Di aw'gu~.ma 'koj.za a ka~'mi~.Ju da 'bo.ka
Ela pousou-o lentamente de volta ao prato e depois respondeu à expressão confusa de Mack.	'E.la pow'zow u le~.ta~'me~.Ti Di 'vOw.ta aw 'pra.tu i de'pojs Res.po~'dew a es.pre'sa~w~ ko~'fu.za Di 'mE.ki
Mack, começou ela, você deve perdoar esses dois.	'mE.ki, ko~.me'sow 'E.la, vo'se 'dE.vi peR.do'ar 'e.sis 'dojs
Os humanos têm uma tendência a estruturar a linguagem de acordo com sua independência e com sua necessidade de comportamento.	uz u~'ma~.nus 'te~j~ u~.ma te~'de~.sja a es.tru.tu'rar a li~'gwa.Ze~j~ Di a'koR.du ko~ 'su.a i~.de.pe~'de~.sja i ko~ 'su.a ne.se.si'da.Di Di ko~.poX.ta~'me~.tu
Assim, quando ouço a linguagem sofrer abusos em favor das regras e não ser usada para compartilhar a vida conosco, é difícil permanecer em silêncio.	a'si~, 'kwa~.du 'ow.su a li~'gwa.Ze~j~ so'frer a'bu.zuz e~j~ fa'voR das 'RE.graz i 'na~w~ 'ser u'za.da 'pa.ra ko~.paX.Ti'Lar a 'vi.da ko~'nos.ku, E Di'fi.siw peR.ma~.ne'ser e~j~ si'le~.sju
Como deve ser, acrescentou Papai.	'ko~.mu 'dE.vi 'seX, a.kre.se~'tow pa'paj
Então o que foi exatamente que eu disse? perguntou Mack, agora bastante curioso.	e~'ta~w~ u ki 'foj e.za.ta~'me~.Ti ki ew 'Di.si, peR.gu~'tow 'mE.ki, a'gO.ra bas'ta~.Ti ku.ri'o.zu
Mack, vá em frente e termine de mastigar.	'mE.ki, 'va e~j~ 'fre~.Ti i teR'mi~.ni Di mas.Ti'gaX
Nós podemos conversar enquanto você come.	'nOjs po'de~.mus ko~.veX'sar e~'kwa~.tu vo'se 'ko~.mi
Mack percebeu que também estava com o garfo a caminho da boca.	'mE.ki peX.se'bew ki ta~'be~j~ es'ta.va ko~ u 'gaX.fu a ka~'mi~.Ju da 'bo.ka
Mastigou agradecido o bocado enquanto Sarayu começava a falar.	mas.Ti'gow a.gra.de'si.du u bo'ka.du e~'kwa~.tu sa.ra'ju ko~.me'sa.va a fa'laX
À medida que fazia isso, ela pareceu se alçar da cadeira e tremeluzir com uma dança de tons e cores sutis, enchendo suavemente a sala com uma variedade de aromas.	a me'Di.da ki fa'zi.a 'i.su, 'E.la pa.re'sew si aw'saR da ka'dej.ra i tre~.me.lu'ziX ko~ u~.ma 'da~.sa Di 'to~z i 'ko.ris su'Tis, e~'Se~.du su.a.ve~'me~.Ti a 'sa.la ko~ u~.ma va.ri.e'da.Di Di a'ro~.mas
Deixe-me responder com uma pergunta.	'dej.Si mi Res.po~'deX ko~ u~.ma peR'gu~.ta
Por que você acha que nós criamos os Dez Mandamentos?	puX 'ke vo'se 'a.Sa ki 'nOjs kri'a~.muz us 'dEjz ma~.da~'me~.tus
De novo Mack estava com o garfo a meio caminho da boca, mas mesmo assim mastigou o bocado enquanto pensava na resposta.	Di 'no.vu 'mE.ki es'ta.va ko~ u 'gaX.fu a 'mej.u ka~'mi~.Ju da 'bo.ka, majs 'mez.mu a'si~ mas.Ti'gow u bo'ka.du e~'kwa~.tu pe~'sa.va na Res'pOs.ta
Acho, pelo menos foi o que me ensinaram, que é um conjunto de regras que vocês esperavam que os humanos obedecessem para viver com retidão e em estado de graça perante vocês.	'a.Su, 'pe.lu 'me~.nus 'foj u ki mi e~.si~'na.ra~w~, ki E u~ ko~'Zu~.tu Di 'RE.gras ki vo'sejz es.pe'ra.va~w~ ki uz u~'ma~.nuz o.be.de'se.se~j~ 'pa.ra vi'veX ko~ Re.Ti'da~w~ i e~j~ es'ta.du Di 'gra.sa pe'ra~.Ti vo'sejs
Se isso fosse verdade, e não é, respondeu Sarayu, quantos você acha que viveram com retidão suficiente para entrar em nossas boas graças?	si 'i.su 'fo.si veR'da.Di, i 'na~w~ E, Res.po~'dew sa.ra'ju, 'kwa~.tus vo'se 'a.Sa ki vi've.ra~w~ ko~ Re.Ti'da~w~ su.fi.si'e~.Ti 'pa.ra e~'trar e~j~ 'nO.sas 'bo.as 'gra.sas
Não muitos, se as pessoas são como eu.	'na~w~ 'mu~j~.tus, si as pe'so.as 'sa~w~ 'ko~.mu ew
Na verdade, só um conseguiu: Jesus.	na veR'da.Di, 'sO u~ ko~.se'giw, Ze'zujs
Ele obedeceu à letra da lei e realizou completamente o espírito dela.	'e.li o.be.de'sew a 'le.tra da 'lej i Re.a.li'zow ko~.plE.ta~'me~.Ti u es'pi.ri.tu 'dE.la
Mas entenda, Mackenzie: para fazer isso, ele teve de confiar totalmente em mim e depender totalmente de mim.	majz e~'te~.da, ma'ke~.zi, 'pa.ra fa'zer 'i.su, 'e.li 'te.vi Di ko~.fi'aX to.taw'me~.Ti e~j~ 'mi~ i de.pe~'deX to.taw'me~.Ti Di 'mi~
Então por que vocês nos deram esses mandamentos?	e~'ta~w~ puX 'ke vo'sejs nus 'dE.ra~w~ 'e.sis ma~.da~'me~.tus
Na verdade, queríamos que vocês desistissem de tentar ser justos sozinhos.	na veR'da.Di, ke'ri.a~.mus ki vo'sejs de.zis'Ti.se~j~ Di te~'taX 'seR 'Zus.tus sO'zi~.Jus
Era um espelho para revelar como o rosto fica imundo quando se vive com independência.	'E.ra u~ es'pe.Lu 'pa.ra Re.ve'laX 'ko~.mu u 'Ros.tu 'fi.ka i~'mu~.du 'kwa~.du si 'vi.vi ko~ i~.de.pe~'de~.sja
Mas tenho certeza de que vocês sabem que há muitos que acham que se tornam justos seguindo as regras.	majs 'te~.Ju seX'te.za Di ki vo'sejs 'sa.be~j~ ki 'a 'mu~j~.tus ki 'a.Sa~w~ ki si 'tOR.na~w~ 'Zus.tus se'gi~.du as 'RE.gras
Mas é possível limpar o rosto com o mesmo espelho que mostra como você está sujo?	majz E po'si.vew li~'par u 'Ros.tu ko~ u 'mez.mu es'pe.Lu ki 'mOs.tra 'ko~.mu vo'se es'ta 'su.Zu
Não há misericórdia nem graça nas regras, nem mesmo para um erro.	'na~w~ 'a mi.ze.ri'kOR.Dja ne~j~ 'gra.sa nas 'RE.gras, ne~j~ 'mez.mu 'pa.ra u~ 'e.Ru
Agora ela estava com força total, as feições crescendo e movendo-se.	a'gO.ra 'E.la es'ta.va ko~ 'foX.sa to'taw, as fej'so~j~s kre'se~.du i mo've~.du si
Mas tenha em mente que, se você viver sua vida sozinho e de forma independente, a promessa é vazia.	majs 'te~.Ja e~j~ 'me~.Ti ki, si vo'se vi'veX 'su.a 'vi.da sO'zi~.Ju i Di 'fOR.ma i~.de.pe~'de~.Ti, a pro~'mE.sa E va'zi.a
Jesus afastou a exigência da lei.	Ze'zujz a.fas'tow a e.zi'Ze~.sja da 'lej
Ela não tem mais poder de acusar ou comandar.	'E.la 'na~w~ te~j~ 'majs po'deR Di a.ku'zar ow ko~.ma~'daX
Jesus é a promessa e o cumprimento.	Ze'zujz E a pro~'mE.sa i u ku~.pri~'me~.tu
Está dizendo que não preciso seguir as regras?	es'ta Di'ze~.du ki 'na~w~ pre'si.zu se'gir as 'RE.gras
Agora Mack havia parado completamente de comer e estava concentrado na conversa.	a'gO.ra 'mE.ki a'vi.a pa'ra.du ko~.plE.ta~'me~.Ti Di ko~'mer i es'ta.va ko~.se~'tra.du na ko~'vEX.sa
Em Jesus você não está sob nenhuma lei.	e~j~ Ze'zujs vo'se 'na~w~ es'ta sob ne~'Ju~.ma 'lej
Não pode estar falando sério! gemeu Mack.	'na~w~ 'pO.Di es'taX fa'la~.du 'sE.rju, Ze~'mew 'mE.ki
Criança, interrompeu Papai, você ainda não ouviu nada.	kri'a~.sa, i~.te.Ro~'pew pa'paj, vo'se a'i~.da 'na~w~ ow'viw 'na.da
Tentar manter a lei é na verdade uma declaração de independência, um modo de manter o controle.	te~'taR ma~'ter a 'lej E na veR'da.Di u~.ma de.kla.ra'sa~w~ Di i~.de.pe~'de~.sja, u~ 'mO.du Di ma~'ter u ko~'tro.li
É por isso que gostamos tanto da lei?	E pur 'i.su ki gos'ta~.mus 'ta~.tu da 'lej
Para nos dar algum controle? perguntou Mack.	'pa.ra nus 'dar aw'gu~ ko~'tro.li, peR.gu~'tow 'mE.ki
É muito pior do que isso, retomou Sarayu.	E 'mu~j~.tu pi'OR du ki 'i.su, Re.to~'mow sa.ra'ju
Ela dá o poder de julgar os outros e de se sentir superior a eles.	'E.la 'da u po'deR Di Zuw'gar uz 'ow.truz i Di si se~'TiX su.pe.ri'or a 'e.lis
Vocês acreditam que estão vivendo num padrão mais elevado do que aqueles a quem vocês julgam.	vo'sejz a.kre'Di.ta~w~ ki es'ta~w~ vi've~.du nu~ pa'dra~w~ 'majz e.le'va.du du ki a'ke.liz a 'ke~j~ vo'sej'Zuw.ga~w~
Aplicar regras, sobretudo em suas expressões mais sutis, como responsabilidade e expectativa, é uma tentativa inútil de criar a certeza a partir da incerteza.	a.pli'ka'RE.gras, so.bre'tu.du e~j~ 'su.az es.pre'so~j~s 'majs su'Tis, 'ko~.mu Res.po~.sa.bi.li'da.Di i es.pek.ta'Ti.va, E u~.ma te~'ta.Ti.va i~'nu.Tiw Di kri'ar a seX'te.za a paX'TiR da i~.seX'te.za
E, ao contrário do que você possa pensar, eu gosto demais da incerteza.	i, aw ko~'tra.rju du ki vo'se 'pO.sa pe~'saX, ew 'gOs.tu de~'majs da i~.seX'te.za
As regras não podem trazer a liberdade.	as 'RE.gras 'na~w~ 'pO.de~j~ tra'zer a li.beR'da.Di
De repente Mack percebeu o que Sarayu tinha dito.	Di Re'pe~.Ti 'mE.ki peX.se'bew u ki sa.ra'ju 'Ti~.Ja 'Di.tu
Está dizendo que a responsabilidade e a expectativa são apenas outra forma de regras?	es'ta Di'ze~.du ki a Res.po~.sa.bi.li'da.Di i a es.pek.ta'Ti.va 'sa~w~ a'pe~.naz 'ow.tra 'fOR.ma Di 'RE.gras
Ouvi direito?	ow'vi Di'rej.tu
É, exclamou Papai de novo.	E, es.kla~'mow pa'paj Di 'no.vu
Agora chegamos ao ponto: Sarayu, ele é todo seu!	a'gO.ra Se'ga~.muz aw 'po~.tu, sa.ra'ju, 'e.li E 'to.du 'sew
Mack procurou concentrar-se em Sarayu, o que não era uma tarefa simples.	'mE.ki pro.ku'row ko~.se~'traX si e~j~ sa.ra'ju, u ki 'na~w~ 'E.ra u~.ma ta'rE.fa 'si~.plis
Sarayu sorriu para Papai e de novo para Mack.	sa.ra'ju so'Riw 'pa.ra pa'paj i Di 'no.vu 'pa.ra 'mE.ki
Começou a falar lenta e decididamente:	ko~.me'sow a fa'laR 'le~.ta i de.si.Di.da~'me~.Ti
Mackenzie, eu sempre prefiro um verbo a um substantivo.	ma'ke~.zi, ew 'se~.pri pre'fi.ru u~ 'vER.bu a u~ subs.ta~'Ti.vu
Parou e esperou.	pa'row i es.pe'row
Mack não tinha muita certeza de ter entendido.	'mE.ki 'na~w~ 'Ti~.Ja 'mu~j~.ta seX'te.za Di 'ter e~.te~'Di.du
Eu, ela abriu as mãos para incluir Jesus e Papai, sou um verbo.	ew, 'E.la a'briw as 'ma~w~s 'pa.ra i~.klu'iR Ze'zujz i pa'paj, 'sow u~ 'vER.bu
Sou o que sou.	'sow u ki 'sow
Serei o que serei.	se'rej u ki se'rej
Sou um verbo!	'sow u~ 'vER.bu
Sou viva, dinâmica, sempre ativa e em movimento.	'sow 'vi.va, Di~'na~.mi.ka, 'se~.pri a'Ti.va i e~j~ mo.vi~'me~.tu
Sou um ser-verbo.	'sow u~ 'seX 'vER.bu
Mack tinha uma expressão vazia no rosto. Entendia as palavras, mas ainda não achava sentido.	'mE.ki 'Ti~.Ja u~.ma es.pre'sa~w~ va'zi.a nu 'Ros.tu, e~.te~'Di.a as pa'la.vras, majz a'i~.da 'na~w~ a'Sa.va se~'Ti.du
E, como minha essência é um verbo, continuou ela, sou mais ligada a verbos do que a substantivos.	i, 'ko~.mu 'mi~.Ja e'se~.sja E u~ 'vER.bu, ko~.Ti~.nu'ow 'E.la, 'sow 'majs li'ga.da a 'vER.bus du ki a subs.ta~'Ti.vus
Verbos como confessar, arrepender-se, viver, amar, responder, crescer, colher, mudar, semear, correr, dançar, cantar e assim por diante.	'vER.bus 'ko~.mu ko~.fe'saX, a.Re.pe~'deX si, vi'veX, a~'maX, Res.po~'deX, kre'seX, ko'LeX, mu'daX, se~.me'aX, ko'ReX, da~'saX, ka~'tar i a'si~ puR Di'a~.Ti
Os humanos, por outro lado, gostam de pegar um verbo vivo e cheio de graça e transformá-lo num substantivo ou num princípio morto que fede a regras.	uz u~'ma~.nus, pur 'ow.tru 'la.du, 'gOs.ta~w~ Di pe'gar u~ 'vER.bu 'vi.vu i 'Sej.u Di 'gra.sa i tra~s.foR'ma lu nu~ subs.ta~'Ti.vu ow nu~ pri~'si.pju 'moX.tu ki 'fE.Di a 'RE.gras
Os substantivos existem porque existe um Universo criado e uma realidade física, mas, se o Universo for apenas uma massa de substantivos, ele está morto.	us subs.ta~'Ti.vuz e'zis.te~j~ puX'ke e'zis.Ti u~ u~.ni'vEX.su kri'a.du i u~.ma Re.a.li'da.Di 'fi.zi.ka, majs, si u u~.ni'vEX.su 'for a'pe~.naz u~.ma 'ma.sa Di subs.ta~'Ti.vus, 'e.li es'ta 'moX.tu
A não ser eu sou, não existem verbos, e os verbos são o que torna o Universo vivo.	a 'na~w~ 'ser ew 'sow, 'na~w~ e'zis.te~j~ 'vER.bus, i us 'vER.bus 'sa~w~ u ki 'tOR.na u u~.ni'vEX.su 'vi.vu
E isso significa exatamente o quê?	i 'i.su si.gi~.ni'fi.ka e.za.ta~'me~.Ti u 'ke
Sarayu pareceu não se perturbar com sua falta de entendimento.	sa.ra'ju pa.re'sew 'na~w~ si peX.tuR'baX ko~ 'su.a 'faw.ta Di e~.te~.Di~'me~.tu
Para que alguma coisa se mova da morte para a vida, você precisa colocar algo vivo e móvel na mistura.	'pa.ra ki aw'gu~.ma 'koj.za si 'mo.va da 'mOX.Ti 'pa.ra a 'vi.da, vo'se pre'si.za ko.lo'kar 'aw.gu 'vi.vu i 'mO.vew na mis'tu.ra
Posso dar alguns exemplos?	'pO.su 'dar aw'gu~z e'ze~.plus
Por favor. Sou todo ouvidos.	puX fa'voX, 'sow 'to.du ow'vi.dus
Jesus deu um risinho e Mack piscou para ele antes de se voltar para Sarayu.	Ze'zujs 'dew u~ Ri'zi~.Ju i 'mE.ki pis'kow 'pa.ra 'e.li 'a~.Tis Di si vow'taX 'pa.ra sa.ra'ju
A sombra levíssima de um sorriso atravessou o rosto dela enquanto retomava	a 'so~.bra lE'vi.si~.ma Di u~ so'Ri.zu a.tra.ve'sow u 'Ros.tu 'dE.la e~'kwa~.tu Re.to~'ma.va
Então vamos usar suas duas palavras: responsabilidade e expectativa.	e~'ta~w~ 'va~.muz u'zaX 'su.as 'du.as pa'la.vras, Res.po~.sa.bi.li'da.Di i es.pek.ta'Ti.va
Antes que suas palavras se tornassem substantivos, eram nomes que continham movimento e experiência: a capacidade de reagir e a prontidão.	'a~.Tis ki 'su.as pa'la.vras si toR'na.se~j~ subs.ta~'Ti.vus, 'E.ra~w~ 'no~.mis ki ko~'Ti~.Ja~w~ mo.vi~'me~.tu i es.pe.ri'e~.sja, a ka.pa.si'da.Di Di Re.a'Zir i a pro~.Ti'da~w~
Minhas palavras são vivas e dinâmicas, cheias de vida e possibilidades.	'mi~.Jas pa'la.vras 'sa~w~ 'vi.vaz i Di~'na~.mi.kas, 'Sej.as Di 'vi.da i po.si.bi.li'da.Dis
As suas são mortas, cheias de leis, medo e julgamento.	as 'su.as 'sa~w~ 'mOX.tas, 'Sej.as Di 'lejs, 'me.du i Zuw.ga~'me~.tu
Por isso você não encontrará a palavra responsabilidade nas escrituras.	pur 'i.su vo'se 'na~w~ e~.ko~.tra'ra a pa'la.vra Res.po~.sa.bi.li'da.Di naz es.kri'tu.ras
Minha nossa!	'mi~.Ja 'nO.sa
Mack franziu a testa, começando a perceber aonde isso ia dar.	'mE.ki fra~'ziw a 'tEs.ta, ko~.me'sa~.du a peX.se'ber a'o~.Di 'i.su 'i.a 'daX
Por outro lado, nós a usamos um bocado.	pur 'ow.tru 'la.du, 'nOjz a u'za~.muz u~ bo'ka.du
Ela continuou:	'E.la ko~.Ti~.nu'ow
A religião usa a lei para ganhar força e controlar as pessoas de que precisa para sobreviver.	a Re.li.Zi'a~w~ 'u.za a 'lej 'pa.ra ga~'JaX 'foX.sa i ko~.tro'lar as pe'so.as Di ki pre'si.za 'pa.ra so.bre.vi'veX
Eu, ao contrário, dou a capacidade de reagir e sua reação é estar livre para amar e servir em todas as situações.	ew, aw ko~'tra.rju, 'dow a ka.pa.si'da.Di Di Re.a'Zir i 'su.a Re.a'sa~w~ E es'taR 'li.vri 'pa.ra a~'mar i seR'vir e~j~ 'to.daz as si.tu.a'so~j~s
Por isso, cada momento é diferente, único e maravilhoso.	pur 'i.su, 'ka.da mo~'me~.tu E Di.fe're~.Ti, 'u~.ni.ku i ma.ra.vi'Lo.zu
Como sou sua capacidade de reagir livremente, tenho de estar presente em vocês.	'ko~.mu 'sow 'su.a ka.pa.si'da.Di Di Re.a'ZiR li.vri~'me~.Ti, 'te~.Ju Di es'taX pre'ze~.Ti e~j~ vo'sejs
Se eu simplesmente lhes desse uma responsabilidade, não teria de estar com vocês.	si ew si~.pliz'me~.Ti Lis 'dE.si u~.ma Res.po~.sa.bi.li'da.Di, 'na~w~ te'ri.a Di es'taX ko~ vo'sejs
A responsabilidade seria uma tarefa a realizar, uma obrigação a cumprir, algo para vencer ou fracassar.	a Res.po~.sa.bi.li'da.Di se'ri.a u~.ma ta'rE.fa a Re.a.li'zaX, u~.ma o.bri.ga'sa~w~ a ku~'priX, 'aw.gu 'pa.ra ve~'ser ow fra.ka'saX
Usemos o exemplo da amizade e veremos que remover o elemento de vida de um substantivo pode alterar um relacionamento.	u'ze~.muz u e'ze~.plu da a~.mi'za.Di i ve're~.mus ki Re~.mo'ver u e.le~'me~.tu Di 'vi.da Di u~ subs.ta~'Ti.vu 'pO.Di aw.te'rar u~ Re.la.si.o~.na~'me~.tu
Mack, se você e eu somos amigos, há uma prontidão dentro de nosso relacionamento.	'mE.ki, si vo'se i ew 'so~.muz a~'mi.gus, 'a u~.ma pro~.Ti'da~w~ 'de~.tru Di 'nO.su Re.la.si.o~.na~'me~.tu
Quando nos vemos ou quando estamos separados, há a prontidão de estarmos juntos, de rirmos e falarmos.	'kwa~.du nus 've~.muz ow 'kwa~.du es'ta~.mus se.pa'ra.dus, 'a a pro~.Ti'da~w~ Di es'taR.mu'Zu~.tus, Di 'RiR.muz i fa'laR.mus
Essa prontidão não tem definição concreta: é viva, dinâmica, e tudo o que emerge do fato de estarmos juntos é um dom único que não é compartilhado por mais ninguém.	'E.sa pro~.Ti'da~w~ 'na~w~ te~j~ de.fi~.ni'sa~w~ ko~'krE.ta, E 'vi.va, Di~'na~.mi.ka, i 'tu.du u ki e~'mER.Zi du 'fa.tu Di es'taR.mu'Zu~.tuz E u~ 'do~w~ 'u~.ni.ku ki 'na~w~ E ko~.paX.Ti'La.du puR 'majs ni~'ge~j~
Mas o que acontece se eu mudar prontidão por expectativa, verbalizada ou não?	majz u ki a.ko~'tE.si si ew mu'daX pro~.Ti'da~w~ pur es.pek.ta'Ti.va, veR.ba.li'za.da ow 'na~w~
Subitamente a lei entra no nosso relacionamento.	su.bi.ta~'me~.Ti a 'lej 'e~.tra nu 'nO.su Re.la.si.o~.na~'me~.tu
Agora você espera que eu aja de um modo que atenda às suas expectativas.	a'gO.ra vo'se es'pE.ra ki ew 'a.Za Di u~ 'mO.du ki a'te~.da as 'su.az es.pek.ta'Ti.vas
Nossa amizade viva se deteriora rapidamente e se torna uma coisa morta, com regras e exigências.	'nO.sa a~.mi'za.Di 'vi.va si de.te.ri'O.ra Ra.pi.da~'me~.Ti i si 'tOR.na u~.ma 'koj.za 'mOX.ta, ko~ 'RE.graz i e.zi'Ze~.sjas
Não tem mais a ver com nós dois, mas com o que os amigos devem fazer ou com as responsabilidades de um bom amigo.	'na~w~ te~j~ 'majz a 'veX ko~ 'nOjs 'dojs, majs ko~ u ki uz a~'mi.gus 'dE.ve~j~ fa'zer ow ko~ as Res.po~.sa.bi.li'da.Dis Di u~ 'bo~ a~'mi.gu
Ou, observou Mack, com as responsabilidades de marido, de pai, empregado ou qualquer outra coisa.	ow, ob.seR'vow 'mE.ki, ko~ as Res.po~.sa.bi.li'da.Dis Di ma'ri.du, Di 'paj, e~.pre'ga.du ow kwaw'kEr 'ow.tra 'koj.za
Prefiro viver na prontidão.	pre'fi.ru vi'veR na pro~.Ti'da~w~
Eu também, disse Sarayu.	ew ta~'be~j~, 'Di.si sa.ra'ju
Mas, argumentou Mack, se não tivéssemos expectativas e responsabilidades, tudo não iria simplesmente desmoronar?	majs, aR.gu~.me~'tow 'mE.ki, si 'na~w~ Ti'vE.se~.muz es.pek.ta'Ti.vaz i Res.po~.sa.bi.li'da.Dis, 'tu.du 'na~w~ i'ri.a si~.pliz'me~.Ti dez.mo.ro~'naX
As responsabilidades e as expectativas são a base para a culpa, a vergonha e o julgamento.	as Res.po~.sa.bi.li'da.Diz i az es.pek.ta'Ti.vas 'sa~w~ a 'ba.zi 'pa.ra a 'kuw.pa, a veR'go~.Ja i u Zuw.ga~'me~.tu
Elas fornecem a estrutura que faz do comportamento a base para a identidade e o valor de alguém.	'E.las foR'nE.se~j~ a es.tru'tu.ra ki 'fajz du ko~.poX.ta~'me~.tu a 'ba.zi 'pa.ra a i.de~.Ti'da.Di i u va'loR Di aw'ge~j~
Você sabe muito bem como é não atender às expectativas de alguém.	vo'se 'sa.bi 'mu~j~.tu 'be~j~ 'ko~.mu E 'na~w~ a'te~.der az es.pek.ta'Ti.vas Di aw'ge~j~
Sei mesmo! murmurou Mack.	'sej 'mez.mu, muR.mu'row 'mE.ki
É uma ideia que me traz tristes lembranças.	E u~.ma i'dEj.a ki mi 'trajs 'tris.Tis le~'bra~.sas
Parou brevemente, com um novo pensamento relampejando.	pa'row brE.ve~'me~.Ti, ko~ u~ 'no.vu pe~.sa~'me~.tu Re.la~.pe'Za~.du
Voce está dizendo que não tem expectativas com relação a mim?	vo'se es'ta Di'ze~.du ki 'na~w~ te~j~ es.pek.ta'Ti.vas ko~ Re.la'sa~w~ a 'mi~
Agora papai falou:	a'gO.ra pa'paj fa'low
Querido, eu nunca tive expectativas com relação a você nem a ninguém.	ke'ri.du, ew 'nu~.ka 'Ti.vi es.pek.ta'Ti.vas ko~ Re.la'sa~w~ a vo'se ne~j~ a ni~'ge~j~
A ideia por trás disso exige que alguém não saiba o futuro ou o resultado e esteja tentando controlar o comportamento do outro para chegar ao resultado desejado.	a i'dEj.a puX 'trajs 'Di.su e'zi.Zi ki aw'ge~j~ 'na~w~ 'saj.ba u fu'tu.ru ow u Re.zuw'ta.du i es'te.Za te~'ta~.du ko~.tro'lar u ko~.poX.ta~'me~.tu du 'ow.tru 'pa.ra Se'gar aw Re.zuw'ta.du de.ze'Za.du
Os humanos tentam esse controle principalmente por meio das expectativas.	uz u~'ma~.nus 'te~.ta~w~ 'e.si ko~'tro.li pri~.si.paw'me~.Ti puR 'mej.u daz es.pek.ta'Ti.vas
Eu o conheço e sei tudo sobre você.	ew u ko~'Je.su i 'sej 'tu.du 'so.bri vo'se
Por que teria uma expectativa diferente daquilo que já sei?	puX 'ke te'ri.a u~.ma es.pek.ta'Ti.va Di.fe're~.Ti da'ki.lu ki 'Za 'sej
Seria idiotice.	se'ri.a i.Di.o'Ti.si
E, além disso, como não a tenho, vocês nunca me desapontam.	i, a'le~j~ 'Di.su, 'ko~.mu 'na~w~ a 'te~.Ju, vo'sejs 'nu~.ka mi de.za'po~.ta~w~
Você nunca ficou desapontado comigo?	vo'se 'nu~.ka fi'kow de.za.po~'ta.du ko~'mi.gu
Mack estava se esforçando bastante para digerir isso.	'mE.ki es'ta.va si es.foX'sa~.du bas'ta~.Ti 'pa.ra Di.Ze'rir 'i.su
Nunca! declarou Papai enfaticamente.	'nu~.ka, de.kla'row pa'paj e~.fa.Ti.ka~'me~.Ti
O que tenho é uma prontidão constante e viva no nosso relacionamento e lhe dou a capacidade de reagir a qualquer situação e circunstância em que você se encontrar.	u ki 'te~.Ju E u~.ma pro~.Ti'da~w~ ko~s'ta~.Ti i 'vi.va nu 'nO.su Re.la.si.o~.na~'me~.tu i Li 'dow a ka.pa.si'da.Di Di Re.a'Zir a kwaw'kEX si.tu.a'sa~w~ i siX.ku~s'ta~.sja e~j~ ki vo'se si e~.ko~'traX
Se passar a contar com expectativas e responsabilidades, você não me conhece nem confia em mim.	si pa'sar a ko~'taX ko~ es.pek.ta'Ti.vaz i Res.po~.sa.bi.li'da.Dis, vo'se 'na~w~ mi ko~'JE.si ne~j~ ko~'fi.a e~j~ 'mi~
E pela mesma razao, exclamou Jesus, você vive no medo!	i 'pe.la 'mez.ma Ra'za~w~, es.kla~'mow Ze'zujs, vo'se 'vi.vi nu 'me.du
Mas você não quer que a gente estabeleça prioridades?	majs vo'se 'na~w~ 'kEX ki a 'Ze~.Ti es.ta.be'le.sa pri.o.ri'da.Dis
Você sabe: Deus primeiro, depois sei lá o quê, seguido por mais não sei o quê?	vo'se 'sa.bi, 'dews pri~'mej.ru, de'pojs 'sej 'la u 'ke, se'gi.du puR 'majs 'na~w~ 'sej u 'ke
O problema de viver segundo prioridades, disse Sarayu, é que se vê tudo como uma hierarquia, uma pirâmide, e você e eu já falamos sobre isso.	u pro'ble~.ma Di vi'veX se'gu~.du pri.o.ri'da.Dis, 'Di.si sa.ra'ju, E ki si 've 'tu.du 'ko~.mu u~.ma i.e.raX'ki.a, u~.ma pi'ra~.mi.Di, i vo'se i ew 'Za fa'la~.mus 'so.bri 'i.su
Se você puser Deus no topo, o que isso realmente significa?	si vo'se pu'zeR 'dews nu 'to.pu, u ki 'i.su Re.aw'me~.Ti si.gi~.ni'fi.ka
Quanto tempo você me dá antes de poder cuidar do resto do seu dia, da parte que lhe interessa muitíssimo mais?	'kwa~.tu 'te~.pu vo'se mi 'da 'a~.Tis Di po'deX kuj'daR du 'REs.tu du 'sew 'Di.a, da 'paX.Ti ki Li i~.te'rE.sa mu~j~'Ti.si~.mu 'majs
Papai interrompeu de novo.	pa'paj i~.te.Ro~'pew Di 'no.vu
Veja bem, Mackenzie, eu não quero simplesmente um pedaço de você e da sua vida.	've.Za 'be~j~, ma'ke~.zi, ew 'na~w~ 'kE.ru si~.pliz'me~.Ti u~ pe'da.su Di vo'se i da 'su.a 'vi.da
Mesmo que você pudesse, e não pode, me dar o pedaço maior, não é isso que eu quero.	'mez.mu ki vo'se pu'dE.si, i 'na~w~ 'pO.Di, mi 'dar u pe'da.su maj'OX, 'na~w~ E 'i.su ki ew 'kE.ru
Agora Jesus falou de novo.	a'gO.ra Ze'zujs fa'low Di 'no.vu
Mack, não quero ser o primeiro numa lista de valores.	'mE.ki, 'na~w~ 'kE.ru 'ser u pri~'mej.ru 'nu~.ma 'lis.ta Di va'lo.ris
Quero estar no centro de tudo.	'kE.ru es'taR nu 'se~.tru Di 'tu.du
Quando vivo em você, podemos viver juntos tudo que acontece com você.	'kwa~.du 'vi.vu e~j~ vo'se, po'de~.mus vi'veR 'Zu~.tus 'tu.du ki a.ko~'tE.si ko~ vo'se
Em vez de uma pirâmide, quero ser como o centro de um móbile, onde tudo em sua vida, seus amigos, sua família, seu trabalho, os pensamentos, as atividades, esteja ligado a mim, mas se movimente ao vento, para dentro e para fora, para trás e para frente, numa incrível dança do ser.	e~j~ 'vejz Di u~.ma pi'ra~.mi.Di, 'kE.ru 'seX 'ko~.mu u 'se~.tru Di u~ 'mO.bi.li, 'o~.Di 'tu.du e~j~ 'su.a 'vi.da, 'sewz a~'mi.gus, 'su.a fa~'mi.lja, 'sew tra'ba.Lu, us pe~.sa~'me~.tus, az a.Ti.vi'da.Dis, es'te.Za li'ga.du a 'mi~, majs si mo.vi~'me~.Ti aw 've~.tu, 'pa.ra 'de~.tru i 'pa.ra 'fO.ra, 'pa.ra 'trajz i 'pa.ra 'fre~.Ti, 'nu~.ma i~'kri.vew 'da~.sa du 'seX
E eu, concluiu Sarayu, sou o vento.	i ew, ko~.klu'iw sa.ra'ju, 'sow u 've~.tu
Ela deu um sorriso enorme e fez uma reverência.	'E.la 'dew u~ so'Ri.zu e~'nOR.mi i 'fejz u~.ma Re.ve're~.sja
Houve silêncio enquanto Mack procurava se controlar.	'ow.vi si'le~.sju e~'kwa~.tu 'mE.ki pro.ku'ra.va si ko~.tro'laX
Estivera segurando a borda da mesa com as duas mãos, como se quisesse agarrar algo tangível diante daquele tiroteio de ideias e imagens.	es.Ti'vE.ra se.gu'ra~.du a 'bOR.da da 'me.za ko~ as 'du.as 'ma~w~s, 'ko~.mu si ki'zE.si a.ga'Rar 'aw.gu ta~'Zi.vew Di'a~.Ti da'ke.li Ti.ro'tej.u Di i'dEj.az i i~'ma.Ze~s
Bom, chega disso, declarou Papai levantando-se da cadeira.	'bo~, 'Se.ga 'Di.su, de.kla'row pa'paj le.va~'ta~.du si da ka'dej.ra
É hora de diversão!	E 'O.ra Di Di.veX'sa~w~
Vocês vão em frente enquanto eu tiro as coisas que podem estragar.	vo'sejs 'va~w~ e~j~ 'fre~.Ti e~'kwa~.tu ew 'Ti.ru as 'koj.zas ki 'pO.de~j~ es.tra'gaX
Cuido dos pratos mais tarde.	'kuj.du dus 'pra.tus 'majs 'taR.Di
E as orações? perguntou Mack.	i az o.ra'so~j~s, peR.gu~'tow 'mE.ki
Nada é um ritual, Mack, disse Papai, pegando alguns pratos de comida.	'na.da E u~ Ri.tu'aw, 'mE.ki, 'Di.si pa'paj, pe'ga~.du aw'gu~s 'pra.tus Di ko~'mi.da
Portanto, esta noite vamos fazer uma coisa diferente. Você vai gostar!	poX'ta~.tu, 'Es.ta 'noj.Ti 'va~.mus fa'zer u~.ma 'koj.za Di.fe're~.Ti, vo'se 'vaj gos'taX
Enquanto se levantava e se virava para acompanhar Jesus até a porta dos fundos, Mack sentiu uma mão no ombro e virou-se.	e~'kwa~.tu si le.va~'ta.va i si vi'ra.va 'pa.ra a.ko~.pa~'JaR Ze'zujz a'tE a 'pOX.ta dus 'fu~.dus, 'mE.ki se~'Tiw u~.ma 'ma~w~ nu 'o~.bru i vi'row si
Sarayu estava parada ali, olhando-o com intensidade.	sa.ra'ju es'ta.va pa'ra.da a'li, o'La~.du u ko~ i~.te~.si'da.Di
Mackenzie, se você me permitir, gostaria de lhe dar um presente para esta noite.	ma'ke~.zi, si vo'se mi peR.mi'TiX, gos.ta'ri.a Di Li 'dar u~ pre'ze~.Ti 'pa.ra 'Es.ta 'noj.Ti
Eu enxergo bastante bem.	ew e~'SER.gu bas'ta~.Ti 'be~j~
Na verdade, disse Sarayu em tom de desculpa, você vê muito pouco, embora para um ser humano enxergue bastante bem.	na veR'da.Di, 'Di.si sa.ra'ju e~j~ 'to~ Di des'kuw.pa, vo'se 've 'mu~j~.tu 'pow.ku, e~'bO.ra 'pa.ra u~ 'ser u~'ma~.nu e~'SER.gi bas'ta~.Ti 'be~j~
Então está bem, concordou Mack.	e~'ta~w~ es'ta 'be~j~, ko~.koR'dow 'mE.ki
Por favor, toque meus olhos e até mais, se quiser.	puX fa'voX, 'tO.ki 'mewz 'O.Luz i a'tE 'majs, si ki'zEX
Enquanto Sarayu estendia as mãos para ele, Mack fechou os olhos.	e~'kwa~.tu sa.ra'ju es.te~'Di.a as 'ma~w~s 'pa.ra 'e.li, 'mE.ki fe'Sow uz 'O.Lus
O toque dela era como gelo, inesperado e empolgante.	u 'tO.ki 'dE.la 'E.ra 'ko~.mu 'Ze.lu, i~.nes.pe'ra.du i e~.pow'ga~.Ti
Um tremor delicioso o atravessou e Mack ergueu as mãos para segurar as dela junto ao rosto.	u~ tre~'moR de.li.si'o.zu u a.tra.ve'sow i 'mE.ki eR'gew as 'ma~w~s 'pa.ra se.gu'rar as 'dE.la 'Zu~.tu aw 'Ros.tu
Não havia nada ali e ele começou lentamente a abrir os olhos.	'na~w~ a'vi.a 'na.da a'li i 'e.li ko~.me'sow le~.ta~'me~.Ti a a'brir uz 'O.Lus
Você pode dizer adeus a sua família e a seus amigos e afastar-se quilômetros e quilômetros e, ao mesmo tempo, carregá-los em seu coração, em sua mente, em seu estômago, pois você não apenas vive no mundo, mas o mundo vive em você.	vo'se 'pO.Di Di'zer a'dewz a 'su.a fa~'mi.lja i a 'sewz a~'mi.guz i a.fas'taX si ki'lo~.me.truz i ki'lo~.me.truz i, aw 'mez.mu 'te~.pu, ka.Re'ga lus e~j~ 'sew ko.ra'sa~w~, e~j~ 'su.a 'me~.Ti, e~j~ 'sew es'to~.ma.gu, 'pojs vo'se 'na~w~ a'pe~.nas 'vi.vi nu 'mu~.du, majz u 'mu~.du 'vi.vi e~j~ vo'se
Quando abriu os olhos, Mack teve de protegê-los imediatamente de uma luz muito intensa que o ofuscou.	'kwa~.du a'briw uz 'O.Lus, 'mE.ki 'te.vi Di pro.te'Ze luz i~.me.Di.a.ta~'me~.Ti Di u~.ma 'lujz 'mu~j~.tu i~'te~.sa ki u o.fus'kow
Depois ouviu algo.	de'pojz ow'viw 'aw.gu
Você vai achar muito difícil olhar diretamente para mim, disse a voz de Sarayu, ou para Papai.	vo'se 'vaj a'SaR 'mu~j~.tu Di'fi.siw o'LaR Di.rE.ta~'me~.Ti 'pa.ra 'mi~, 'Di.si a 'vOjz Di sa.ra'ju, ow 'pa.ra pa'paj
Mas, a medida que sua mente se acostumar as mudanças, será mais fácil.	majs, a me'Di.da ki 'su.a 'me~.Ti si a.kos.tu~'mar as mu'da~.sas, se'ra 'majs 'fa.siw
Ele estava parado no mesmo lugar onde fechara os olhos, mas a cabana havia sumido, assim como o cais e a carpintaria.	'e.li es'ta.va pa'ra.du nu 'mez.mu lu'gar 'o~.Di fe'Sa.ra uz 'O.Lus, majz a ka'ba~.na a'vi.a su~'mi.du, a'si~ 'ko~.mu u 'kajz i a kaX.pi~.ta'ri.a
Estava ao ar livre, no topo de uma pequena colina, sob um céu noturno brilhante mas sem lua.	es'ta.va aw 'aR 'li.vri, nu 'to.pu Di u~.ma pe'ke~.na ko'li~.na, sob u~ 'sEw no'tuR.nu bri'La~.Ti majs se~j~ 'lu.a
Podia ver as estrelas em movimento, tranquilamente e com precisão, como se houvesse grandes condutores celestiais coordenando seus movimentos.	po'Di.a 'ver az es'tre.laz e~j~ mo.vi~'me~.tu, tra~.kwi.la~'me~.Ti i ko~ pre.si'za~w~, 'ko~.mu si ow'vE.si 'gra~.Dis ko~.du'to.ris se.les.Ti'ajs ko.oR.de~'na~.du 'sews mo.vi~'me~.tus
Ocasionalmente, como se recebendo um comando, cometas e chuvas de meteoros rolavam por entre as estrelas, acrescentando variação à dança.	o.ka.zi.o~.naw'me~.Ti, 'ko~.mu si Re.se'be~.du u~ ko~'ma~.du, ko~'me.taz i 'Su.vas Di me.te'O.rus Ro'la.va~w~ pur 'e~.tri az es'tre.las, a.kre.se~'ta~.du va.ri.a'sa~w~ a 'da~.sa
Era como se o tempo tivesse se tornado dinâmico e volátil, juntando-se a imagem celestial aparentemente caótica, mas administrada com precisão.	'E.ra 'ko~.mu si u 'te~.pu Ti'vE.si si toR'na.du Di~'na~.mi.ku i vo'la.Tiw, Zu~'ta~.du si a i~'ma.Ze~j~ se.les.Ti'aw a.pa.re~.Ti~'me~.Ti ka'O.Ti.ka, majz a.Di~.mi~.nis'tra.da ko~ pre.si'za~w~
Ele se virou para Sarayu, que ainda estava ao seu lado.	'e.li si vi'row 'pa.ra sa.ra'ju, ki a'i~.da es'ta.va aw 'sew 'la.du
Apesar de ser difícil olhar diretamente para ela, agora podia vislumbrar simetria e cores engastadas em padrões, como se minúsculos diamantes, rubis e safiras tivessem sido costurados numa roupa de luz que se movia primeiro em ondas e depois se espalhava em partículas.	a.pe'zaR Di 'seR Di'fi.siw o'LaR Di.rE.ta~'me~.Ti 'pa.ra 'E.la, a'gO.ra po'Di.a viz.lu~'braX si~.me'tri.a i 'ko.riz e~.gas'ta.daz e~j~ pa'dro~j~s, 'ko~.mu si mi~'nus.ku.lus Di.a~'ma~.Tis, Ru'biz i sa'fi.ras Ti'vE.se~j~ 'si.du kos.tu'ra.dus 'nu~.ma 'Row.pa Di 'lujs ki si mo'vi.a pri~'mej.ru e~j~ 'o~.daz i de'pojs si es.pa'La.va e~j~ paX'Ti.ku.las
É tudo incrivelmente lindo! sussurrou ele.	E 'tu.du i~.kri.vew'me~.Ti 'li~.du, su.su'Row 'e.li
É verdade.	E veR'da.Di
A voz de Sarayu vinha da luz.	a 'vOjz Di sa.ra'ju 'vi~.Ja da 'lujs
Agora, Mackenzie, olhe ao redor.	a'gO.ra, ma'ke~.zi, 'O.Li aw Re'dOX
Ele ficou boquiaberto.	'e.li fi'kow bo.ki.a'bEX.tu
Mesmo na escuridão da noite, tudo tinha clareza e brilhava com halos de luz em vários tons e cores.	'mez.mu na es.ku.ri'da~w~ da 'noj.Ti, 'tu.du 'Ti~.Ja kla're.za i bri'La.va ko~ 'a.lus Di 'lujz e~j~ 'va.rjus 'to~z i 'ko.ris
Embora a floresta estivesse incendiada de luz e cor, cada árvore e cada folha eram distintamente visíveis.	e~'bO.ra a flo'rEs.ta es.Ti'vE.si i~.se~.Di'a.da Di 'lujz i 'koX, 'ka.da 'aR.vo.ri i 'ka.da 'fo.La 'E.ra~w~ Dis.Ti~.ta~'me~.Ti vi'zi.vejs
Pássaros criavam uma trilha de fogo colorido ao voarem se perseguindo.	'pa.sa.rus kri'a.va~w~ u~.ma 'tri.La Di 'fo.gu ko.lo'ri.du aw vo'a.re~j~ si peX.se'gi~.du
À distância, um exército da Criação parecia estar a postos:	a Dis'ta~.sja, u~ e'zEX.si.tu da kri.a'sa~w~ pa.re'si.a es'tar a 'pOs.tus
Cervos, Ursos, cabritos monteses e alces majestosos desfilavam perto das bordas da floresta, lontras e castores no lago, cada um luzindo com cores chamejantes.	'sER.vus, 'uX.sus, ka'bri.tus mo~'te.ziz i 'aw.sis ma.Zes'tO.zus des.fi'la.va~w~ 'pEX.tu das 'bOR.das da flo'rEs.ta, 'lo~.traz i kas'to.ris nu 'la.gu, 'ka.da 'u~ lu'zi~.du ko~ 'ko.ri.Sa~.me'Za~.Tis
Num jorro de chamas, uma águia-pescadora mergulhou em direção à superfície do lago, mas mudou o curso no último instante e roçou a superfície, com fagulhas caindo como neve nas águas.	nu~ 'Zo.Ru Di 'Sa~.mas, u~.ma 'a.gja pes.ka'do.ra meR.gu'Low e~j~ Di.re'sa~w~ a su.peX'fi.si du 'la.gu, majs mu'dow u 'kuX.su nu 'uw.Ti~.mu i~s'ta~.Ti i Ro'sow a su.peX'fi.si, ko~ fa'gu.Las ka'i~.du 'ko~.mu 'nE.vi naz 'a.gwas
Atrás dela, uma grande truta vestida de arco-íris rompeu à superfície e mergulhou de volta em meio a um borrifo de cores.	a'trajs 'dE.la, u~.ma 'gra~.Di 'tru.ta ves'Ti.da Di 'aX.ku 'i.ris Ro~'pew a su.peX'fi.si i meR.gu'Low Di 'vOw.ta e~j~ 'mej.u a u~ bo'Ri.fu Di 'ko.ris
Mack sentiu-se maior do que a vida, como se pudesse estar presente em todas as partes.	'mE.ki se~'Tiw si maj'OR du ki a 'vi.da, 'ko~.mu si pu'dE.si es'taX pre'ze~.Ti e~j~ 'to.daz as 'paX.Tis
Dois filhotes de urso brincavam ao pé da mãe e, de onde estava, Mack, sem pensar, estendeu o braço para tocá-los.	'dojs fi'LO.Tis Di 'uX.su bri~'ka.va~w~ aw 'pE da 'ma~j~ 'i, Di 'o~.Di es'ta.va, 'mE.ki, se~j~ pe~'saX, es.te~'dew u 'bra.su 'pa.ra to'ka lus
Recolheu-o de volta, espantado ao perceber que também chamejava.	Re.ko'Lew u Di 'vOw.ta, es.pa~'ta.du aw peX.se'beX ki ta~'be~j~ Sa~.me'Za.va
Olhou as mãos maravilhosamente esculpidas e claramente visíveis dentro da cascata de cores de luz que parecia cobrí-las como luvas.	o'Low as 'ma~w~s ma.ra.vi.LO.za~'me~.Ti es.kuw'pi.daz i kla.ra~'me~.Ti vi'zi.vejs 'de~.tru da kas'ka.ta Di 'ko.ris Di 'lujs ki pa.re'si.a ko'bri las 'ko~.mu 'lu.vas
Examinou o resto do corpo e descobriu que a luz e a cor o envolviam completamente.	e.za~.mi~'now u 'REs.tu du 'koX.pu i des.ko'briw ki a 'lujz i a 'kor u e~.vow'vi.a~w~ ko~.plE.ta~'me~.Ti
Uma veste de pureza que o revestia de liberdade e decência.	u~.ma 'vEs.Ti Di pu're.za ki u Re.ves'Ti.a Di li.beR'da.Di i de'se~.sja
Também percebeu que não sentia dor, nem mesmo nas juntas geralmente doloridas.	ta~'be~j~ peX.se'bew ki 'na~w~ se~'Ti.a 'doX, ne~j~ 'mez.mu na'Zu~.ta.Ze.raw'me~.Ti do.lo'ri.das
Na verdade, nunca havia se sentido tão bem, tão inteiro.	na veR'da.Di, 'nu~.ka a'vi.a si se~'Ti.du 'ta~w~ 'be~j~, 'ta~w~ i~'tej.ru
Sua cabeça estava límpida e ele respirava profundamente os perfumes da noite e das flores.	'su.a ka'be.sa es'ta.va 'li~.pi.da i 'e.li Res.pi'ra.va pro.fu~.da~'me~.Ti us peX'fu~.mis da 'noj.Ti i das 'flo.ris
Uma alegria delirante e deliciosa cresceu por dentro, e ele flutuou lentamente no ar, retornando suavemente ao chão.	u~.ma a.le'gri.a de.li'ra~.Ti i de.li.si'O.za kre'sew puR 'de~.tru, i 'e.li flu.tu'ow le~.ta~'me~.Ti nu 'aX, Re.toR'na~.du su.a.ve~'me~.Ti aw 'Sa~w~
É como se eu voasse em um sonho, pensou.	E 'ko~.mu si ew vo'a.si e~j~ u~ 'so~.Ju, pe~'sow
Então Mack viu as luzes.	e~'ta~w~ 'mE.ki 'viw as 'lu.zis
Pontos em movimento emergiam da floresta, convergindo para a campina abaixo onde ele estava com Sarayu.	'po~.tuz e~j~ mo.vi~'me~.tu e~.meR'Zi.a~w~ da flo'rEs.ta, ko~.veR'Zi~.du 'pa.ra a ka~'pi~.na a'baj.Su 'o~.Di 'e.li es'ta.va ko~ sa.ra'ju
Agora podia vê-los no alto das montanhas ao redor, aparecendo e desaparecendo enquanto vinham em sua direção seguindo caminhos e trilhas invisíveis.	a'gO.ra po'Di.a 've lus nu 'aw.tu das mo~'ta~.Jaz aw Re'dOX, a.pa.re'se~.du i de.za.pa.re'se~.du e~'kwa~.tu 'vi~.Ja~w~ e~j~ 'su.a Di.re'sa~w~ se'gi~.du ka~'mi~.Juz i 'tri.Laz i~.vi'zi.vejs
Chegou a campina um exército de crianças.	Se'gow a ka~'pi~.na u~ e'zEX.si.tu Di kri'a~.sas
Não havia velas, elas próprias eram luzes.	'na~w~ a'vi.a 'vE.las, 'E.las 'prO.prjaz 'E.ra~w~ 'lu.zis
E, dentro de sua própria luminosidade, cada uma vestia roupas diferentes que Mack imaginou que correspondiam a tribos diversas.	i, 'de~.tru Di 'su.a 'prO.prja lu~.mi~.no.zi'da.Di, 'ka.da u~.ma ves'Ti.a 'Row.pas Di.fe're~.Tis ki 'mE.ki i~.ma.Zi~'now ki ko.Res.po~'Di.a~w~ a 'tri.bus Di'vEX.sas
Eram as crianças da Terra, os filhos de Papai.	'E.ra~w~ as kri'a~.sas da 'tE.Ra, us 'fi.Lus Di pa'paj
Acercaram-se com dignidade e graça silenciosa, rostos cheios de contentamento e paz, as maiores segurando as mãos das menores.	a.seX'ka.ra~w~ si ko~ Di.gi~.ni'da.Di i 'gra.sa si.le~.si'O.za, 'Ros.tu'Sej.us Di ko~.te~.ta~'me~.tu i 'pajs, as maj'O.ris se.gu'ra~.du as 'ma~w~s das me~'nO.ris
Por um momento Mack se perguntou se Missy estaria ali, mas logo desistiu.	pur u~ mo~'me~.tu 'mE.ki si peR.gu~'tow si 'mi.si es.ta'ri.a a'li, majs 'lO.gu de.zis'Tiw
Achou que se estivesse e quisesse ir ao seu encontro, correria para ele.	a'Sow ki si es.Ti'vE.si i ki'zE.si 'ir aw 'sew e~'ko~.tru, ko.Re'ri.a 'pa.ra 'e.li
Agora as crianças haviam formado um círculo enorme na campina, deixando um caminho aberto a partir das proximidades de onde Mack estava, bem no centro.	a'gO.ra as kri'a~.saz a'vi.a~w~ foR'ma.du u~ 'siX.ku.lu e~'nOR.mi na ka~'pi~.na, dej'Sa~.du u~ ka~'mi~.Ju a'bEX.tu a paX'TiR das pro.si~.mi'da.Dis Di 'o~.Di 'mE.ki es'ta.va, 'be~j~ nu 'se~.tru
Pequenos jorros de fogo e luz, como flashes fotográficos, espocavam lentamente, acendendo-se quando as crianças riam ou sussurravam.	pe'ke~.nu'Zo.Rus Di 'fo.gu i 'lujs, 'ko~.mu 'flE.Sis fo.to'gra.fi.kus, es.po'ka.va~w~ le~.ta~'me~.Ti, a.se~'de~.du si 'kwa~.du as kri'a~.sas 'Ri.a~w~ ow su.su'Ra.va~w~
Embora Mack não fizesse ideia do que estava acontecendo, elas obviamente sabiam.	e~'bO.ra 'mE.ki 'na~w~ fi'zE.si i'dEj.a du ki es'ta.va a.ko~.te'se~.du, 'E.laz Ob.vi.a~'me~.Ti sa'bi.a~w~
Emergindo na clareira atrás delas e formando outro círculo de luzes maiores apareceram adultos cheios de cores brilhantes, mas discretas.	e~.meR'Zi~.du na kla'rej.ra a'trajs 'dE.laz i foR'ma~.du 'ow.tru 'siX.ku.lu Di 'lu.zis maj'O.riz a.pa.re'se.ra~w~ a'duw.tu'Sej.us Di 'ko.ris bri'La~.Tis, majs Dis'krE.tas
De repente a atenção de Mack foi atraída por um movimento incomum.	Di Re'pe~.Ti a a.te~'sa~w~ Di 'mE.ki 'foj a.tra'i.da pur u~ mo.vi~'me~.tu i~.ko~'mu~
Parecia que um dos seres de luz no círculo externo estava tendo alguma dificuldade.	pa.re'si.a ki 'u~ dus 'se.ris Di 'lujz nu 'siX.ku.lu es'tER.nu es'ta.va 'te~.du aw'gu~.ma Di.fi.kuw'da.Di
Clarões e lanças de cor violeta e marfim saltavam em forma de breves arcos na noite, sendo substituídos por tons de orquídea, ouro e vermelho flamejante, jorros ardentes e luminosos de luz que explodiam indo ao encontro da escuridão ao redor.	kla'ro~j~z i 'la~.sas Di 'koR vi.o'le.ta i maX'fi~ saw'ta.va~w~ e~j~ 'fOR.ma Di 'brE.viz 'aX.kus na 'noj.Ti, 'se~.du subs.Ti.tu'i.dus puX 'to~s Di oX'ki.Dja, 'ow.ru i veR'me.Lu fla~.me'Za~.Ti, 'Zo.Ruz aR'de~.Tiz i lu~.mi~'nO.zus Di 'lujs ki es.plo'Di.a~w~ 'i~.du aw e~'ko~.tru da es.ku.ri'da~w~ aw Re'dOX
Sarayu deu um risinho.	sa.ra'ju 'dew u~ Ri'zi~.Ju
O que está acontecendo? sussurrou Mack.	u ki es'ta a.ko~.te'se~.du, su.su'Row 'mE.ki
Há um homem com dificuldade para conter o que está sentindo.	'a u~ 'o~.me~j~ ko~ Di.fi.kuw'da.Di 'pa.ra ko~'ter u ki es'ta se~'Ti~.du
A pessoa que não conseguia se controlar agitava as que estavam próximas.	a pe'so.a ki 'na~w~ ko~.se'gi.a si ko~.tro'lar a.Zi'ta.va as ki es'ta.va~w~ 'prO.si~.mas
O efeito de ondulação era claramente visível à medida que a luz flamejante se estendia até o círculo de crianças.	u e'fej.tu Di o~.du.la'sa~w~ 'E.ra kla.ra~'me~.Ti vi'zi.vew a me'Di.da ki a 'lujs fla~.me'Za~.Ti si es.te~'Di.a a'tE u 'siX.ku.lu Di kri'a~.sas
As mais próximas do instigador pareciam reagir conforme as cores e luzes fluíam delas para ele.	as 'majs 'prO.si~.mas du i~s.Ti.ga'doX pa.re'si.a~w~ Re.a'ZiX ko~'fOR.mi as 'ko.riz i 'lu.zis flu'i.a~w~ 'dE.las 'pa.ra 'e.li
As combinações que emergiam eram únicas, diferentes da cor daquele que estava provocando a agitação.	as ko~.bi~.na'so~j~s ki e~.meR'Zi.a~w~ 'E.ra~w~ 'u~.ni.kas, Di.fe're~.Tis da 'koR da'ke.li ki es'ta.va pro.vo'ka~.du a a.Zi.ta'sa~w~
Ainda não entendo, sussurrou Mack de novo.	a'i~.da 'na~w~ e~'te~.du, su.su'Row 'mE.ki Di 'no.vu
Mackenzie, o padrão de cor e luz é único em cada pessoa, não há dois iguais, nenhum padrão se repete.	ma'ke~.zi, u pa'dra~w~ Di 'kor i 'lujz E 'u~.ni.ku e~j~ 'ka.da pe'so.a, 'na~w~ 'a 'dojz i'gwajs, ne~'Ju~ pa'dra~w~ si Re'pE.Ti
Aqui podemos ver uns aos outros verdadeiramente por que cada personalidade e cada emoção são visíveis como cor e luz.	a'ki po'de~.mus 'ver u~z awz 'ow.trus veR.da.dej.ra~'me~.Ti puX 'ke 'ka.da peX.so~.na.li'da.Di i 'ka.da e~.mo'sa~w~ 'sa~w~ vi'zi.vejs 'ko~.mu 'kor i 'lujs
Isso é incrível! exclamou Mackenzie.	'i.su E i~'kri.vew, es.kla~'mow ma'ke~.zi
Então por que as cores das crianças são principalmente brancas?	e~'ta~w~ puX 'ke as 'ko.ris das 'kri.a~.sas 'sa~w~ pri~.si.paw'me~.Ti 'bra~.kas
Se você se aproximar, verá que elas tem muitas cores individuais que se fundiram no branco.	si vo'se si a.pro.si~'maX, ve'ra ki 'E.las te~j~ 'mu~j~.tas 'ko.riz i~.Di.vi.du'ajs ki si fu~'Di.ra~w~ nu 'bra~.ku
À medida que elas amadurecerem e crescerem, as cores irão se tornar mais distintas e emergirão tons e matizes únicos.	a me'Di.da ki 'E.laz a~.ma.du.re'se.re~j~ i kre'se.re~j~, as 'ko.riz i'ra~w~ si toR'naR 'majs Dis'Ti~.taz i e~.meR.Zi'ra~w~ 'to~z i ma'Ti.ziz 'u~.ni.kus
Incrível! foi tudo o que Mack conseguiu dizer.	i~'kri.vew, 'foj 'tu.du u ki 'mE.ki ko~.se'giw Di'zeX
Olhou com mais atenção e notou que por trás do círculo de adultos haviam surgido outros, igualmente espaçados, ao redor de todo o perímetro.	o'Low ko~ 'majz a.te~'sa~w~ i no'tow ki puX 'trajs du 'siX.ku.lu Di a'duw.tuz a'vi.a~w~ suR'Zi.du 'ow.trus, i.gwaw'me~.Ti es.pa'sa.dus, aw Re'dOR Di 'to.du u pe'ri~.me.tru
Eram chamas mais altas, aparentemente soprando com as correntes de ar, e tinham cores semelhantes, de safira e azul-água, com pedacinhos únicos de outras cores engastados em cada um.	'E.ra~w~ 'Sa~.mas 'majz 'aw.tas, a.pa.re~.Ti~'me~.Ti so'pra~.du ko~ as ko'Re~.Tis Di 'aX, i 'Ti~.Ja~w~ 'ko.ris se~.me'La~.Tis, Di sa'fi.ra i a'zuw 'a.gwa, ko~ pe.da'si~.Juz 'u~.ni.kus Di 'ow.tras 'ko.riz e~.gas'ta.duz e~j~ 'ka.da 'u~
Anjos, respondeu Sarayu antes que Mack pudesse perguntar.	'a~.Zus, Res.po~'dew sa.ra'ju 'a~.Tis ki 'mE.ki pu'dE.si peR.gu~'taX
Servidores e guardiões.	seR.vi'do.riz i gwaR.Di'o~j~s
Incrível! exclamou Mack mais uma vez.	i~'kri.vew, es.kla~'mow 'mE.ki 'majz u~.ma 'vejs
Há mais, Mackenzie, e isso vai ajudá-lo a entender o problema que aquele indivíduo está tendo.	'a 'majs, ma'ke~.zi, i 'i.su 'vaj a.Zu'da lu a e~.te~'der u pro'ble~.ma ki a'ke.li i~.Di'vi.dwu es'ta 'te~.du
Ela apontou na direção da agitação que continuava, lançando luzes e cores súbitas e abruptas na direção deles.	'E.la a.po~'tow na Di.re'sa~w~ da a.Zi.ta'sa~w~ ki ko~.Ti~.nu'a.va, la~'sa~.du 'lu.ziz i 'ko.ris 'su.bi.taz i a'brup.tas na Di.re'sa~w~ 'de.lis
Não somente conseguimos ver a especificidade de cada pessoa em cor e luz como reagimos também usando cor e luz.	'na~w~ sO~'me~.Ti ko~.se'gi~.mus 'ver a es.pe.si.fi.si'da.Di Di 'ka.da pe'so.a e~j~ 'kor i 'lujs 'ko~.mu Re.a'Zi~.mus ta~'be~j~ u'za~.du 'kor i 'lujs
Essa reação é muito difícil de controlar e geralmente não deve ser contida, como esse homem está tentando.	'E.sa Re.a'sa~w~ E 'mu~j~.tu Di'fi.siw Di ko~.tro'lar i Ze.raw'me~.Ti 'na~w~ 'dE.vi 'seX ko~'Ti.da, 'ko~.mu 'e.si 'o~.me~j~ es'ta te~'ta~.du
É mais natural deixar que a reação simplesmente se expresse.	E 'majs na.tu'raw dej'SaX ki a Re.a'sa~w~ si~.pliz'me~.Ti si es'prE.si
Não entendo, hesitou Mack.	'na~w~ e~'te~.du, e.zi'tow 'mE.ki
Está dizendo que podemos reagir uns aos outros em cores?	es'ta Di'ze~.du ki po'de~.mus Re.a'Zir u~z awz 'ow.truz e~j~ 'ko.ris
Sim, Sarayu assentiu.	'si~, sa.ra'ju a.se~'Tiw
Cada relacionamento entre duas pessoas é absolutamente único.	'ka.da Re.la.si.o~.na~'me~.tu 'e~.tri 'du.as pe'so.az E ab.so.lu.ta~'me~.Ti 'u~.ni.ku
Por isso você não pode amar duas pessoas da mesma maneira.	pur 'i.su vo'se 'na~w~ 'pO.Di a~'maR 'du.as pe'so.as da 'mez.ma ma~'nej.ra
Simplesmente não é possível.	si~.pliz'me~.Ti 'na~w~ E po'si.vew
Você ama cada pessoa de modo diferente por ela ser quem ela é e pela especificidade do que ela recebe de você.	vo'se 'a~.ma 'ka.da pe'so.a Di 'mO.du Di.fe're~.Ti pur 'E.la 'seX 'ke~j~ 'E.la E i 'pe.la es.pe.si.fi.si'da.Di du ki 'E.la Re'sE.bi Di vo'se
E quanto mais vocês se conhecem, mais ricas são as cores desse relacionamento.	i 'kwa~.tu 'majs vo'sejs si ko~'JE.se~j~, 'majs 'Ri.kas 'sa~w~ as 'ko.ris 'de.si Re.la.si.o~.na~'me~.tu
Mack escutava ao mesmo tempo que olhava o que acontecia a volta.	'mE.ki es.ku'ta.va aw 'mez.mu 'te~.pu ki o'La.va u ki a.ko~.te'si.a a 'vOw.ta
Sarayu continuou:	sa.ra'ju ko~.Ti~.nu'ow
Vou dar um exemplo para você entender melhor.	'vow 'dar u~ e'ze~.plu 'pa.ra vo'se e~.te~'deR me'LOX
Suponha, Mack, que você está com um amigo numa lanchonete.	su'po~.Ja, 'mE.ki, ki vo'se es'ta ko~ u~ a~'mi.gu 'nu~.ma la~.So~'nE.Ti
Você está concentrado no companheiro e, se tiver olhos para ver, perceberá que os dois estão envolvidos numa variedade de cores e luzes que marcam não apenas o que cada um é especificamente, mas também a especificidade do relacionamento entre vocês e das emoções que estão experimentando.	vo'se es'ta ko~.se~'tra.du nu ko~.pa~'Jej.ru i, si Ti'vEr 'O.Lus 'pa.ra 'veX, peX.se.be'ra ki us 'dojz es'ta~w~ e~.vow'vi.dus 'nu~.ma va.ri.e'da.Di Di 'ko.riz i 'lu.zis ki 'maX.ka~w~ 'na~w~ a'pe~.naz u ki 'ka.da 'u~ E es.pe.si.fi.ka~'me~.Ti, majs ta~'be~j~ a es.pe.si.fi.si'da.Di du Re.la.si.o~.na~'me~.tu 'e~.tri vo'sejz i daz e~.mo'so~j~s ki es'ta~w~ es.pe.ri~.me~'ta~.du
Mas. Mack começou a perguntar e foi interrompido.	majs, 'mE.ki ko~.me'sow a peR.gu~'tar i foj i~.te.Ro~'pi.du
Mas suponha, continuou Sarayu, que outra pessoa que você ama entre na lanchonete e, embora esteja envolvido pela conversa com o primeiro amigo, você nota a entrada do outro.	majs su'po~.Ja, ko~.Ti~.nu'ow sa.ra'ju, ki 'ow.tra pe'so.a ki vo'se 'a~.ma 'e~.tri na la~.So~'nE.Ti i, e~'bO.ra es'te.Za e~.vow'vi.du 'pe.la ko~'vEX.sa ko~ u pri~'mej.ru a~'mi.gu, vo'se 'nO.ta a e~'tra.da du 'ow.tru
De novo, se você tivesse olhos para ver a realidade mais ampla, testemunharia que uma combinação única de cor e luz saltaria de você e se enrolaria no que acabou de chegar, representando você em outra forma de amá-lo e recebê-lo.	Di 'no.vu, si vo'se Ti'vE.si 'O.Lus 'pa.ra 'ver a Re.a.li'da.Di 'majz 'a~.pla, tes.te~.mu~.Ja'ri.a ki u~.ma ko~.bi~.na'sa~w~ 'u~.ni.ka Di 'kor i 'lujs saw.ta'ri.a Di vo'se i si e~.Ro.la'ri.a nu ki a.ka'bow Di Se'gaX, Re.pre.ze~'ta~.du vo'se e~j~ 'ow.tra 'fOR.ma Di a~'ma lu i Re.se'be lu
Mais uma coisa, Mackenzie:	'majz u~.ma 'koj.za, ma'ke~.zi
A especificidade não é somente visual, mas também sensorial.	a es.pe.si.fi.si'da.Di 'na~w~ E sO~'me~.Ti vi.zu'aw, majs ta~'be~j~ se~.so.ri'aw
Você pode sentir, cheirar e até mesmo sentir o gosto dela.	vo'se 'pO.Di se~'TiX, Sej'rar i a'tE 'mez.mu se~'Tir u 'gos.tu 'dE.la
Adoro isso! exclamou Mack.	a'dO.ru 'i.su, es.kla~'mow 'mE.ki
Mas, a não ser por aquele lá, apontou na direção das luzes agitadas ao redor do adulto, por quê todos estao calmos?	majs, a 'na~w~ 'seX pur a'ke.li 'la, a.po~'tow na Di.re'sa~w~ das 'lu.ziz a.Zi'ta.daz aw Re'dOR du a'duw.tu, puX 'ke 'to.duz es'taw 'kaw.mus
Eu imaginaria que houvesse cor por todo lado.	ew i~.ma.Zi~.na'ri.a ki ow'vE.si 'koX puX 'to.du 'la.du
Eles não se conhecem?	'e.lis 'na~w~ si ko~'JE.se~j~
A maioria se conhece muito bem, mas estão aqui para uma comemoração que não tem nada a ver com eles nem com os relacionamentos de uns com os outros, pelo menos não diretamente, explicou Sarayu.	a maj.o'ri.a si ko~'JE.si 'mu~j~.tu 'be~j~, majz es'ta~w~ a'ki 'pa.ra u~.ma ko~.me~.mo.ra'sa~w~ ki 'na~w~ te~j~ 'na.da a 'veX ko~ 'e.lis ne~j~ ko~ us Re.la.si.o~.na~'me~.tus Di u~s ko~ uz 'ow.trus, 'pe.lu 'me~.nus 'na~w~ Di.rE.ta~'me~.Ti, es.pli'kow sa.ra'ju
Eles estão esperando.	'e.liz es'ta~w~ es.pe'ra~.du
Você verá logo, respondeu Sarayu e era óbvio que ela não diria mais nada sobre o assunto.	vo'se ve'ra 'lO.gu, Res.po~'dew sa.ra'ju i 'E.ra 'Ob.vju ki 'E.la 'na~w~ Di'ri.a 'majs 'na.da 'so.bri u a'su~.tu
Então por que aquele está tendo tanta dificuldade e por que ele parece concentrado em nós?	e~'ta~w~ puX 'ke a'ke.li es'ta 'te~.du 'ta~.ta Di.fi.kuw'da.Di i puX 'ke 'e.li pa'rE.si ko~.se~'tra.du e~j~ 'nOjs
Mackenzie, disse Sarayu com gentileza, ele não está concentrado em nós, está concentrado em você.	ma'ke~.zi, 'Di.si sa.ra'ju ko~ Ze~.Ti'le.za, 'e.li 'na~w~ es'ta ko~.se~'tra.du e~j~ 'nOjs, es'ta ko~.se~'tra.du e~j~ vo'se
O quê? Mack ficou pasmo.	u 'ke, 'mE.ki fi'kow 'paz.mu
Aquele que tem tanta dificuldade para se conter é o seu pai.	a'ke.li ki 'te~j~ 'ta~.ta Di.fi.kuw'da.Di 'pa.ra si ko~'ter E u 'sew 'paj
Uma onda de emoções, uma mistura de raiva e anseio, varreu Mack.	u~.ma 'o~.da Di e~.mo'so~j~s, u~.ma mis'tu.ra Di 'Raj.va i a~'sej.u, va'Rew 'mE.ki
Nesse momento as cores de seu pai explodiram da campina e o envolveram.	'ne.si mo~'me~.tu as 'ko.ris Di 'sew 'paj es.plo'Di.ra~w~ da ka~'pi~.na i u e~.vow've.ra~w~
Ele ficou perdido num jorro de rubi e vermelhão, magenta e violeta, à medida que a luz e a dor faziam um redemoinho ao seu redor e o cobriam.	'e.li fi'kow peR'Di.du nu~ 'Zo.Ru Di Ru'bi i veR.me'La~w~, ma'Ze~.ta i vi.o'le.ta, a me'Di.da ki a 'lujz i a 'doX fa'zi.a~w~ u~ Re.de~.mo'i~.Ju aw 'sew Re'dOr i u ko'bri.a~w~
E de algum modo, no meio da tempestade que explodia, ele se viu correndo pela campina para encontrar o pai, correndo para a fonte de cores e emoções.	i Di aw'gu~ 'mO.du, nu 'mej.u da te~.pes'ta.Di ki es.plo'Di.a, 'e.li si 'viw ko'Re~.du 'pe.la ka~'pi~.na 'pa.ra e~.ko~'trar u 'paj, ko'Re~.du 'pa.ra a 'fo~.Ti Di 'ko.riz i e~.mo'so~j~s
Era um menininho querendo o pai, e pela primeira vez não teve medo.	'E.ra u~ me~.ni~'ni~.Ju ke're~.du u 'paj, i 'pe.la pri~'mej.ra 'vejz 'na~w~ 'te.vi 'me.du
Estava correndo, sem se importar com coisa alguma além do objeto do desejo de seu coração, e o encontrou.	es'ta.va ko'Re~.du, se~j~ si i~.poX'taX ko~ 'koj.za aw'gu~.ma a'le~j~ du ob'ZE.tu du de'ze.Zu Di 'sew ko.ra'sa~w~, i u e~.ko~'trow
Seu pai estava de joelhos, coberto de luz, lágrimas brilhando como uma cachoeira de diamantes e jóias nas mãos que cobriam o rosto.	'sew 'paj es'ta.va Di Zu'e.Lus, ko'bEX.tu Di 'lujs, 'la.gri~.mas bri'La~.du 'ko~.mu u~.ma ka.So'ej.ra Di Di.a~'ma~.Tiz i 'ZOj.as nas 'ma~w~s ki ko'bri.a~w~ u 'Ros.tu
Papai! gritou Mack e jogou-se para o homem que nem podiar olhar o filho.	pa'paj, gri'tow 'mE.ki i Zo'gow si 'pa.ra u 'o~.me~j~ ki ne~j~ po.Di'ar o'Lar u 'fi.Lu
No uivo de vento e chamas, Mack segurou o rosto do pai com as duas mãos, forçando-o a olhá-lo para que pudesse gaguejar as palavras que sempre quisera dizer:	nu 'uj.vu Di 've~.tu i 'Sa~.mas, 'mE.ki se.gu'row u 'Ros.tu du 'paj ko~ as 'du.as 'ma~w~s, foX'sa~.du u a o'La lu 'pa.ra ki pu'dE.si ga.ge'Zar as pa'la.vras ki 'se~.pri ki'zE.ra Di'zeX
Papai, desculpe! Papai, eu amo você!	pa'paj, des'kuw.pi, pa'paj, ew 'a~.mu vo'se
A luz de suas palavras pareceu explodir, afastando a escuridão das cores do pai, transformando-as em vermelho sangue.	a 'lujz Di 'su.as pa'la.vras pa.re'sew es.plo'DiX, a.fas'ta~.du a es.ku.ri'da~w~ das 'ko.ris du 'paj, tra~s.foR'ma~.du az e~j~ veR'me.Lu 'sa~.gi
Os dois trocaram palavras soluçantes de confissão e perdão.	us 'dojs tro'ka.ra~w~ pa'la.vras so.lu'sa~.Tis Di ko~.fi'sa~w~ i peR'da~w~
E um amor maior do que qualquer um dos dois os curou.	i u~ a~'moR maj'OR du ki kwaw'kEr 'u~ dus 'dojz us ku'row
Finalmente se levantaram juntos, o pai abraçando o filho como nunca pudera fazer antes.	fi~.naw'me~.Ti si le.va~'ta.ra~w~ 'Zu~.tus, u 'paj a.bra'sa~.du u 'fi.Lu 'ko~.mu 'nu~.ka pu'dE.ra fa'zer 'a~.Tis
Foi então que Mack notou a onda de uma canção passando sobre os dois, como se penetrasse no lugar sagrado onde ele estava com o pai.	'foj e~'ta~w~ ki 'mE.ki no'tow a 'o~.da Di u~.ma ka~'sa~w~ pa'sa~.du 'so.bri us 'dojs, 'ko~.mu si pe~.ne'tra.si nu lu'gaX sa'gra.du 'o~.Di 'e.li es'ta.va ko~ u 'paj
Abraçados, incapazes de falar em meio as lágrimas, eles ouviram a canção de reconciliação que iluminava o céu noturno.	a.bra'sa.dus, i~.ka'pa.zis Di fa'lar e~j~ 'mej.u as 'la.gri~.mas, 'e.liz ow'vi.ra~w~ a ka~'sa~w~ Di Re.ko~.si.li.a'sa~w~ ki i.lu~.mi~'na.va u 'sEw no'tuR.nu
Uma fonte de cor brilhante começou a jorrar em arco entre as crianças, sobretudo entre as que haviam sofrido mais, e ondulou ao passar de cada uma para a próxima, levada pelo vento, até que todo o campo estivesse inundado de luz e música.	u~.ma 'fo~.Ti Di 'koR bri'La~.Ti ko~.me'sow a Zo'Rar e~j~ 'aX.ku 'e~.tri as kri'a~.sas, so.bre'tu.du 'e~.tri as ki a'vi.a~w~ so'fri.du 'majs, i o~.du'low aw pa'saR Di 'ka.da u~.ma 'pa.ra a 'prO.si~.ma, le'va.da 'pe.lu 've~.tu, a'tE ki 'to.du u 'ka~.pu es.Ti'vE.si i~.nu~'da.du Di 'lujz i 'mu.zi.ka
De algum modo Mack soube que não era um momento para conversar e que seu tempo com o pai estava passando rapidamente.	Di aw'gu~ 'mO.du 'mE.ki 'sow.bi ki 'na~w~ 'E.ra u~ mo~'me~.tu 'pa.ra ko~.veX'sar i ki 'sew 'te~.pu ko~ u 'paj es'ta.va pa'sa~.du Ra.pi.da~'me~.Ti
Para ele, a nova leveza que sentia era eufórica.	'pa.ra 'e.li, a 'nO.va le've.za ki se~'Ti.a 'E.ra ew'fO.ri.ka
Beijando o pai nos lábios, virou-se e voltou para a pequena colina onde Sarayu o esperava.	bej'Za~.du u 'paj nus 'la.bjus, vi'row si i vow'tow 'pa.ra a pe'ke~.na ko'li~.na 'o~.Di sa.ra'ju u es.pe'ra.va
Enquanto passava pelas fileiras de crianças, pode sentir o toque e as cores delas envolvendo-o rapidamente e ficando para trás.	e~'kwa~.tu pa'sa.va 'pe.las fi'lej.ras Di kri'a~.sas, 'pO.Di se~'Tir u 'tO.ki i as 'ko.ris 'dE.laz e~.vow've~.du u Ra.pi.da~'me~.Ti i fi'ka~.du 'pa.ra 'trajs
De algum modo ele já era conhecido e amado ali.	Di aw'gu~ 'mO.du 'e.li 'Za 'E.ra ko~.Je'si.du i a~'ma.du a'li
Quando chegou a Sarayu, ela o abraçou também e ele deixou que ela o segurasse enquanto continuava a chorar.	'kwa~.du Se'gow a sa.ra'ju, 'E.la u a.bra'sow ta~'be~j~ i 'e.li dej'Sow ki 'E.la u se.gu'ra.si e~'kwa~.tu ko~.Ti~.nu'a.va a So'raX
Quando recuperou uma leve tranquilidade, virou-se para olhar de novo a campina, o lago e o céu noturno.	'kwa~.du Re.ku.pe'row u~.ma 'lE.vi tra~.kwi.li'da.Di, vi'row si 'pa.ra o'LaR Di 'no.vu a ka~'pi~.na, u 'la.gu i u 'sEw no'tuR.nu
Um silêncio baixou.	u~ si'le~.sju baj'Sow
A antecipação era palpável.	a a~.te.si.pa'sa~w~ 'E.ra paw'pa.vew
De repente, à direita, saindo da escuridão, surgiu Jesus e o pandemônio irrompeu.	Di Re'pe~.Ti, a Di'rej.ta, sa'i~.du da es.ku.ri'da~w~, suR'Ziw Ze'zujz i u pa~.de~'mo~.nju i.Ro~'pew
Ele vestia uma roupa branca e usava na cabeça uma coroa simples de ouro, mas era, em cada centímetro do seu ser, o rei do Universo.	'e.li ves'Ti.a u~.ma 'Row.pa 'bra~.ka i u'za.va na ka'be.sa u~.ma ko'ro.a 'si~.plis Di 'ow.ru, majz 'E.ra, e~j~ 'ka.da se~'Ti~.me.tru du 'sew 'seX, u 'Rej du u~.ni'vEX.su
Luz e cor dançavam e teciam uma tapeçaria de amor para ele pisar.	'lujz i 'koR da~'sa.va~w~ i te'si.a~w~ u~.ma ta.pe.sa'ri.a Di a~'moX 'pa.ra 'e.li pi'zaX
Alguns choravam, dizendo palavras de amor, enquanto outros simplesmente permaneciam de mãos levantadas.	aw'gu~.So'ra.va~w~, Di'ze~.du pa'la.vras Di a~'moX, e~'kwa~.tu 'ow.trus si~.pliz'me~.Ti peR.ma~.ne'si.a~w~ Di 'ma~w~s le.va~'ta.das
Muitos daqueles cujas cores eram as mais ricas e profundas estavam deitados com o rosto no chão.	'mu~j~.tus da'ke.lis 'ku.Zas 'ko.riz 'E.ra~w~ as 'majs 'Ri.kaz i pro'fu~.daz es'ta.va~w~ dej'ta.dus ko~ u 'Ros.tu nu 'Sa~w~
Tudo o que respirava cantava uma canção de amor e agradecimento sem fim.	'tu.du u ki Res.pi'ra.va ka~'ta.va u~.ma ka~'sa~w~ Di a~'mor i a.gra.de.si~'me~.tu se~j~ 'fi~
Nessa noite o Universo era como devia ser.	'nE.sa 'noj.Ti u u~.ni'vEX.su 'E.ra 'ko~.mu de'vi.a 'seX
Quando chegou ao centro, Jesus parou para olhar em volta.	'kwa~.du Se'gow aw 'se~.tru, Ze'zujs pa'row 'pa.ra o'Lar e~j~ 'vOw.ta
Seus olhos pousaram em Mack, que parado na pequena colina, ouviu Jesus sussurrar em seu ouvido:	'sewz 'O.Lus pow.za'ra~w~ e~j~ 'mE.ki, ki pa'ra.du na pe'ke~.na ko'li~.na, ow'viw Ze'zujs su.su'Rar e~j~ 'sew ow'vi.du
Mack, eu gosto especialmente de você.	'mE.ki, ew 'gOs.tu es.pe.si.aw'me~.Ti Di vo'se
Foi tudo o que Mack conseguiu suportar enquanto caía no chao dissolvendo-se numa onda de lágrimas jubilosas.	'foj 'tu.du u ki 'mE.ki ko~.se'giw su.poX'tar e~'kwa~.tu ka'i.a nu 'Saw Di.sow've~.du si 'nu~.ma 'o~.da Di 'la.gri~.ma.Zu.bi'lO.zas
Não podia se mexer, preso no abraço de Jesus, feito de amor e ternura.	'na~w~ po'Di.a si me'SeX, 'pre.zu nu a'bra.su Di Ze'zujs, 'fej.tu Di a~'mor i teR'nu.ra
Então ouviu Jesus dizer alto e claro, mas de modo muito gentil e convidativo:	e~'ta~w~ ow'viw Ze'zujs Di'zer 'aw.tu i 'kla.ru, majs Di 'mO.du 'mu~j~.tu Ze~'Tiw i ko~.vi.da'Ti.vu
E eles foram, as crianças primeiro, depois os adultos, cada um por sua vez, rindo, falando, abraçando-se e cantando com seu Jesus.	i 'e.lis 'fo.ra~w~, as kri'a~.sas pri~'mej.ru, de'pojz uz a'duw.tus, 'ka.da 'u~ puX 'su.a 'vejs, 'Ri~.du, fa'la~.du, a.bra'sa~.du si i ka~'ta~.du ko~ 'sew Ze'zujs
O tempo pareceu parar enquanto a dança celestial prosseguia.	u 'te~.pu pa.re'sew pa'rar e~'kwa~.tu a 'da~.sa se.les.Ti'aw pro.se'gi.a
E então cada um foi saindo até não restar ninguém, a não ser as ardentes sentinelas azuis e os animais.	i e~'ta~w~ 'ka.da 'u~ 'foj sa'i~.du a'tE 'na~w~ Res'taR ni~'ge~j~, a 'na~w~ 'ser az aR'de~.Tis se~.Ti~'nE.laz a'zujz i uz a~.ni~'majs
Jesus caminhou entre eles, chamando cada um pelo nome, e então os animais e seus filhotes voltaram para as tocas, os ninhos e os leitos nas pastagens.	Ze'zujs ka~.mi~'Jow 'e~.tri 'e.lis, Sa~'ma~.du 'ka.da 'u~ 'pe.lu 'no~.mi, i e~'ta~w~ uz a~.ni~'majz i 'sews fi'LO.Tis vow'ta.ra~w~ 'pa.ra as 'tO.kas, us 'ni~.Juz i us 'lej.tus nas pas'ta.Ze~s
Por fim estavam novamente sozinhos.	puX 'fi~ es'ta.va~w~ nO.va~'me~.Ti sO'zi~.Jus
O grito selvagem e assombroso de um mergulhão ecoando sobre o lago pareceu sinalizar o fim da celebração, e as sentinelas desapareceram ao mesmo tempo.	u 'gri.tu sew'va.Ze~j~ i a.so~'bro.zu Di u~ meR.gu'La~w~ e.ko'a~.du 'so.bri u 'la.gu pa.re'sew si~.na.li'zar u 'fi~ da se.le.bra'sa~w~, i as se~.Ti~'nE.las de.za.pa.re'se.ra~w~ aw 'mez.mu 'te~.pu
Os únicos sons que restavam eram os do coro de grilos e sapos retomando suas canções de culto na margem da água e nas campinas ao redor.	uz 'u~.ni.kus 'so~s ki Res'ta.va~w~ 'E.ra~w~ us du 'ko.ru Di 'gri.luz i 'sa.pus Re.to~'ma~.du 'su.as ka~'so~j~s Di 'kuw.tu na 'maR.Ze~j~ da 'a.gwa i nas ka~'pi~.naz aw Re'dOX
Sem uma palavra, os três se viraram e retornaram para a cabana, que de novo se tornara visível para Mack.	se~j~ u~.ma pa'la.vra, us 'trejs si vi'ra.ra~w~ i Re.toR'na.ra~w~ 'pa.ra a ka'ba~.na, ki Di 'no.vu si toR'na.ra vi'zi.vew 'pa.ra 'mE.ki
Como uma cortina sendo puxada sobre seus olhos, de repente a visão voltou ao normal.	'ko~.mu u~.ma koX'Ti~.na 'se~.du pu'Sa.da 'so.bri 'sewz 'O.Lus, Di Re'pe~.Ti a vi'za~w~ vow'tow aw noR'maw
Ele teve uma sensação de perda e de ansiedade e chegou a ficar um pouco triste, até que Jesus se aproximou, pegou sua mão e apertou-a para assegurar que tudo era como deveria ser.	'e.li 'te.vi u~.ma se~.sa'sa~w~ Di 'peR.da i Di a~.si.e'da.Di i Se'gow a fi'kar u~ 'pow.ku 'tris.Ti, a'tE ki Ze'zujs si a.pro.si~'mow, pe'gow 'su.a 'ma~w~ i a.peX'tow a 'pa.ra a.se.gu'raX ki 'tu.du 'E.ra 'ko~.mu de.ve'ri.a 'seX
Um Deus infinito pode se dar inteiro a cada um de seus filhos.	u~ 'dewz i~.fi~'ni.tu 'pO.Di si 'dar i~'tej.ru a 'ka.da 'u~ Di 'sews 'fi.Lus
Ele não se distribui de modo que cada um tenha uma parte, mas a cada um ele se dá inteiro, tão integralmente como se não houvesse outros.	'e.li 'na~w~ si Dis.tri'buj Di 'mO.du ki 'ka.da 'u~ 'te~.Ja u~.ma 'paX.Ti, majz a 'ka.da 'u~ 'e.li si 'da i~'tej.ru, 'ta~w~ i~.te.graw'me~.Ti 'ko~.mu si 'na~w~ ow'vE.si 'ow.trus
Mack teve a sensação de que acabara de entrar num sono profundo, sem sonhos, quando sentiu uma mão sacudindo-o para acordar.	'mE.ki 'te.vi a se~.sa'sa~w~ Di ki a.ka'ba.ra Di e~'traR nu~ 'so~.nu pro'fu~.du, se~j~ 'so~.Jus, 'kwa~.du se~'Tiw u~.ma 'ma~w~ sa.ku'Di~.du u 'pa.ra a.koR'daX
Mack, acorde.	'mE.ki, a'kOR.Di
É hora de irmos.	E 'O.ra Di 'iR.mus
A voz era familiar, mas profunda, como de alguém que também tivesse acabado de acordar.	a 'vOjz 'E.ra fa~.mi.li'aX, majs pro'fu~.da, 'ko~.mu Di aw'ge~j~ ki ta~'be~j~ Ti'vE.si a.ka'ba.du Di a.koR'daX
Hein? gemeu ele.	e~j~, Ze~'mew 'e.li
Que horas são? murmurou enquanto tentava descobrir onde estava e o que estava fazendo.	ki 'O.ras 'sa~w~, muR.mu'row e~'kwa~.tu te~'ta.va des.ko'brir 'o~.Di es'ta.va i u ki es'ta.va fa'ze~.du
É hora de ir, repetiu o sussurro.	E 'O.ra Di 'iX, Re.pe'Tiw u su'su.Ru
Mack saiu da cama resmungando e procurou até encontrar o interruptor de luz.	'mE.ki sa'iw da 'ka~.ma Rez.mu~'ga~.du i pro.ku'row a'tE e~.ko~'trar u i~.te.Rup'toR Di 'lujs
Depois da escuridão de breu, a claridade foi ofuscante e ele demorou até conseguir abrir os olhos e se esforçar para ver o visitante.	de'pojs da es.ku.ri'da~w~ Di 'brew, a kla.ri'da.Di 'foj o.fus'ka~.Ti i 'e.li de~.mo'row a'tE ko~.se'gir a'brir uz 'O.Luz i si es.foX'saX 'pa.ra 'ver u vi.zi'ta~.Ti
O homem parado junto dele se parecia um pouco com Papai: digno, mais velho, magro e mais alto do que Mack.	u 'o~.me~j~ pa'ra.du 'Zu~.tu 'de.li si pa.re'si.a u~ 'pow.ku ko~ pa'paj, 'Di.gi~.nu, 'majs 'vE.Lu, 'ma.gru i 'majz 'aw.tu du ki 'mE.ki
O cabelo muito branco estava preso num rabo de cavalo, e o bigode e o cavanhaque eram grisalhos.	u ka'be.lu 'mu~j~.tu 'bra~.ku es'ta.va 'pre.zu nu~ 'Ra.bu Di ka'va.lu, i u bi'gO.Di i u ka.va~'Ja.ki 'E.ra~w~ gri'za.Lus
Camisa xadrez com mangas enroladas, jeans e botas de caminhada completavam a vestimenta de alguém pronto para pôr o pé na trilha.	ka~'mi.za Sa'drejs ko~ 'ma~.gaz e~.Ro'la.das, 'Di~z i 'bO.tas Di ka~.mi~'Ja.da ko~.ple'ta.va~w~ a ves.Ti~'me~.ta Di aw'ge~j~ 'pro~.tu 'pa.ra 'por u 'pE na 'tri.La
Papai? perguntou Mack.	pa'paj, peR.gu~'tow 'mE.ki
Sim, filho.	'si~, 'fi.Lu
Mack balançou a cabeça.	'mE.ki ba.la~'sow a ka'be.sa
Ainda está brincando comigo, nao é?	a'i~.da es'ta bri~'ka~.du ko~'mi.gu, 'naw E
Sempre, disse ele com um sorriso.	'se~.pri, 'Di.si 'e.li ko~ u~ so'Ri.zu
E, respondendo a pergunta seguinte de Mack antes que ela fosse feita:	i, Res.po~'de~.du a peR'gu~.ta se'gi~.Ti Di 'mE.ki 'a~.Tis ki 'E.la 'fo.si 'fej.ta
Nesta manhã você vai precisar de um pai.	'nEs.ta ma~'Ja~ vo'se 'vaj pre.si'zaR Di u~ 'paj
Vamos indo.	'va~.muz 'i~.du
Tem tudo de que você precisa na cadeira e na mesa ao pé da sua cama.	te~j~ 'tu.du Di ki vo'se pre'si.za na ka'dej.ra i na 'me.za aw 'pE da 'su.a 'ka~.ma
Encontro-o na cozinha, onde você pode comer alguma coisa antes de sairmos.	e~'ko~.tru u na ko'zi~.Ja, 'o~.Di vo'se 'pO.Di ko~'mer aw'gu~.ma 'koj.za 'a~.Tis Di sa'iR.mus
Não se incomodou em perguntar aonde iria.	'na~w~ si i~.ko~.mo'dow e~j~ peR.gu~'tar a'o~.Di i'ri.a
Se Papai desejasse que ele soubesse, teria dito.	si pa'paj de.ze'Za.si ki 'e.li sow'bE.si, te'ri.a 'Di.tu
Vestiu rapidamente as roupas do tamanho exato, semelhantes as de Papai, e calçou um par de botas de caminhada.	ves'Tiw Ra.pi.da~'me~.Ti as 'Row.pas du ta~'ma~.Ju e'za.tu, se~.me'La~.Tiz as Di pa'paj, i kaw'sow u~ 'paR Di 'bO.tas Di ka~.mi~'Ja.da
Parou rapidamente no banheiro para se lavar e entrou na cozinha.	pa'row Ra.pi.da~'me~.Ti nu ba~'Jej.ru 'pa.ra si la'var i e~'trow na ko'zi~.Ja
Jesus e Papai estava perto da bancada, parecendo muito mais descansados do que Mack.	Ze'zujz i pa'paj es'ta.va 'pEX.tu da ba~'ka.da, pa.re'se~.du 'mu~j~.tu 'majs des.ka~'sa.dus du ki 'mE.ki
Ele já ia falar quando Sarayu entrou pela porta dos fundos com um grande embrulho.	'e.li 'Za 'i.a fa'laX 'kwa~.du sa.ra'ju e~'trow 'pe.la 'pOX.ta dus 'fu~.dus ko~ u~ 'gra~.Di e~'bru.Lu
