Tão todo nele me perco que de mim se arrebentam as raízes do mundo;	'ta~w~ 'to.du 'ne.li mi 'peX.ku ki Di 'mi~ si a.Re'be~.ta~w~ as Ra'i.zis du 'mu~.du
tamanha a violência de seu corpo contra o meu, que a sua neutra existência se quebra:	ta~'ma~.Ja a vi.o'le~.sja Di 'sew 'koX.pu 'ko~.tra u 'mew, ki a 'su.a 'new.tra e.zis'te~.sja si 'kE.bra
a leve brisa faz mover a sua túnica de pedra.	a 'lE.vi 'bri.za 'fajz mo'ver a 'su.a 'tu~.ni.ka Di 'pE.dra
O anjo é grave agora.	u 'a~.Zu E 'gra.vi a'gO.ra
Começo a esperar a morte.	ko~'mE.su a es.pe'rar a 'mOX.Ti
Sim, minha força está na solidão. Não tenho medo nem de chuvas tempestivas nem das grandes ventanias soltas, pois eu também sou o escuro da noite.	'si~, 'mi~.Ja 'foX.sa es'ta na so.li'da~w~, 'na~w~ 'te~.Ju 'me.du ne~j~ Di 'Su.vas te~.pes'Ti.vas ne~j~ das 'gra~.Dis ve~.ta~'ni.as 'sow.tas, 'pojz ew ta~'be~j~ 'sow u es'ku.ru da 'noj.Ti
A força não provém da capacidade física. Provém de uma vontade indomável.	a 'foX.sa 'na~w~ pro've~j~ da ka.pa.si'da.Di 'fi.zi.ka, pro've~j~ Di u~.ma vo~'ta.Di i~.do~'ma.vew
Ser profundamente amado por alguém nos dá força; amar alguém profundamente nos dá coragem.	'seX pro.fu~.da~'me~.Ti a~'ma.du pur aw'ge~j~ nus 'da 'foX.sa, a~'mar aw'ge~j~ pro.fu~.da~'me~.Ti nus 'da ko'ra.Ze~j~
Quando uma criatura humana desperta para um grande sonho e sobre ele lança toda a força de sua alma, todo o universo conspira a seu favor.	'kwa~.du u~.ma kri.a'tu.ra u~'ma~.na des'pEX.ta 'pa.ra u~ 'gra~.Di 'so~.Ju i 'so.bri 'e.li 'la~.sa 'to.da a 'foX.sa Di 'su.a 'aw.ma, 'to.du u u~.ni'vEX.su ko~s'pi.ra a 'sew fa'voX
O amor é a força mais sutil do mundo.	u a~'mor E a 'foX.sa 'majs su'Tiw du 'mu~.du
O verdadeiro homem mede a sua força quando se defronta com o obstáculo.	u veR.da'dej.ru 'o~.me~j~ 'mE.Di a 'su.a 'foX.sa 'kwa~.du si de'fro~.ta ko~ u obs'ta.ku.lu
O entusiasmo é a maior força da alma. Conserva-o e nunca te faltará poder para conseguires o que desejas.	u e~.tu.zi'az.mu E a maj'OX 'foX.sa da 'aw.ma, ko~'sER.va u i 'nu~.ka Ti faw.ta'ra po'deX 'pa.ra ko~.se'gi.riz u ki de'ze.Zas
Quem quer vencer um obstáculo deve armar-se da força do leão e da prudência da serpente.	'ke~j~ 'kER ve~'ser u~ obs'ta.ku.lu 'dE.vi aR'maX si da 'foX.sa du le'a~w~ i da pru'de~.sja da seX'pe~.Ti
As palavras têm a leveza do vento e a força da tempestade.	as pa'la.vras 'te~j~ a le've.za du 've~.tu i a 'foX.sa da te~.pes'ta.Di
Não é a força mas a constância dos bons resultados que conduz os homens à felicidade.	'na~w~ E a 'foX.sa majz a ko~s'ta~.sja dus 'bo~s Re.zuw'ta.dus ki ko~'duz uz 'o~.me~z a fe.li.si'da.Di
Para fazer uma obra de arte não basta ter talento, não basta ter força, é preciso também viver um grande amor.	'pa.ra fa'zer u~.ma 'O.bra Di 'aX.Ti 'na~w~ 'bas.ta 'teX ta'le~.tu, 'na~w~ 'bas.ta 'teX 'foX.sa, E pre'si.zu ta~'be~j~ vi'ver u~ 'gra~.Di a~'moX
Não eduques as crianças nas várias disciplinas recorrendo à força, mas como se fosse um jogo, para que também possas observar melhor qual a disposição natural de cada um.	'na~w~ e'du.kiz as kri'a~.sas nas 'va.rjas Di.si'pli~.nas Re.ko'Re~.du a 'foX.sa, majs 'ko~.mu si 'fo.si u~ 'Zo.gu, 'pa.ra ki ta~'be~j~ 'pO.saz ob.seR'vaR me'LOX 'kwaw a Dis.po.zi'sa~w~ na.tu'raw Di 'ka.da 'u~
A força não vem de vencer. Suas lutas desenvolvem suas forças. Quando você atravessa dificuldades e decide não se render, isso é força.	a 'foX.sa 'na~w~ 've~j~ Di ve~'seX, 'su.as 'lu.tas de.ze~'vOw.ve~j~ 'su.as 'foX.sas, 'kwa~.du vo'se a.tra'vE.sa Di.fi.kuw'da.Diz i de'si.Di 'na~w~ si Re~'deX, 'i.su E 'foX.sa
O amor é a força mais abstrata, e também a mais potente que há no mundo.	u a~'mor E a 'foX.sa 'majz abs'tra.ta, i ta~'be~j~ a 'majs po'te~.Ti ki 'a nu 'mu~.du
Você ganha força, coragem e confiança através de cada experiência em que você realmente para e encara o medo de frente.	vo'se 'ga~.Ja 'foX.sa, ko'ra.Ze~j~ i ko~.fi'a~.sa a.tra'vEjs Di 'ka.da es.pe.ri'e~.sja e~j~ ki vo'se Re.aw'me~.Ti 'pa.ra i e~'ka.ra u 'me.du Di 'fre~.Ti
Você nunca sabe a força que tem. Até que a sua única alternativa é ser forte.	vo'se 'nu~.ka 'sa.bi a 'foX.sa ki te~j~, a'tE ki a 'su.a 'u~.ni.ka aw.teR.na'Ti.va E 'seX 'fOX.Ti
A força do direito deve superar o direito da força.	a 'foX.sa du Di'rej.tu 'dE.vi su.pe'rar u Di'rej.tu da 'foX.sa
Dificuldades e obstáculos são fontes valiosas de saúde e força para qualquer sociedade.	Di.fi.kuw'da.Diz i obs'ta.ku.lus 'sa~w~ 'fo~.Tis va.li'O.zas Di sa'u.Di i 'foX.sa 'pa.ra kwaw'kEX so.si.e'da.Di
A justiça sem a força é impotente, a força sem justiça é tirana.	a Zus'Ti.sa se~j~ a 'foX.sa E i~.po'te~.Ti, a 'foX.sa se~j~ Zus'Ti.sa E Ti'ra~.na
Os grandes feitos são conseguidos não pela força, mas pela perseverança.	us 'gra~.Dis 'fej.tus 'sa~w~ ko~.se'gi.dus 'na~w~ 'pe.la 'foX.sa, majs 'pe.la peX.se.ve'ra~.sa
O dinheiro é a coisa mais importante do mundo. Representa: saúde, força, honra, generosidade e beleza, do mesmo modo que a falta dele representa: doença, fraqueza, desgraça, maldade e fealdade.	u Di~'Jej.ru E a 'koj.za 'majz i~.poX'ta~.Ti du 'mu~.du, Re.pre'ze~.ta, sa'u.Di, 'foX.sa, 'o~.Ra, Ze~.ne.ro.zi'da.Di i be'le.za, du 'mez.mu 'mO.du ki a 'faw.ta 'de.li Re.pre'ze~.ta, do'e~.sa, fra'ke.za, dez'gra.sa, maw'da.Di i fe.aw'da.Di
A porta da felicidade abre só para o exterior; quem a força em sentido contrário acaba por fechá-la ainda mais.	a 'pOX.ta da fe.li.si'da.Di 'a.bri 'sO 'pa.ra u es.te.ri'oX, 'ke~j~ a 'fOX.sa e~j~ se~'Ti.du ko~'tra.rju a'ka.ba pur fe'Sa la a'i~.da 'majs
Não se pode manter a paz pela força, mas sim pela concórdia.	'na~w~ si 'pO.Di ma~'ter a 'pajs 'pe.la 'foX.sa, majs 'si~ 'pe.la ko~'kOR.Dja
As pessoas não carecem de força, carecem de determinação.	as pe'so.as 'na~w~ ka'rE.se~j~ Di 'foX.sa, ka'rE.se~j~ Di de.teR.mi~.na'sa~w~
A força do desejo da carne facilmente vence as barreiras morais do homem insatisfeito.	a 'foX.sa du de'ze.Zu da 'kaR.ni fa.siw'me~.Ti 've~.si as ba'Rej.ras mo'rajs du 'o~.me~j~ i~.sa.Tis'fej.tu
O ego é dotado de um poder, de uma força criativa, conquista tardia da humanidade, a que chamamos vontade.	u 'E.gu E do'ta.du Di u~ po'deX, Di u~.ma 'foX.sa kri.a'Ti.va, ko~'kis.ta taR'Di.a da u~.ma~.ni'da.Di, a ki Sa~'ma~.mus vo~'ta.Di
Posso perdoar a força bruta, mas a razão bruta é uma coisa irracional. É bater abaixo da linha do intelecto.	'pO.su peR.do'ar a 'foX.sa 'bru.ta, majz a Ra'za~w~ 'bru.ta E u~.ma 'koj.za i.Ra.si.o~'naw, E ba'ter a'baj.Su da 'li~.Ja du i~.te'lEk.tu
A violência não é força, mas fraqueza, nem nunca poderá ser criadora de coisa alguma, apenas destruidora.	a vi.o'le~.sja 'na~w~ E 'foX.sa, majs fra'ke.za, ne~j~ 'nu~.ka po.de'ra 'seX kri.a'do.ra Di 'koj.za aw'gu~.ma, a'pe~.nas des.truj'do.ra
As mais belas qualidades tornam-se inúteis, quando a força do caráter não as sustenta.	as 'majs 'bE.las kwa.li'da.Dis 'tOR.na~w~ si i~'nu.tejs, 'kwa~.du a 'foX.sa du ka'ra.teR 'na~w~ as sus'te~.ta
Não é um lábio ou um olho o que chamamos de beleza. Mas a força global e o resultado final de todas as partes.	'na~w~ E u~ 'la.bju ow u~ 'o.Lu u ki Sa~'ma~.mus Di be'le.za, majz a 'foX.sa glo'baw i u Re.zuw'ta.du fi~'naw Di 'to.daz as 'paX.Tis
Uma ideia torna-se uma força material quando ganha as massas organizadas.	u~.ma i'dEj.a 'tOR.na si u~.ma 'foX.sa ma.te.ri'aw 'kwa~.du 'ga~.Ja as 'ma.saz oR.ga~.ni'za.das
Seja fiel nas pequenas coisas porque é nelas que mora a sua força.	'se.Za fi'Ew nas pe'ke~.nas 'koj.zas puX'ke E 'nE.las ki 'mO.ra a 'su.a 'foX.sa
A ânsia de poder não é originada da força, mas da fraqueza.	a 'a~.sja Di po'deR 'na~w~ E o.ri.Zi~'na.da da 'foX.sa, majs da fra'ke.za
Um boletim de voto tem mais força que um tiro de espingarda.	u~ bo.le'Ti~ Di 'vO.tu te~j~ 'majs 'foX.sa ki u~ 'Ti.ru Di es.pi~'gaR.da
Dizem a verdade aqueles que afirmam que as más companhias conduzem os homens à forca.	'Di.ze~j~ a veR'da.Di a'ke.lis ki a'fiR.ma~w~ ki as 'majs ko~.pa~'Ji.as ko~'du.ze~j~ uz 'o~.me~z a 'foX.ka
A força de vontade deve ser mais forte do que a habilidade.	a 'foX.sa Di vo~'ta.Di 'dE.vi 'seR 'majs 'fOX.Ti du ki a a.bi.li'da.Di
Se eu pudesse, seria mais sensata; mas uma força nova, arrasta-me contra a minha vontade, e o desejo, atrai-me a uma direção, e a razão, a outra: vejo e aprovo o melhor, mas sigo o pior.	si ew pu'dE.si, se'ri.a 'majs se~'sa.ta, majz u~.ma 'foX.sa 'nO.va, a'Ras.ta mi 'ko~.tra a 'mi~.Ja vo~'ta.Di, i u de'ze.Zu, a'traj mi a u~.ma Di.re'sa~w~, i a Ra'za~w~, a 'ow.tra, 've.Zu i a'prO.vu u me'LOX, majs 'si.gu u pi'OX
O segredo da força está na vontade.	u se'gre.du da 'foX.sa es'ta na vo~'ta.Di
Não há nada que não se consiga com a força de vontade, a bondade e, principalmente, com o amor.	'na~w~ 'a 'na.da ki 'na~w~ si ko~'si.ga ko~ a 'foX.sa Di vo~'ta.Di, a bo~'da.Di i, pri~.si.paw'me~.Ti, ko~ u a~'moX
Quando um homem tem força de vontade, os deuses dão uma ajuda.	'kwa~.du u~ 'o~.me~j~ te~j~ 'foX.sa Di vo~'ta.Di, us 'dew.zis 'da~w~ u~.ma a'Zu.da
As lágrimas possuem uma força especial: derretem gelo e aquecem corações.	as 'la.gri~.mas po'su.e~j~ u~.ma 'foX.sa es.pe.si'aw, de'RE.te~j~ 'Ze.lu i a'kE.se~j~ ko.ra'so~j~s
Se resistimos às nossas paixões, é mais pela fraqueza delas que pela nossa força.	si Re.zis'Ti~.muz as 'nO.sas paj'So~j~s, E 'majs 'pe.la fra'ke.za 'dE.las ki 'pe.la 'nO.sa 'foX.sa
A força fez os primeiros escravos, a sua covardia perpetuou-os.	a 'foX.sa 'fejz us pri~'mej.ruz es'kra.vus, a 'su.a ko.vaR'Di.a peX.pe.tu'ow us
O que nos força a mentir é o sentimento da impossibilidade de os outros compreenderem inteiramente a nossa ação. Mesmo a mentira mais complicada é mais simples que a verdade.	u ki nus 'fOX.sa a me~'Tir E u se~.Ti~'me~.tu da i~.po.si.bi.li'da.Di Di uz 'ow.trus ko~.pre.e~'de.re~j~ i~.tej.ra~'me~.Ti a 'nO.sa a'sa~w~, 'mez.mu a me~'Ti.ra 'majs ko~.pli'ka.da E 'majs 'si~.plis ki a veR'da.Di
Meu Deus, se errarmos, faz-nos querer mudar; se tivermos razão, dá-nos força para vivermos com isso.	'mew 'dews, si e'RaR.mus, 'fajs nus ke'reR mu'daX, si Ti'vER.mus Ra'za~w~, 'da nus 'foX.sa 'pa.ra vi'vER.mus ko~ 'i.su
Aqui mora a fé, a sublime qualidade dos que jamais deixarão de acreditar na força superior do bem.	a'ki 'mO.ra a 'fE, a su'bli~.mi kwa.li'da.Di dus ki Za~'majs dej.Sa'ra~w~ Di a.kre.Di'taR na 'foX.sa su.pe.ri'oR du 'be~j~
A raiva te torna menor, enquanto o perdão te força a crescer além do que você era.	a 'Raj.va Ti 'tOR.na me~'nOX, e~'kwa~.tu u peR'da~w~ Ti 'fOX.sa a kre'ser a'le~j~ du ki vo'se 'E.ra
A celebridade é uma contradição. Parecendo que dá valor e força às criaturas, apenas as desvaloriza e enfraquece.	a se.le.bri'da.Di E u~.ma ko~.tra.Di'sa~w~, pa.re'se~.du ki 'da va'lor i 'foX.sa as kri.a'tu.ras, a'pe~.naz as dez.va.lo'ri.za i e~.fra'kE.si
Um homem não pode abandonar o direito de resistir àqueles que o atacam com força para lhe retirar a vida.	u~ 'o~.me~j~ 'na~w~ 'pO.Di a.ba~.do~'nar u Di'rej.tu Di Re.zis'Tir a'ke.lis ki u a'ta.ka~w~ ko~ 'foX.sa 'pa.ra Li Re.Ti'rar a 'vi.da
Que a força esteja com você.	ki a 'foX.sa es'te.Za ko~ vo'se
A força sem inteligência é como o movimento sem direção.	a 'foX.sa se~j~ i~.te.li'Ze~.sja E 'ko~.mu u mo.vi~'me~.tu se~j~ Di.re'sa~w~
A paixão torna-se uma força quando encontra saída no trabalho dos nossos braços, na perícia da nossa mão ou na atividade criadora do nosso espírito.	a paj'Sa~w~ 'tOR.na si u~.ma 'foX.sa 'kwa~.du e~'ko~.tra sa'i.da nu tra'ba.Lu dus 'nO.sus 'bra.sus, na pe'ri.sja da 'nO.sa 'ma~w~ ow na a.Ti.vi'da.Di kri.a'do.ra du 'nO.su es'pi.ri.tu
O que falta às pessoas não é força, e sim, vontade.	u ki 'faw.ta as pe'so.as 'na~w~ E 'foX.sa, i 'si~, vo~'ta.Di
Sou uma parte dessa força que embora deseje o mal, no entanto, origina o bem.	'sow u~.ma 'paX.Ti 'dE.sa 'foX.sa ki e~'bO.ra de'ze.Zi u 'maw, nu e~'ta~.tu, o.ri'Zi~.na u 'be~j~
As pessoas que possuem alguma força de caráter carregam consigo, como os planetas, a sua atmosfera nas suas órbitas.	as pe'so.as ki po'su.e~j~ aw'gu~.ma 'foX.sa Di ka'ra.teX ka'RE.ga~w~ ko~'si.gu, 'ko~.mu us pla~'ne.tas, a 'su.a a.Ti~.mos'fE.ra nas 'su.az 'OR.bi.tas
Nossa paciência alcançará mais que nossa força.	'nO.sa pa.si'e~.sja aw.ka~.sa'ra 'majs ki 'nO.sa 'foX.sa
São a força e a liberdade que fazem os homens virtuosos. A fraqueza e a escravidão nunca fizeram nada além de pessoas más.	'sa~w~ a 'foX.sa i a li.beR'da.Di ki 'fa.ze~j~ uz 'o~.me~s viX.tu'O.zus, a fra'ke.za i a es.kra.vi'da~w~ 'nu~.ka fi'zE.ra~w~ 'na.da a'le~j~ Di pe'so.as 'majs
Ninguém deve ser elogiado pela sua bondade quando não tem força para ser mau.	ni~'ge~j~ 'dE.vi 'ser e.lo.Zi'a.du 'pe.la 'su.a bo~'da.Di 'kwa~.du 'na~w~ te~j~ 'foX.sa 'pa.ra 'seR 'maw
A vontade, se não quer, não cede, é como a chama ardente, que se eleva com mais força quanto mais se tenta abafá-la.	a vo~'ta.Di, si 'na~w~ 'kEX, 'na~w~ 'sE.Di, E 'ko~.mu a 'Sa~.ma aR'de~.Ti, ki si e'lE.va ko~ 'majs 'foX.sa 'kwa~.tu 'majs si 'te~.ta a.ba'fa la
Ele tinha a força perante a qual os outros se dobravam: a calma.	'e.li 'Ti~.Ja a 'foX.sa pe'ra~.Ti a 'kwaw uz 'ow.trus si do'bra.va~w~, a 'kaw.ma
Convicção: Palavra que permite pôr, com a consciência tranquila, o tom da força ao serviço da incerteza.	ko~.vik'sa~w~, pa'la.vra ki peR'mi.Ti 'poX, ko~ a ko~.si'e~.sja tra~'kwi.la, u 'to~ da 'foX.sa aw seR'vi.su da i~.seX'te.za
As promessas, como as pessoas, perdem a força quando envelhecem.	as pro~'mE.sas, 'ko~.mu as pe'so.as, 'pER.de~j~ a 'foX.sa 'kwa~.du e~.ve'LE.se~j~
A força que tiramos do rancor e da irritação é apenas fraqueza.	a 'foX.sa ki Ti'ra~.mus du Ra~'kor i da i.Ri.ta'sa~w~ E a'pe~.nas fra'ke.za
Nada existe tão alto que o homem, com força de vontade, não possa apoiar a sua escada.	'na.da e'zis.Ti 'ta~w~ 'aw.tu ki u 'o~.me~j~, ko~ 'foX.sa Di vo~'ta.Di, 'na~w~ 'pO.sa a.poj'ar a 'su.a es'ka.da
Todos temos força suficiente para aguentar os infortúnios dos outros.	'to.dus 'te~.mus 'foX.sa su.fi.si'e~.Ti 'pa.ra a.gwe~'tar uz i~.foX'tu~.njus duz 'ow.trus
Serás amado apenas quando puderes mostrar a tua fraqueza, sem provocar nenhuma força.	se'rajz a~'ma.du a'pe~.nas 'kwa~.du pu'dE.ris mos'trar a 'tu.a fra'ke.za, se~j~ pro.vo'kaR ne~'Ju~.ma 'foX.sa
É preciso ter muita força para dizer moribundo o mesmo que se diria com saúde.	E pre'si.zu 'teR 'mu~j~.ta 'foX.sa 'pa.ra Di'zeR mo.ri'bu~.du u 'mez.mu ki si Di'ri.a ko~ sa'u.Di
Os leões têm uma grande força, mas esta ser-lhes-ia inútil se a natureza lhes não tivesse dado olhos.	us le'o~j~s 'te~j~ u~.ma 'gra~.Di 'foX.sa, majz 'Es.ta 'seX Liz 'i.a i~'nu.Tiw si a na.tu're.za Lis 'na~w~ Ti'vE.si 'da.du 'O.Lus
A força da maternidade é maior que as leis da natureza.	a 'foX.sa da ma.teR.ni'da.Di E maj'OX ki as 'lejs da na.tu're.za
Sem paixão, o homem é mera força e possibilidade latentes, como a rocha que espera o choque do ferro antes que ela possa mostrar sua faísca.	se~j~ paj'Sa~w~, u 'o~.me~j~ E 'mE.ra 'foX.sa i po.si.bi.li'da.Di la'te~.Tis, 'ko~.mu a 'RO.Sa ki es'pE.ra u 'SO.ki du 'fE.Ru 'a~.Tis ki 'E.la 'pO.sa mos'traX 'su.a fa'is.ka
Não há como a força do Estado para garantir a liberdade dos seus membros.	'na~w~ 'a 'ko~.mu a 'foX.sa du es'ta.du 'pa.ra ga.ra~'Tir a li.beR'da.Di dus 'sews 'me~.brus
Quando se defrontam dois exércitos de força equivalente, aquele que sofre por sustentar a guerra alcançará a vitória.	'kwa~.du si de'fro~.ta~w~ 'dojz e'zEX.si.tus Di 'foX.sa e.ki.va'le~.Ti, a'ke.li ki 'sO.fri puX sus.te~'tar a 'gE.Ra aw.ka~.sa'ra a vi'tO.rja
O homem que nada contra a correnteza sabe a força dela.	u 'o~.me~j~ ki 'na.da 'ko~.tra a ko.Re~'te.za 'sa.bi a 'foX.sa 'dE.la
Pode-se, à força de confiança, colocar alguém na impossibilidade de nos enganar.	'pO.Di si, a 'foX.sa Di ko~.fi'a~.sa, ko.lo'kar aw'ge~j~ na i~.po.si.bi.li'da.Di Di nuz e~.ga~'naX
Será um conforto pensar que a fraqueza pode ser uma força, como uma saúde delicada é uma defesa contra as doenças graves?	se'ra u~ ko~'foX.tu pe~'saX ki a fra'ke.za 'pO.Di 'ser u~.ma 'foX.sa, 'ko~.mu u~.ma sa'u.Di de.li'ka.da E u~.ma de'fe.za 'ko~.tra as do'e~.sas 'gra.vis
A força bruta, quando não é governada pela razão, desmorona sob o seu próprio peso.	a 'foX.sa 'bru.ta, 'kwa~.du 'na~w~ E go.veR'na.da 'pe.la Ra'za~w~, dez.mo'ro~.na sob u 'sew 'prO.prju 'pe.zu
Viver é como amar: todas as razões são contra, e a força de todos os instintos é a favor.	vi'ver E 'ko~.mu a~'maX, 'to.daz as Ra'zo~j~s 'sa~w~ 'ko~.tra, i a 'foX.sa Di 'to.duz uz i~s'Ti~.tuz E a fa'voX
A beleza dos jovens é a força e a dos velhos os cabelos brancos.	a be'le.za du'ZO.ve~z E a 'foX.sa i a dus 'vE.Luz us ka'be.lus 'bra~.kus
Paciência e nada de pressas fazem mais do que a força e a ira.	pa.si'e~.sja i 'na.da Di 'prE.sas 'fa.ze~j~ 'majs du ki a 'foX.sa i a 'i.ra
Onde é necessária a astúcia não há lugar para a força.	'o~.Di E ne.se'sa.rja a as'tu.sja 'na~w~ 'a lu'gaX 'pa.ra a 'foX.sa
À força de falarmos de amor, apaixonamo-nos.	a 'foX.sa Di fa'laR.mus Di a~'moX, a.paj.So~'na~.mu nus
Fica sabendo que és um deus, se é deus aquele que possui força, sentimento e memória que prevê e que domina, modera e faz mover este corpo ao qual está ligado.	'fi.ka sa'be~.du ki 'Ejz u~ 'dews, si E 'dewz a'ke.li ki po'suj 'foX.sa, se~.Ti~'me~.tu i me~'mO.rja ki pre've i ki do~'mi~.na, mo'dE.ra i 'fajz mo'ver 'es.Ti 'koX.pu aw 'kwaw es'ta li'ga.du
O espírito de propriedade duplica a força do homem.	u es'pi.ri.tu Di pro.pri.e'da.Di du'pli.ka a 'foX.sa du 'o~.me~j~
A mulher é astuta e mentirosa, por ser fraca e oprimida; e a astúcia é a força de quem não é forte.	a mu'LEr E as'tu.ta i me~.Ti'rO.za, puX 'seX 'fra.ka i o.pri~'mi.da, i a as'tu.sja E a 'foX.sa Di 'ke~j~ 'na~w~ E 'fOX.Ti
O que não provoca minha morte faz com que eu fique mais forte.	u ki 'na~w~ pro'vO.ka 'mi~.Ja 'mOX.Ti 'fajs ko~ ki ew 'fi.ki 'majs 'fOX.Ti
A minha vontade é forte, porém minha disposição de obedecer-lhe é fraca.	a 'mi~.Ja vo~'ta.Di E 'fOX.Ti, po're~j~ 'mi~.Ja Dis.po.zi'sa~w~ Di o.be.de'seX Li E 'fra.ka
Somos feitos de carne, mas temos de viver como se fôssemos de ferro.	'so~.mus 'fej.tus Di 'kaR.ni, majs 'te~.mus Di vi'veX 'ko~.mu si 'fo.se~.mus Di 'fE.Ru
Só é lutador quem sabe lutar consigo mesmo.	'sO E lu.ta'doX 'ke~j~ 'sa.bi lu'taX ko~'si.gu 'mez.mu
Como fica forte uma pessoa quando está segura de ser amada!	'ko~.mu 'fi.ka 'fOX.Ti u~.ma pe'so.a 'kwa~.du es'ta se'gu.ra Di 'ser a~'ma.da
O fraco jamais perdoa: o perdão é uma das características do forte.	u 'fra.ku Za~'majs peR'do.a, u peR'da~w~ E u~.ma das ka.rak.te'ris.Ti.kas du 'fOX.Ti
Por vezes sentimos que aquilo que fazemos não é senão uma gota de água no mar. Mas o mar seria menor se lhe faltasse uma gota.	puR 've.zis se~'Ti~.mus ki a'ki.lu ki fa'ze~.mus 'na~w~ E se~'na~w~ u~.ma 'go.ta Di 'a.gwa nu 'maX, majz u 'maX se'ri.a me~'nOX si Li faw'ta.si u~.ma 'go.ta
Fortes razões, fazem fortes ações.	'fOX.Tis Ra'zo~j~s, 'fa.ze~j~ 'fOX.Tiz a'so~j~s
Toda reforma interior e toda mudança para melhor dependem exclusivamente da aplicação do nosso próprio esforço.	'to.da Re'fOR.ma i~.te.ri'or i 'to.da mu'da~.sa 'pa.ra me'LOR de'pe~.de~j~ es.klu.zi.va~'me~.Ti da a.pli.ka'sa~w~ du 'nO.su 'prO.prju es'foX.su
Não há que ser forte. Há que ser flexível.	'na~w~ 'a ki 'seX 'fOX.Ti, 'a ki 'seX flek'si.vew
Na vida, não existem soluções. Existem forças em marcha: é preciso criá-las e, então, a elas seguem-se as soluções.	na 'vi.da, 'na~w~ e'zis.te~j~ so.lu'so~j~s, e'zis.te~j~ 'foX.saz e~j~ 'maX.Sa, E pre'si.zu kri'a laz i, e~'ta~w~, a 'E.las 'sE.ge~j~ si as so.lu'so~j~s
O pensamento pode ter elevação sem ter elegância, e, na proporção em que não tiver elegância, perderá a ação sobre os outros. A força sem a destreza é uma simples massa.	u pe~.sa~'me~.tu 'pO.Di 'ter e.le.va'sa~w~ se~j~ 'ter e.le'ga~.sja, i, na pro.poX'sa~w~ e~j~ ki 'na~w~ Ti'vEr e.le'ga~.sja, peR.de'ra a a'sa~w~ 'so.bri uz 'ow.trus, a 'foX.sa se~j~ a des'tre.za E u~.ma 'si~.plis 'ma.sa
Na verdade, só existe prazer no uso e no sentimento das próprias forças, e a maior dor é a reconhecida falta de forças onde elas seriam necessárias.	na veR'da.Di, 'sO e'zis.Ti pra'zeR nu 'u.zu i nu se~.Ti~'me~.tu das 'prO.prjas 'foX.sas, i a maj'OR 'dor E a Re.ko~.Je'si.da 'faw.ta Di 'foX.saz 'o~.Di 'E.las se'ri.a~w~ ne.se'sa.rjas
Ser feliz é encontrar força no perdão, esperanças nas batalhas, segurança no palco do medo, amor nos desencontros. É agradecer a Deus a cada minuto pelo milagre da vida.	'seX fe'liz E e~.ko~'traX 'foX.sa nu peR'da~w~, es.pe'ra~.sas nas ba'ta.Las, se.gu'ra~.sa nu 'paw.ku du 'me.du, a~'moR nus de.ze~'ko~.trus, E a.gra.de'ser a 'dewz a 'ka.da mi~'nu.tu 'pe.lu mi'la.gri da 'vi.da
Se pela força da distância você se ausenta, pela força que há na saudade você voltará.	si 'pe.la 'foX.sa da Dis'ta~.sja vo'se si aw'ze~.ta, 'pe.la 'foX.sa ki 'a na saw'da.Di vo'se vow.ta'ra
O maior líder é aquele que reconhece sua pequenez, extrai força de sua humildade e experiência da sua fragilidade.	u maj'OR 'li.der E a'ke.li ki Re.ko~'JE.si 'su.a pe.ke~'nejs, es'traj 'foX.sa Di 'su.a u~.miw'da.Di i es.pe.ri'e~.sja da 'su.a fra.Zi.li'da.Di
Que a força do medo que tenho não me impeça de ver o que anseio. Que a morte de tudo que acredito não me tape os ouvidos e a boca.	ki a 'foX.sa du 'me.du ki 'te~.Ju 'na~w~ mi i~'pE.sa Di 'ver u ki a~'sej.u, ki a 'mOX.Ti Di 'tu.du ki a.kre'Di.tu 'na~w~ mi 'ta.pi uz ow'vi.duz i a 'bo.ka
Gostaria que você soubesse que existe dentro de si uma força capaz de mudar sua vida. Basta que lute e aguarde um novo amanhecer.	gos.ta'ri.a ki vo'se sow'bE.si ki e'zis.Ti 'de~.tru Di 'si u~.ma 'foX.sa ka'pajz Di mu'daX 'su.a 'vi.da, 'bas.ta ki 'lu.Ti i a'gwaR.Di u~ 'no.vu a~.ma~.Je'seX
Quando um louco parece completamente lúcido é o momento de colocar-lhe a camisa de força.	'kwa~.du u~ 'low.ku pa'rE.si ko~.plE.ta~'me~.Ti 'lu.si.du E u mo~'me~.tu Di ko.lo'kaX Li a ka~'mi.za Di 'foX.sa
O amor é a única força capaz de transformar um inimigo em amigo.	u a~'mor E a 'u~.ni.ka 'foX.sa ka'pajz Di tra~s.foR'mar u~ i~.ni~'mi.gu e~j~ a~'mi.gu
Estou convencido das minhas próprias limitações - e esta convicção é minha força.	es'tow ko~.ve~'si.du das 'mi~.Jas 'prO.prjaz li~.mi.ta'so~j~s, i 'Es.ta ko~.vik'sa~w~ E 'mi~.Ja 'foX.sa
Leve os jovens a enxergar os singelos momentos, a força que surge nas perdas, a segurança que brota no caos, a grandeza que emana dos pequenos gestos!	'lE.vi u'ZO.ve~z a e~.SeR'gar us si~'ZE.lus mo~'me~.tus, a 'foX.sa ki 'suR.Zi nas 'peR.das, a se.gu'ra~.sa ki 'brO.ta nu 'kaws, a gra~'de.za ki e~'ma~.na dus pe'ke~.nus 'ZEs.tus
O amor é uma força, uma energia, que se manifesta Na alma como um sentimento de lembrança de algo Que a alma já teve, mas perdeu.	u a~'mor E u~.ma 'foX.sa, u~.ma e~.neR'Zi.a, ki si ma~.ni'fEs.ta na 'aw.ma 'ko~.mu u~ se~.Ti~'me~.tu Di le~'bra~.sa Di 'aw.gu ki a 'aw.ma 'Za 'te.vi, majs peR'dew
Só sofro com toda a força do mundo porque amo com a intensidade de um cometa.	'sO 'so.fru ko~ 'to.da a 'foX.sa du 'mu~.du puX'ke 'a~.mu ko~ a i~.te~.si'da.Di Di u~ ko~'me.ta
A maior desgraça da democracia é que ela traz à tona a força numérica dos idiotas, que são a maioria da humanidade.	a maj'OR dez'gra.sa da de~.mo.kra'si.a E ki 'E.la 'trajz a 'to~.na a 'foX.sa nu~'mE.ri.ka duz i.Di'O.tas, ki 'sa~w~ a maj.o'ri.a da u~.ma~.ni'da.Di
A força se consegue com fracassos e não com os sucessos.	a 'foX.sa si ko~'sE.gi ko~ fra'ka.suz i 'na~w~ ko~ us su'sE.sus
O amor é ajudado pela força. A doçura do perdão traz a esperança e a paz.	u a~'mor E a.Zu'da.du 'pe.la 'foX.sa, a do'su.ra du peR'da~w~ 'trajz a es.pe'ra~.sa i a 'pajs
Os sonhos não determinam o lugar em que você vai estar, mas produzem a força necessária para tirá-lo do lugar em que está.	us 'so~.Jus 'na~w~ de.teR'mi~.na~w~ u lu'gar e~j~ ki vo'se 'vaj es'taX, majs pro'du.ze~j~ a 'foX.sa ne.se'sa.rja 'pa.ra Ti'ra lu du lu'gar e~j~ ki es'ta
Assim como o lutador, o guerreiro da luz conhece sua imensa força; e jamais luta com quem não merece a honra do combate.	a'si~ 'ko~.mu u lu.ta'doX, u ge'Rej.ru da 'lujs ko~'JE.si 'su.a i~'me~.sa 'foX.sa, i Za~'majs 'lu.ta ko~ 'ke~j~ 'na~w~ me'rE.si a 'o~.Ra du ko~'ba.Ti
Não falo, não suspiro, não escrevo seu nome. Mas a lágrima que agora queima a minha face me força a fazê-lo.	'na~w~ 'fa.lu, 'na~w~ sus'pi.ru, 'na~w~ es'kre.vu 'sew 'no~.mi, majz a 'la.gri~.ma ki a'gO.ra 'kej.ma a 'mi~.Ja 'fa.si mi 'fOX.sa a fa'ze lu
Ela tem força, ela tem sensibilidade, ela é guerreira. Ela é uma deusa, ela é mulher de verdade.	'E.la te~j~ 'foX.sa, 'E.la te~j~ se~.si.bi.li'da.Di, 'E.la E ge'Rej.ra, 'E.la E u~.ma 'dew.za, 'E.la E mu'LER Di veR'da.Di
Violência não é um sinal de força, a violência é um sinal de desespero e fraqueza.	vi.o'le~.sja 'na~w~ E u~ si~'naw Di 'foX.sa, a vi.o'le~.sja E u~ si~'naw Di de.zes'pe.ru i fra'ke.za
Força de ânimo e coragem na adversidade servem para conquistar o êxito, mais do que um exército.	'foX.sa Di 'a~.ni~.mu i ko'ra.Ze~j~ na a.Di.veX.si'da.Di 'sER.ve~j~ 'pa.ra ko~.kis'tar u 'e.zi.tu, 'majs du ki u~ e'zEX.si.tu
Para conquistarmos algo na vida não é necessário apenas força ou talento, é preciso, acima de tudo, ter vivido um grande amor.	'pa.ra ko~.kis'taR.muz 'aw.gu na 'vi.da 'na~w~ E ne.se'sa.rju a'pe~.nas 'foX.sa ow ta'le~.tu, E pre'si.zu, a'si~.ma Di 'tu.du, 'teR vi'vi.du u~ 'gra~.Di a~'moX
Lida propriamente, a Bíblia é a força mais potente para o ateísmo jamais concebida	'li.da prO.pri.a~'me~.Ti, a 'bi.blja E a 'foX.sa 'majs po'te~.Ti 'pa.ra u a.te'iz.mu Za~'majs ko~.se'bi.da
Enfrentaremos a força física com a nossa força moral.	e~.fre~.ta're~.muz a 'foX.sa 'fi.zi.ka ko~ a 'nO.sa 'foX.sa mo'raw
Agora as pessoas voltaram a me irritar. E eu voltei a ter que fazer muita força pra sair de casa.	a'gO.ra as pe'so.as vow'ta.ra~w~ a mi i.Ri'taX, i ew vow'tej a 'teX ki fa'zeR 'mu~j~.ta 'foX.sa pra sa'iR Di 'ka.za
A paz não pode ser mantida à força. Somente pode ser atingida pelo entendimento.	a 'pajz 'na~w~ 'pO.Di 'seR ma~'Ti.da a 'foX.sa, sO~'me~.Ti 'pO.Di 'ser a.Ti~'Zi.da 'pe.lu e~.te~.Di~'me~.tu
Evite a força, ataque a fraqueza.	e'vi.Ti a 'foX.sa, a'ta.ki a fra'ke.za
Nossa força maior não está na capacidade de pensar, mas em algo mais poderoso: o poder de controlar e direcionar nossos pensamentos para onde quisermos.	'nO.sa 'foX.sa maj'OR 'na~w~ es'ta na ka.pa.si'da.Di Di pe~'saX, majz e~j~ 'aw.gu 'majs po.de'ro.zu, u po'deR Di ko~.tro'lar i Di.re.si.o~'naR 'nO.sus pe~.sa~'me~.tus 'pa.ra 'o~.Di ki'zER.mus
Porque a vida segue. Mas o que foi bonito fica com toda a força. Mesmo que a gente tente apagar com outras coisas bonitas ou leves, certos momentos nem o tempo apaga.	puX'ke a 'vi.da 'sE.gi, majz u ki 'foj bo~'ni.tu 'fi.ka ko~ 'to.da a 'foX.sa, 'mez.mu ki a 'Ze~.Ti 'te~.Ti a.pa'gaX ko~ 'ow.tras 'koj.zas bo~'ni.taz ow 'lE.vis, 'sEX.tus mo~'me~.tus ne~j~ u 'te~.pu a'pa.ga
O amor é uma força que transforma o destino.	u a~'mor E u~.ma 'foX.sa ki tra~s'fOR.ma u des'Ti~.nu
Benditas sejam todas as palavras ditas em silêncio. Porque não há força maior que a fé, nem voz mais alta que a oração.	be~'Di.tas 'se.Za~w~ 'to.daz as pa'la.vras 'Di.taz e~j~ si'le~.sju, puX'ke 'na~w~ 'a 'foX.sa maj'OX ki a 'fE, ne~j~ 'vOjz 'majz 'aw.ta ki a o.ra'sa~w~
Quanto mais você se fortalece interiormente, se dá força, está do seu lado, menos você se deixar seduzir pela vaidade, pelo que os outros vão pensar. O apego é uma ilusão.	'kwa~.tu 'majs vo'se si foX.ta'lE.si i~.te.ri.oR'me~.Ti, si 'da 'foX.sa, es'ta du 'sew 'la.du, 'me~.nus vo'se si dej'SaX se.du'ziX 'pe.la vaj'da.Di, 'pe.lu ki uz 'ow.trus 'va~w~ pe~'saX, u a'pe.gu E u~.ma i.lu'za~w~
Natureza é uma força que inunda como os desertos.	na.tu're.za E u~.ma 'foX.sa ki i~'nu~.da 'ko~.mu us de'zEX.tus
A força gerada pela não violência é infinitamente maior do que a força de todas as armas inventadas pela engenhosidade do homem.	a 'foX.sa Ze'ra.da 'pe.la 'na~w~ vi.o'le~.sja E i~.fi~.ni.ta~'me~.Ti maj'OR du ki a 'foX.sa Di 'to.daz az 'aR.maz i~.ve~'ta.das 'pe.la e~.Ze~.Jo.zi'da.Di du 'o~.me~j~
Fui dormir umas vezes tão feliz, que, se  soubesse minha força, levitava. Em outras, tanta foi a tristeza que fiz versos	'fuj doR'mir u~.mas 've.zis 'ta~w~ fe'lis, ki, si sow'bE.si 'mi~.Ja 'foX.sa, le.vi'ta.va, e~j~ 'ow.tras, 'ta~.ta 'foj a tris'te.za ki 'fiz 'vEX.sus
A graça é uma qualidade que dá ao homem a força de executar as exigências da lei.	a 'gra.sa E u~.ma kwa.li'da.Di ki 'da aw 'o~.me~j~ a 'foX.sa Di e.ze.ku'tar az e.zi'Ze~.sjas da 'lej
Toda a força que eu vejo em você Tem sido vital pra mim Você ainda é meu melhor pecado É o que eu mais desejo É o meu berço E agora eu sei O quanto conhecer você foi bom pra mim	'to.da a 'foX.sa ki ew 've.Zu e~j~ vo'se te~j~ 'si.du vi'taw pra 'mi~ vo'se a'i~.da E 'mew me'LOX pe'ka.du E u ki ew 'majs de'ze.Zu E u 'mew 'beX.su i a'gO.ra ew 'sej u 'kwa~.tu ko~.Je'seR vo'se 'foj 'bo~ pra 'mi~
Deus não consiste na força, mas na verdade.	'dews 'na~w~ ko~'sis.Ti na 'foX.sa, majs na veR'da.Di
Só podemos medir a nossa força quando nos deparamos com um obstáculo.	'sO po'de~.mus me'Dir a 'nO.sa 'foX.sa 'kwa~.du nus de.pa'ra~.mus ko~ u~ obs'ta.ku.lu
As ondas de dor que me haviam assaltado pouco tempo antes se erguiam agora com força e inundaram minha cabeça, puxando-me para o peito. Não voltei à superfície.	az 'o~.das Di 'doX ki mi a'vi.a~w~ a.saw'ta.du 'pow.ku 'te~.pu 'a~.Tis si eR'gi.a~w~ a'gO.ra ko~ 'foX.sa i i~.nu~'da.ra~w~ 'mi~.Ja ka'be.sa, pu'Sa~.du mi 'pa.ra u 'pej.tu, 'na~w~ vow'tej a su.peX'fi.si
Não é a força do sentimento elevado, é a sua duração que faz os homens superiores.	'na~w~ E a 'foX.sa du se~.Ti~'me~.tu e.le'va.du, E a 'su.a du.ra'sa~w~ ki 'fajz uz 'o~.me~s su.pe.ri'o.ris
A fé é como o amor: não pode ser obtida pela força.	a 'fE E 'ko~.mu u a~'moX, 'na~w~ 'pO.Di 'ser ob'Ti.da 'pe.la 'foX.sa
Satiagraha: força da Verdade  Ahimsa: não violência	sa.Ti.a'gra.Ra, 'foX.sa da veR'da.Di a'Ri~.sa, 'na~w~ vi.o'le~.sja
Porque a força de dentro é maior. Maior que todo mal que existe no mundo. Maior que todos os ventos contrários. É maior porque é do bem. E nisso sim, acredito até o fim.	puX'ke a 'foX.sa Di 'de~.tru E maj'OX, maj'OX ki 'to.du 'maw ki e'zis.Ti nu 'mu~.du, maj'OX ki 'to.duz us 've~.tus ko~'tra.rjus, E maj'OX puX'ke E du 'be~j~, i 'ni.su 'si~, a.kre'Di.tu a'tE u 'fi~
Que a Força esteja com você!	ki a 'foX.sa es'te.Za ko~ vo'se
O poder de um ser humano não está na sua musculatura mas na sua inteligência. Os fracos usam a força, os fortes usam a sabedoria.	u po'deR Di u~ 'ser u~'ma~.nu 'na~w~ es'ta na 'su.a mus.ku.la'tu.ra majs na 'su.a i~.te.li'Ze~.sja, us 'fra.kuz 'u.za~w~ a 'foX.sa, us 'fOX.Tiz 'u.za~w~ a sa.be.do'ri.a
Bella! Ele voltou toda a força de seus olhos dourados e abrasadores para mim. Que é? murmurei, distraída. Divirta-me! insistiu ele.	'bE.la, 'e.li vow'tow 'to.da a 'foX.sa Di 'sewz 'O.Lus dow'ra.duz i a.bra.za'do.ris 'pa.ra 'mi~, ki E, muR.mu'rej, Dis.tra'i.da, Di'viX.ta mi, i~.sis'Tiw 'e.li
Que a força do medo que tenho Não me impeça de ver o que anseio	ki a 'foX.sa du 'me.du ki 'te~.Ju 'na~w~ mi i~'pE.sa Di 'ver u ki a~'sej.u
As duas virtudes cardinais da guerra: força e fraude.	as 'du.as viX'tu.Dis kaR.Di~'najs da 'gE.Ra, 'foX.sa i 'fraw.Di
Abismo  Talvez o abismo nos engula Talvez cheguemos a Atlântida Talvez não tenhamos mais a força de mover montanhas. Mas somos o que somos.	a'biz.mu taw'vejz u a'biz.mu nuz e~'gu.la taw'vej.Se'ge~.muz a a'tla~.Ti.da taw'vejz 'na~w~ te~'Ja~.mus 'majz a 'foX.sa Di mo'veR mo~'ta~.Jas, majs 'so~.muz u ki 'so~.mus
Eu sou uma força que avança!	ew 'sow u~.ma 'foX.sa ki a'va~.sa
Tira força da tua fraqueza.	'Ti.ra 'foX.sa da 'tu.a fra'ke.za
Minha história é de uma escuridão tranquila, de raiz adormecida na sua força, de odor que não tem perfume.	'mi~.Ja is'tO.rja E Di u~.ma es.ku.ri'da~w~ tra~'kwi.la, Di Ra'iz a.doR.me'si.da na 'su.a 'foX.sa, Di o'doX ki 'na~w~ te~j~ peX'fu~.mi
Força sempre.	'foX.sa 'se~.pri
Todos caem mas apenas os fracos continuam no chão...	'to.dus 'ka.e~j~ majz a'pe~.naz us 'fra.kus ko~.Ti~'nu.a~w~ nu 'Sa~w~
Eterno é tudo aquilo que vive uma fração de segundo mas com tamanha intensidade que se petrifica e nenhuma força o resgata.	e'tER.nu E 'tu.du a'ki.lu ki 'vi.vi u~.ma fra'sa~w~ Di se'gu~.du majs ko~ ta~'ma~.Ja i~.te~.si'da.Di ki si pe.tri'fi.ka i ne~'Ju~.ma 'foX.sa u Rez'ga.ta
O ponto de partida de qualquer conquista é o desejo.	u 'po~.tu Di paX'Ti.da Di kwaw'kEX ko~'kis.ta E u de'ze.Zu
Nada é tão difícil que, à força de tentativas, não tenha resolução.	'na.da E 'ta~w~ Di'fi.siw ki, a 'foX.sa Di te~.ta'Ti.vas, 'na~w~ 'te~.Ja Re.zo.lu'sa~w~
Alguns tiveram a forca como preço pelo próprio crime, outros, a coroa.	aw'gu~s Ti'vE.ra~w~ a 'foX.ka 'ko~.mu 'pre.su 'pe.lu 'prO.prju 'kri~.mi, 'ow.trus, a ko'ro.a
O ideal é um poderoso bálsamo que duplica a força dos homens de gênio e mata os fracos.	u i.de'aw E u~ po.de'ro.zu 'baw.sa~.mu ki du'pli.ka a 'foX.sa duz 'o~.me~s Di 'Ze~.nju i 'ma.ta us 'fra.kus
É mais trabalhoso conduzir os homens pela persuasão que pela força.	E 'majs tra.ba'Lo.zu ko~.du'zir uz 'o~.me~s 'pe.la peX.su.a'za~w~ ki 'pe.la 'foX.sa
A ingenuidade é uma força que os astutos fazem mal em desprezar.	a i~.Ze~.nuj'da.Di E u~.ma 'foX.sa ki uz as'tu.tus 'fa.ze~j~ 'maw e~j~ des.pre'zaX
A força dos maus é eles considerarem-se bons e vítimas dos caprichos alheios.	a 'foX.sa dus 'mawz E 'e.lis ko~.si.de'ra.re~j~ si 'bo~z i 'vi.Ti~.mas dus ka'pri.Suz a.Lej'us
A verdade será um dia a força. Saber é poder é a mais bela divisa que alguma vez se disse.	a veR'da.Di se'ra u~ 'Di.a a 'foX.sa, sa'ber E po'der E a 'majs 'bE.la Di'vi.za ki aw'gu~.ma 'vejs si 'Di.si
A força dos povos bárbaros reside na sua juventude.	a 'foX.sa dus 'pO.vus 'baR.ba.rus Re'zi.Di na 'su.a Zu.ve~'tu.Di
A força de vontade dos fracos chama-se teimosia.	a 'foX.sa Di vo~'ta.Di dus 'fra.ku'Sa~.ma si tej~.mo'zi.a
Considera bem a medida da tua força e aquilo que excede a tua aptidão.	ko~.si'dE.ra 'be~j~ a me'Di.da da 'tu.a 'foX.sa i a'ki.lu ki e'sE.Di a 'tu.a ap.Ti'da~w~
Não é justo usar a força contra a sabedoria.	'na~w~ E 'Zus.tu u'zar a 'foX.sa 'ko~.tra a sa.be.do'ri.a
A paz e a força são duas mulheres ciumentas que recusam-se sempre a ficar na mesma casa.	a 'pajz i a 'foX.sa 'sa~w~ 'du.as mu'LE.ris si.u~'me~.tas ki Re'ku.za~w~ si 'se~.pri a fi'kaR na 'mez.ma 'ka.za
Todos nós temos a força suficiente para suportar os males dos outros.	'to.dus 'nOjs 'te~.muz a 'foX.sa su.fi.si'e~.Ti 'pa.ra su.poX'tar us 'ma.lis duz 'ow.trus
A vida não dá o que espera dela a criança caprichosa mas apenas o que lhe arrancam à força os corajosos e os audaciosos.	a 'vi.da 'na~w~ 'da u ki es'pE.ra 'dE.la a kri'a~.sa ka.pri'SO.za majz a'pe~.naz u ki Li a'Ra~.ka~w~ a 'foX.sa us ko.ra'ZO.zuz i uz aw.da.si'O.zus
A juventude deve ser domada com a razão, não com a força.	a Zu.ve~'tu.Di 'dE.vi 'seR do~'ma.da ko~ a Ra'za~w~, 'na~w~ ko~ a 'foX.sa
A força dos governos é inversamente proporcional ao peso dos impostos.	a 'foX.sa dus go'veR.nuz E i~.vEX.sa~'me~.Ti pro.poX.si.o~'naw aw 'pe.zu duz i~'pOs.tus
A arte não é outra coisa senão a força de sugestão de um detalhe.	a 'aX.Ti 'na~w~ E 'ow.tra 'koj.za se~'na~w~ a 'foX.sa Di su.Zes'ta~w~ Di u~ de'ta.Li
Uns homens sobem por leves como os vapores e gases, outros como os projécteis pela força do engenho e dos talentos.	u~z 'o~.me~s 'sO.be~j~ puR 'lE.vis 'ko~.mu us va'po.riz i 'ga.zis, 'ow.trus 'ko~.mu us pro'ZEk.tejs 'pe.la 'foX.sa du e~'Ze~.Ju i dus ta'le~.tus
O homem é, no universo, uma força, porém superior às outras, pelo pensamento.	u 'o~.me~j~ E, nu u~.ni'vEX.su, u~.ma 'foX.sa, po're~j~ su.pe.ri'or az 'ow.tras, 'pe.lu pe~.sa~'me~.tu
A ira nada pode sem a força.	a 'i.ra 'na.da 'pO.Di se~j~ a 'foX.sa
Fazer consistir a força do casamento na do amor é desconhecer o espírito desta instituição.	fa'zeX ko~.sis'Tir a 'foX.sa du ka.za~'me~.tu na du a~'mor E des.ko~.Je'ser u es'pi.ri.tu 'dEs.ta i~s.Ti.tuj'sa~w~
A fraqueza da força é só crer na força.	a fra'ke.za da 'foX.sa E 'sO 'kreR na 'foX.sa
Os governos suspeitam da literatura porque é uma força que lhes escapa.	us go'veR.nus sus'pej.ta~w~ da li.te.ra'tu.ra puX'ke E u~.ma 'foX.sa ki Liz es'ka.pa
Nós não temos nem a força nem as oportunidades de executar todo o bem e todo o mal que congeminamos.	'nOjs 'na~w~ 'te~.mus ne~j~ a 'foX.sa ne~j~ az o.poX.tu~.ni'da.Dis Di e.ze.ku'taX 'to.du u 'be~j~ i 'to.du u 'maw ki ko~.Ze~.mi~'na~.mus
A força do número é a mais brutal das forças, não carecendo, sequer, da audácia e do talento.	a 'foX.sa du 'nu~.me.ru E a 'majs bru'taw das 'foX.sas, 'na~w~ ka.re'se~.du, se'kEX, da aw'da.sja i du ta'le~.tu
Toda a nossa força é colocada na alma e no corpo: a primeira é destinada a comandar, o outro, a obedecer; uma aproxima-nos dos deuses, o outro, dos brutos.	'to.da a 'nO.sa 'foX.sa E ko.lo'ka.da na 'aw.ma i nu 'koX.pu, a pri~'mej.ra E des.Ti~'na.da a ko~.ma~'daX, u 'ow.tru, a o.be.de'seX, u~.ma a.pro'si~.ma nus dus 'dew.zis, u 'ow.tru, dus 'bru.tus
Um grande mérito força o respeito, e afugenta a adulação.	u~ 'gra~.Di 'mE.ri.tu 'fOX.sa u Res'pej.tu, i a.fu'Ze~.ta a a.du.la'sa~w~
O adversário mais perigoso da força é a fraqueza.	u a.Di.veX'sa.rju 'majs pe.ri'go.zu da 'foX.sa E a fra'ke.za
À força de prazeres a nossa felicidade cai no abismo.	a 'foX.sa Di pra'ze.riz a 'nO.sa fe.li.si'da.Di 'kaj nu a'biz.mu
Os homens desejam ser escravos em qualquer parte e colher aí a força para dominar noutro sítio.	uz 'o~.me~s de'ze.Za~w~ 'ser es'kra.vuz e~j~ kwaw'kEX 'paX.Ti i ko'Ler a'i a 'foX.sa 'pa.ra do~.mi~'naR 'now.tru 'si.Tju
A verdadeira força é o expoente da destreza.	a veR.da'dej.ra 'foX.sa E u es.po'e~.Ti da des'tre.za
Vou seguir meu próprio caminho, minha fé perdeu a sua força novamente, e tem sido muito difícil dizer: estamos caindo do abismo novamente.	'vow se'giR 'mew 'prO.prju ka~'mi~.Ju, 'mi~.Ja 'fE peR'dew a 'su.a 'foX.sa nO.va~'me~.Ti, i te~j~ 'si.du 'mu~j~.tu Di'fi.siw Di'zeX, es'ta~.mus ka'i~.du du a'biz.mu nO.va~'me~.Ti
A paciência traz mais frutos que a própria força	a pa.si'e~.sja 'trajz 'majs 'fru.tus ki a 'prO.prja 'foX.sa
O fanatismo é a única forma de força de vontade acessível aos fracos.	u fa~.na'Tiz.mu E a 'u~.ni.ka 'fOR.ma Di 'foX.sa Di vo~'ta.Di a.se'si.vew aws 'fra.kus
A ânsia pelo poder não se origina da força, e sim da fraqueza.	a 'a~.sja 'pe.lu po'deR 'na~w~ si o.ri'Zi~.na da 'foX.sa, i 'si~ da fra'ke.za
Essa força me ajuda a viver por isso eu não desisto Essas mãos que amparam o meu ser São as mãos de Jesus Cristo	'E.sa 'foX.sa mi a'Zu.da a vi'veX pur 'i.su ew 'na~w~ de'zis.tu 'E.sas 'ma~w~s ki a~'pa.ra~w~ u 'mew 'seX 'sa~w~ as 'ma~w~s Di Ze'zujs 'kris.tu
Eu tenho medo da força absurda que eu sinto sem você, de como eu tenho muito mais certeza de mim sem você, de como eu posso ser até mais feliz sem você.	ew 'te~.Ju 'me.du da 'foX.sa ab'suR.da ki ew 'si~.tu se~j~ vo'se, Di 'ko~.mu ew 'te~.Ju 'mu~j~.tu 'majs seX'te.za Di 'mi~ se~j~ vo'se, Di 'ko~.mu ew 'pO.su 'ser a'tE 'majs fe'lis se~j~ vo'se
Dá uma vontade de não ser, exatamente quando se é com toda força.	'da u~.ma vo~'ta.Di Di 'na~w~ 'seX, e.za.ta~'me~.Ti 'kwa~.du si E ko~ 'to.da 'foX.sa
Se a morte deve levar-me, então que seja com toda força, numa curva, porque vejo me mal acabar a minha vida numa cadeira de rodas.	si a 'mOX.Ti 'dE.vi le'vaX mi, e~'ta~w~ ki 'se.Za ko~ 'to.da 'foX.sa, 'nu~.ma 'kuR.va, puX'ke 've.Zu mi 'maw a.ka'bar a 'mi~.Ja 'vi.da 'nu~.ma ka'dej.ra Di 'RO.das
A adversidade tem o efeito de atrair a força e as qualidades de um homem que as teria adormecido na sua ausência.	a a.Di.veX.si'da.Di te~j~ u e'fej.tu Di a.tra'ir a 'foX.sa i as kwa.li'da.Dis Di u~ 'o~.me~j~ ki as te'ri.a a.doR.me'si.du na 'su.a aw'ze~.sja
Se o cavalo tivesse conhecimento da sua força, seria tão louco que se sujeitasse ao jugo, como acontece? Mas, caso ele se tornasse sensato e se libertasse, então dir-se-ia que tinha enlouquecido.	si u ka'va.lu Ti'vE.si ko~.Je.si~'me~.tu da 'su.a 'foX.sa, se'ri.a 'ta~w~ 'low.ku ki si su.Zej'ta.si aw 'Zu.gu, 'ko~.mu a.ko~'tE.si, majs, 'ka.zu 'e.li si toR'na.si se~'sa.tu i si li.beX'ta.si, e~'ta~w~ 'DiX si 'i.a ki 'Ti~.Ja e~.low.ke'si.du
Que a Força esteja com você.	ki a 'foX.sa es'te.Za ko~ vo'se
Senhor, dai-me força e sabedoria para passar nos obstáculos do meu dia a dia. Que o Senhor esteja ao meu lado em todo o momento, pois sem Ti, meu Pai, eu não sou nada.	se~'JoX, 'daj mi 'foX.sa i sa.be.do'ri.a 'pa.ra pa'saR nuz obs'ta.ku.lus du 'mew 'Di.a a 'Di.a, ki u se~'Jor es'te.Za aw 'mew 'la.du e~j~ 'to.du u mo~'me~.tu, 'pojs se~j~ 'Ti, 'mew 'paj, ew 'na~w~ 'sow 'na.da
Penso em você, penso em você com força e carinho.	'pe~.su e~j~ vo'se, 'pe~.su e~j~ vo'se ko~ 'foX.sa i ka'ri~.Ju
É um pacto silencioso que tem a força de manter as coisas enraizadas, um pacto de eternidade, mesmo que o destino um dia venha a dividir o caminho dos dois.	E u~ 'pak.tu si.le~.si'o.zu ki te~j~ a 'foX.sa Di ma~'ter as 'koj.zaz e~.Raj'za.das, u~ 'pak.tu Di e.teR.ni'da.Di, 'mez.mu ki u des'Ti~.nu u~ 'Di.a 've~.Ja a Di.vi'Dir u ka~'mi~.Ju dus 'dojs
Mas o homem que enxerga dois séculos na frente de seu tempo morre na forca...	majz u 'o~.me~j~ ki e~'SER.ga 'dojs 'sE.ku.lus na 'fre~.Ti Di 'sew 'te~.pu 'mO.Ri na 'foX.ka
Rir do mal é não estar disposto a combatê-lo. Rir do bem é desconhecer a força com o qual o bem difunde-se a si próprio.	'RiR du 'maw E 'na~w~ es'taR Dis'pos.tu a ko~.ba'te lu, 'RiR du 'be~j~ E des.ko~.Je'ser a 'foX.sa ko~ u 'kwaw u 'be~j~ Di'fu~.Di si a 'si 'prO.prju
Aquele que usa da força física é um fraco. O homem forte, de verdade, faz uso do amor e da razão.	a'ke.li ki 'u.za da 'foX.sa 'fi.zi.ka E u~ 'fra.ku, u 'o~.me~j~ 'fOX.Ti, Di veR'da.Di, 'fajz 'u.zu du a~'mor i da Ra'za~w~
Porque a força de dentro é maior. Maior que todo mal que existe no mundo.	puX'ke a 'foX.sa Di 'de~.tru E maj'OX, maj'OX ki 'to.du 'maw ki e'zis.Ti nu 'mu~.du
Força, atitude, coragem, respeito, amor e memórias cravadas em meu peito!	'foX.sa, a.Ti'tu.Di, ko'ra.Ze~j~, Res'pej.tu, a~'mor i me~'mO.rjas kra'va.daz e~j~ 'mew 'pej.tu
O amor é a força mais poderosa que existe. O amor é a fruta de todas as estações.	u a~'mor E a 'foX.sa 'majs po.de'rO.za ki e'zis.Ti, u a~'mor E a 'fru.ta Di 'to.daz az es.ta'so~j~s
Quando qualquer trabalho parece ter exigido imensa força e luta para efetivá-lo, a idéia é grandiosa	'kwa~.du kwaw'kEX tra'ba.Lu pa'rE.si 'ter e.zi'Zi.du i~'me~.sa 'foX.sa i 'lu.ta 'pa.ra e.fe.Ti'va lu, a i'dEj.a E gra~.Di'O.za
E nada tem tanta força quanto uma promessa.	i 'na.da te~j~ 'ta~.ta 'foX.sa 'kwa~.tu u~.ma pro~'mE.sa
Quem tem mãe pode dizer que tem tudo, que é feliz, que tem força pra lutar contra tudo e todos. Quem tem mãe tem vida.	'ke~j~ te~j~ 'ma~j~ 'pO.Di Di'zeX ki te~j~ 'tu.du, ki E fe'lis, ki te~j~ 'foX.sa pra lu'taX 'ko~.tra 'tu.du i 'to.dus, 'ke~j~ te~j~ 'ma~j~ te~j~ 'vi.da
Mostrar sentimentos não é sinal de fraqueza, é sinal de força interior.	mos'traX se~.Ti~'me~.tus 'na~w~ E si~'naw Di fra'ke.za, E si~'naw Di 'foX.sa i~.te.ri'oX
O segredo da minha força é que enxergo razões para continuar. Sempre.	u se'gre.du da 'mi~.Ja 'foX.sa E ki e~'SER.gu Ra'zo~j~s 'pa.ra ko~.Ti~.nu'aX, 'se~.pri
Com a força tomada de empréstimo a esta ajuda inconsciente, os pensamentos, resíduo do trabalho do dia, tornam-se então ativos novamente e surgem na consciência sob a forma de sonho.	ko~ a 'foX.sa to~'ma.da Di e~'prEs.Ti~.mu a 'Es.ta a'Zu.da i~.ko~.si'e~.Ti, us pe~.sa~'me~.tus, Re'zi.dwu du tra'ba.Lu du 'Di.a, 'tOR.na~w~ si e~'ta~w~ a'Ti.vus nO.va~'me~.Ti i 'suR.Ze~j~ na ko~.si'e~.saj sob a 'fOR.ma Di 'so~.Ju
Lembro de Guimarães Rosa, quando dizia que o que tem de ser tem muita força.	'le~.bru Di gi~.ma'ra~j~s 'RO.za, 'kwa~.du Di'zi.a ki u ki te~j~ Di 'seX te~j~ 'mu~j~.ta 'foX.sa
Deus nunca vai desistir de você, nunca.	'dews 'nu~.ka 'vaj de.zis'TiR Di vo'se, 'nu~.ka
A força que vem da alma, supera um momento de fraqueza de um grande homem.	a 'foX.sa ki 've~j~ da 'aw.ma, su'pE.ra u~ mo~'me~.tu Di fra'ke.za Di u~ 'gra~.Di 'o~.me~j~
Ela ta tentando ser forte. Mais manter o sorriso dói...	'E.la 'ta te~'ta~.du 'seX 'fOX.Ti, 'majs ma~'ter u so'Ri.zu 'dOj
Se não fomos fortes o bastante para encará as coisas da vida , seremos fracos bastante para perdê-la.	si 'na~w~ 'fo~.mus 'fOX.Tiz u bas'ta~.Ti 'pa.ra e~.ka'ra as 'koj.zas da 'vi.da, se're~.mus 'fra.kus bas'ta~.Ti 'pa.ra peR'de la
Não. Eu não to bem. Não. Eu não vou dizer o que aconteceu. Não. Você não se preocupa.	'na~w~, ew 'na~w~ 'to 'be~j~, 'na~w~, ew 'na~w~ 'vow Di'zer u ki a.ko~.te'sew, 'na~w~, vo'se 'na~w~ si prew'ku.pa
E que fique muito mal explicado. Não faço força para ser entendido. Quem faz sentido é soldado...	i ki 'fi.ki 'mu~j~.tu 'maw es.pli'ka.du, 'na~w~ 'fa.su 'foX.sa 'pa.ra 'ser e~.te~'Di.du, 'ke~j~ 'fajs se~'Ti.du E sow'da.du
Tomei consciência de que a força invencível que impulsionou o mundo não são os amores felizes mas os contrariados.	to~'mej ko~.si'e~.si.a Di ki a 'foX.sa i~.ve~'si.vew ki i~.puw.si.o~'now u 'mu~.du 'na~w~ 'sa~w~ uz a~'mo.ris fe'li.zis majz us ko~.tra.ri'a.dus
A paixão atrai os corações, a saudade força o encontro, o desejo traz tua boca, mas somente o amor  pode juntar duas almas.	a paj'Sa~w~ a'traj us ko.ra'so~j~s, a saw'da.Di 'fOX.sa u e~'ko~.tru, u de'ze.Zu 'trajs 'tu.a 'bo.ka, majs sO~'me~.Ti u a~'moX 'pO.Di Zu~'taR 'du.az 'aw.mas
É preciso força pra sonhar e perceber Que a estrada vai além do que se vê.	E pre'si.zu 'foX.sa pra so~'Jar i peX.se'beX ki a es'tra.da 'vaj a'le~j~ du ki si 've
Sempre há uma outra chance, uma outra amizade, um outro amor, uma nova força. Para todo fim, um recomeço.	'se~.pri 'a u~.ma 'ow.tra 'Sa~.si, u~.ma 'ow.tra a~.mi'za.Di, u~ 'ow.tru a~'moX, u~.ma 'nO.va 'foX.sa, 'pa.ra 'to.du 'fi~, u~ Re.ko~'me.su
Nossas virtudes e nossos defeitos são inseparáveis, assim como a força e a matéria. Quando se separam, o homem deixa de existir.	'nO.sas viX'tu.Diz i 'nO.sus de'fej.tus 'sa~w~ i~.se.pa'ra.vejs, a'si~ 'ko~.mu a 'foX.sa i a ma'tE.rja, 'kwa~.du si se'pa.ra~w~, u 'o~.me~j~ 'dej.Sa Di e.zis'TiX
Uma crença forte demonstra apenas a sua força, não a verdade daquilo que se acredita	u~.ma 'kre~.sa 'fOX.Ti de~'mo~s.tra a'pe~.naz a 'su.a 'foX.sa, 'na~w~ a veR'da.Di da'ki.lu ki si a.kre'Di.ta
Ser forte é ter coragem pra continuar. Ter força é ter força pra se superar.	'seX 'foX.Ti E 'teX ko'ra.Ze~j~ pra ko~.Ti~.nu'aX, 'teX 'foX.sa E 'teX 'foX.sa pra si su.pe'raX
As vezes é preciso ser como as ondas do mar, recuar para ganhar força.	as 've.ziz E pre'si.zu 'seX 'ko~.mu az 'o~.das du 'maX, Re.ku'aX 'pa.ra ga~'JaX 'foX.sa
Arme-se com a arma da oração, e terá mais força no combate diário.	'aR.mi si ko~ a 'aR.ma da o.ra'sa~w~, i te'ra 'majs 'foX.sa nu ko~'ba.Ti Di'a.rju
Ainda que a minha mente e o meu corpo enfraqueçam, Deus é a minha força, Ele é tudo o que eu sempre preciso.	a'i~.da ki a 'mi~.Ja 'me~.Ti i u 'mew 'koX.pu e~.fra'ke.sa~w~, 'dewz E a 'mi~.Ja 'foX.sa, 'e.li E 'tu.du u ki ew 'se~.pri pre'si.zu
Atitudes são como um bumerangue. Temos que medir a força com que o jogamos; Pois ao voltar ele pode cortar nossos dedos fora.	a.Ti'tu.Dis 'sa~w~ 'ko~.mu u~ bu~.me'ra~.gi, 'te~.mus ki me'Dir a 'foX.sa ko~ ki u Zo'ga~.mus, 'pojz aw vow'tar 'e.li 'pO.Di koX'taR 'nO.sus 'de.dus 'fO.ra
Que minha coragem seja maior que o meu medo, e que minha força seja tão grande quanto a minha fé.	ki 'mi~.Ja ko'ra.Ze~j~ 'se.Za maj'OX ki u 'mew 'me.du, i ki 'mi~.Ja 'foX.sa 'se.Za 'ta~w~ 'gra~.Di 'kwa~.tu a 'mi~.Ja 'fE
A força mais potente do universo é a fé.	a 'foX.sa 'majs po'te~.Ti du u~.ni'vEX.su E a 'fE
Que o sol a brilhar nas manhãs chuvosas tenha força para radiar os corações cinzas.	ki u 'sOw a bri'LaR nas ma~'Ja~j~.Su'vO.zas 'te~.Ja 'foX.sa 'pa.ra Ra.Di'ar us ko.ra'so~j~s 'si~.zas
Posso começar uma guerra ou acabar com ela. Posso lhe dar a força dos heróis ou deixá-lo impotente. Posso ser capturado com um olhar, mas nenhuma força me obriga a ficar. Quem sou eu? O amor!	'pO.su ko~.me'sar u~.ma 'gE.Ra ow a.ka'baX ko~ 'E.la, 'pO.su Li 'dar a 'foX.sa duz e'rOjz ow dej'Sa lu i~.po'te~.Ti, 'pO.su 'seX kap.tu'ra.du ko~ u~ o'LaX, majs ne~'Ju~.ma 'foX.sa mi o'bri.ga a fi'kaX, 'ke~j~ 'sow ew, u a~'moX
Não se pode controlar o próprio povo pela força, mas se pode distraí-lo com consumismo.	'na~w~ si 'pO.Di ko~.tro'lar u 'prO.prju 'po.vu 'pe.la 'foX.sa, majs si 'pO.Di Dis.tra'i lu ko~ ko~.su~'miz.mu
Eu não tenho mais força para ficar longe de você!	ew 'na~w~ 'te~.Ju 'majs 'foX.sa 'pa.ra fi'kaR 'lo~.Zi Di vo'se
Acredite na força dos seus sonhos. Deus é justo e não colocaria em seu coração um desejo impossível de ser realizado.	a.kre'Di.Ti na 'foX.sa dus 'sews 'so~.Jus, 'dewz E 'Zus.tu i 'na~w~ ko.lo.ka'ri.a e~j~ 'sew ko.ra'sa~w~ u~ de'ze.Zu i~.po'si.vew Di 'se.Re.a.li'za.du
Entre a força e a técnica, vence a técnica. Se a força e a técnica forem iguais, vence o Espírito.	'e~.tri a 'foX.sa i a 'tEk.ni.ka, 've~.si a 'tEk.ni.ka, si a 'foX.sa i a 'tEk.ni.ka 'fo.re~j~ i'gwajs, 've~.si u es'pi.ri.tu
Deus, dá-me força pra começar minhas tarefas, perseverança pra não parar no meio, inteligência pra terminar e humildade pra ver que ficou muito bom e não me gabar.	'dews, 'da mi 'foX.sa pra ko~.me'saR 'mi~.Jas ta'rE.fas, peX.se.ve'ra~.sa pra 'na~w~ pa'raR nu 'mej.u, i~.te.li'Ze~.sja pra teR.mi~'nar i u~.miw'da.Di pra 'veX ki fi'kow 'mu~j~.tu 'bo~ i 'na~w~ mi ga'baX
Se a mulher soubesse que sua força está na sua fragilidade, dominaria o mundo.	si a mu'LEX sow'bE.si ki 'su.a 'foX.sa es'ta na 'su.a fra.Zi.li'da.Di, do~.mi~.na'ri.a u 'mu~.du
A Força de um Guerreiro não está em sua Espada e sim no  desejo de cumprir a justiça.	a 'foX.sa Di u~ ge'Rej.ru 'na~w~ es'ta e~j~ 'su.a es'pa.da i 'si~ nu de'ze.Zu Di ku~'prir a Zus'Ti.sa
Resistam e encontrarão a força Combatam e encontrarão a morte.	Re'zis.ta~w~ i e~.ko~.tra'ra~w~ a 'foX.sa ko~'ba.ta~w~ i e~.ko~.tra'ra~w~ a 'mOX.Ti
Se você não tem força para impor seus próprios termos à vida, você deve aceitar os termos que ela lhe oferece.	si vo'se 'na~w~ te~j~ 'foX.sa 'pa.ra i~'poX 'sews 'prO.prjus 'teR.muz a 'vi.da, vo'se 'dE.vi a.sej'tar us 'teR.mus ki 'E.la Li o.fe'rE.si
Nossa ansiedade não esvazia o sofrimento do amanhã, mas apenas esvazia a força do hoje.	'nO.sa a~.si.e'da.Di 'na~w~ ez.va'zi.a u so.fri~'me~.tu du a~.ma~'Ja~, majz a'pe~.naz ez.va'zi.a a 'foX.sa du 'o.Zi
Eu não troco a justiça pela soberba. Eu não deixo o direito pela força. Eu não esqueço a fraternidade pela tolerância. Eu não substituo a fé pela supertição, a realidade pelo ídolo.	ew 'na~w~ 'trO.ku a Zus'Ti.sa 'pe.la so'beR.ba, ew 'na~w~ 'dej.Su u Di'rej.tu 'pe.la 'foX.sa, ew 'na~w~ es'ke.su a fra.teR.ni'da.Di 'pe.la to.le'ra~.sja, ew 'na~w~ subs.Ti'tu.u a 'fE 'pe.la su.peX.Ti'sa~w~, a Re.a.li'da.Di 'pe.lu 'i.do.lu
É impressionante a força que as coisas parecem ter quando elas precisam acontecer.	E i~.pre.si.o~'na~.Ti a 'foX.sa ki as 'koj.zas pa'rE.se~j~ 'teX 'kwa~.du 'E.las pre'si.za~w~ a.ko~.te'seX
Nenhum homem sabe o quanto é mau, até se esforçar para ser bom. Só conhecemos a força do vento quando caminhamos contra ele, e não quando nos deixamos levar.	ne~'Ju~ 'o~.me~j~ 'sa.bi u 'kwa~.tu E 'maw, 'a.tE si es.foX'saX 'pa.ra 'seR 'bo~, 'sO ko~.Je'se~.muz a 'foX.sa du 've~.tu 'kwa~.du ka~.mi~'Ja~.mus 'ko~.tra 'e.li, i 'na~w~ 'kwa~.du nus dej'Sa~.mus le'vaX
À força de tanto ler e imaginar, fui me distanciando da realidade ao ponto de já não poder distinguir em que dimenção vivo	a 'foX.sa Di 'ta~.tu 'ler i i~.ma.Zi~'naX, 'fuj mi Dis.ta~.si'a~.du da Re.a.li'da.Di aw 'po~.tu Di 'Za 'na~w~ po'deR Dis.Ti~'gwir e~j~ ki Di~.me~'sa~w~ 'vi.vu
Sonhe, lute, corra atrás, realize. Mas nunca desista, pois nada é impossível quando temos força, foco e fé.	'so~.Ji, 'lu.Ti, 'ko.Ra a'trajs, Re.a'li.zi, majs 'nu~.ka de'zis.ta, 'pojs 'na.da E i~.po'si.vew 'kwa~.du 'te~.mus 'foX.sa, 'fO.ku i 'fE
De que tamanho é a força do amor que nos permite arrancar a máscara da superficialidade para abrir nosso coração aos outros?	Di ki ta~'ma~.Ju E a 'foX.sa du a~'moX ki nus peR'mi.Ti a.Ra~'kar a 'mas.ka.ra da su.peX.fi.si.a.li'da.Di 'pa.ra a'briR 'nO.su ko.ra'sa~w~ awz 'ow.trus
Deus não prometeu dias sem dor, risos sem sofrimento, sol sem chuva, mas Ele prometeu Força para o dia, Conforto para as lágrimas e Luz para o caminho.	'dews 'na~w~ pro~.me'tew 'Di.as se~j~ 'doX, 'Ri.zus se~j~ so.fri~'me~.tu, 'sOw se~j~ 'Su.va, majz 'e.li pro~.me'tew 'foX.sa 'pa.ra u 'Di.a, ko~'foX.tu 'pa.ra as 'la.gri~.maz i 'lujs 'pa.ra u ka~'mi~.Ju
se você nasceu com a fraqueza para cair você nasceu com a força para levantar	si vo'se na'sew ko~ a fra'ke.za 'pa.ra ka'iR vo'se na'sew ko~ a 'foX.sa 'pa.ra le.va~'taX
Há uma força motriz mais poderosa que o vapor, a eletricidade e a energia atômica: a vontade.	'a u~.ma 'foX.sa mo'triz 'majs po.de'rO.za ki u va'poX, a e.le.tri.si'da.Di i a e~.neR'Zi.a a'to~.mi.ka, a vo~'ta.Di
O amor não força nada, ao contrário ele abre o caminho...	u a~'moR 'na~w~ 'fOX.sa 'na.da, aw ko~'tra.rju 'e.li 'a.bri u ka~'mi~.Ju
A cada dia que passa tento entender como consigo força para superar as decepções.	a 'ka.da 'Di.a ki 'pa.sa 'te~.tu e~.te~'deX 'ko~.mu ko~'si.gu 'foX.sa 'pa.ra su.pe'rar as de.sep'so~j~s
Isso é o que acontece quando uma força que não se pode parar encontra um objeto imóvel.	'i.su E u ki a.ko~'tE.si 'kwa~.du u~.ma 'foX.sa ki 'na~w~ si 'pO.Di pa'rar e~'ko~.tra u~ ob'ZE.tu i~'mO.vew
Ame, acredite, pense, grite, sonhe, conquiste, lute, batalhe, tenha força, tenha foco, tenha fé. Sorria e agradeça a Deus por mais um dia.	'a~.mi, a.kre'Di.Ti, 'pe~.si, 'gri.Ti, 'so~.Ji, ko~'kis.Ti, 'lu.Ti, ba'ta.Li, 'te~.Ja 'foX.sa, 'te~.Ja 'fO.ku, 'te~.Ja 'fE, so'Ri.a i a.gra'de.sa a 'dews puR 'majz 'u~ 'Di.a
Não importa pra onde ou por quanto tempo a vida me leve. A força da saudade sempre me trará de volta!	'na~w~ i~'pOX.ta pra 'o~.Di ow puX 'kwa~.tu 'te~.pu a 'vi.da mi 'lE.vi, a 'foX.sa da saw'da.Di 'se~.pri mi tra'ra Di 'vOw.ta
Mulher  sou mulher sou anjo sou força sou coragem sou luta sou uma sou todas sou sim sei que sou sei quem sou sei quem quero ser sou quem quero ser sou mulher	mu'LEX 'sow mu'LEX 'sow 'a~.Zu 'sow 'foX.sa 'sow ko'ra.Ze~j~ 'sow 'lu.ta 'sow u~.ma 'sow 'to.das 'sow 'si~ 'sej ki 'sow 'sej 'ke~j~ 'sow 'sej 'ke~j~ 'kE.ru 'seX 'sow 'ke~j~ 'kE.ru 'seX 'sow mu'LEX
Porque a vida segue. Mas o que foi bonito fica com toda a força. Certos momentos nem o tempo apaga.	puX'ke a 'vi.da 'sE.gi, majz u ki 'foj bo~'ni.tu 'fi.ka ko~ 'to.da a 'foX.sa, 'sEX.tus mo~'me~.tus ne~j~ u 'te~.pu a'pa.ga
Porque a força de dentro é maior. Maior que todos os ventos contrários.	puX'ke a 'foX.sa Di 'de~.tru E maj'OX, maj'OX ki 'to.duz us 've~.tus ko~'tra.rjus
Amar alguém profundamente lhe dá força; ser amado profundamente lhe dá coragem	a~'mar aw'ge~j~ pro.fu~.da~'me~.Ti Li 'da 'foX.sa, 'ser a~'ma.du pro.fu~.da~'me~.Ti Li 'da ko'ra.Ze~j~
Como você pode derrubar as fortalezas de Satanás, se você não tem nem a força para desligar a TV?	'ko~.mu vo'se 'pO.Di de.Ru'bar as foX.ta'le.zas Di sa.ta~'najs, si vo'se 'na~w~ te~j~ ne~j~ a 'foX.sa 'pa.ra dez.li'gar a 'te 've
A morte é parte natural da Vida. Regozije-se por aqueles que se uniram com a Força. Não lamente por eles. Não sinta falta deles. O apego leva à inveja. À sombra da cobiça, isso sim.	a 'mOX.Ti E 'paX.Ti na.tu'raw da 'vi.da, Re.go'zi.Zi si pur a'ke.lis ki si u~'ni.ra~w~ ko~ a 'foX.sa, 'na~w~ la~'me~.Ti pur 'e.lis, 'na~w~ 'si~.ta 'faw.ta 'de.lis, u a'pe.gu 'lE.va a i~'vE.Za, a 'so~.bra da ko'bi.sa, 'i.su 'si~
O importante não é o obstáculo que nos derrubou, o importante é a força que nos fez levantar e mudar a história de nossas vidas.	u i~.poX'ta~.Ti 'na~w~ E u obs'ta.ku.lu ki nus de.Ru'bow, u i~.poX'ta~.Ti E a 'foX.sa ki nus 'fejz le.va~'tar i mu'dar a is'tO.rja Di 'nO.sas 'vi.das
Apesar das ruínas e da morte, Onde sempre acabou cada ilusão, A força dos meus sonhos é tão forte, Que de tudo renasce a exaltação E nunca as minhas mãos ficam vazias.	a.pe'zaR das Ru'i~.naz i da 'mOX.Ti, 'o~.Di 'se~.pri a.ka'bow 'ka.da i.lu'za~w~, a 'foX.sa dus 'mews 'so~.Juz E 'ta~w~ 'foX.Ti, ki Di 'tu.du Re~'na.si a e.zaw.ta'sa~w~ i 'nu~.ka as 'mi~.Jas 'ma~w~s 'fi.ka~w~ va'zi.as
Não é a força do gotejar da água que fura a pedra, mas sim a persistência incansável desta ação.	'na~w~ E a 'foX.sa du go.te'ZaR da 'a.gwa ki 'fu.ra a 'pE.dra, majs 'si~ a peX.sis'te~.sja i~.ka~'sa.vew 'dEs.ta a'sa~w~
Paciência e tempo dão mais resultado do que a força e a raiva.	pa.si'e~.sja i 'te~.pu 'da~w~ 'majs Re.zuw'ta.du du ki a 'foX.sa i a 'Raj.va
A cada dia viver me esmaga com mais força.	a 'ka.da 'Di.a vi'veR mi ez'ma.ga ko~ 'majs 'foX.sa
Eu me lembrei que fugir, às vezes é necessário para recuperar o fôlego. Para restaurar a força.	ew mi le~'brej ki fu'ZiX, as 've.ziz E ne.se'sa.rju 'pa.ra Re.ku.pe'rar u 'fo.le.gu, 'pa.ra Res.taw'rar a 'foX.sa
Que eu tenha hoje, e a cada dia A força dos céus A luz do sol O brilho da lua O resplendor do fogo A agilidade do vento A profundidade do mar A estabilidade da terra E a firmeza da rocha.	ki ew 'te~.Ja 'o.Zi, i a 'ka.da 'Di.a a 'foX.sa dus 'sEwz a 'lujz du 'sOw u 'bri.Lu da 'lu.a u Res.ple~'doR du 'fo.gu a a.Zi.li'da.Di du 've~.tu a pro.fu~.Di'da.Di du 'mar a es.ta.bi.li'da.Di da 'tE.Ra i a fiR'me.za da 'RO.Sa
Todo mundo que pensa um pouco vive com medo da força democrática (numérica) dos idiotas.	'to.du 'mu~.du ki 'pe~.sa u~ 'pow.ku 'vi.vi ko~ 'me.du da 'foX.sa de~.mo'kra.Ti.ka, nu~'mE.ri.ka, duz i.Di'O.tas
O fato de ser capaz de sentir dor com tal intensidade é a sua maior força.	u 'fa.tu Di 'seX ka'pajz Di se~'TiR 'doX ko~ 'taw i~.te~.si'da.Di E a 'su.a maj'OX 'foX.sa
Há uma força maior que a energia atômica - A vontade! Albert Einstein.	'a u~.ma 'foX.sa maj'OX ki a e~.neR'Zi.a a'to~.mi.ka, a vo~'ta.Di, 'aw.beX.Ti 'aj~s.taj~
A verdadeira força não é a do mar em fúria que tudo destrói, mas do rochedo, impassível, que a tudo resiste!	a veR.da'dej.ra 'foX.sa 'na~w~ E a du 'mar e~j~ 'fu.rja ki 'tu.du des'trOj, majs du Ro'Se.du, i~.pa'si.vew, ki a 'tu.du Re'zis.Ti
Mesmo por toda riqueza dos sheiks árabes, não te esquecerei um dia, nem um dia, espero com a força do pensamento, recriar a luz que me trará você	'mez.mu puX 'to.da Ri'ke.za dus 'Sej.kiz 'a.ra.bis, 'na~w~ Ti es.ke.se'rej u~ 'Di.a, ne~j~ 'u~ 'Di.a, es'pE.ru ko~ a 'foX.sa du pe~.sa~'me~.tu, Re.kri'ar a 'lujs ki mi tra'ra vo'se
Uma mulher, quando reconhece sua força, se torna uma fonte inesgotável de inspiração.	u~.ma mu'LEX, 'kwa~.du Re.ko~'JE.si 'su.a 'foX.sa, si 'tOR.na u~.ma 'fo~.Ti i~.nez.go'ta.vew Di i~s.pi.ra'sa~w~
Espero que você leve uma vida da qual se orgulhe. Ou que tenha força para começar tudo de novo.	es'pE.ru ki vo'se 'lE.vi u~.ma 'vi.da da 'kwaw si oR'gu.Li, ow ki 'te~.Ja 'foX.sa 'pa.ra ko~.me'saX 'tu.du Di 'no.vu
Por trás da fragilidade física escondia-se uma extraordinária força.	puX 'trajs da fra.Zi.li'da.Di 'fi.zi.ka es.ko~'Di.a si u~.ma es.tra.oR.Di~'na.rja 'foX.sa
O leão chama a atenção por sua força; a águia, pela agilidade; o cisne, pela elegância; o chimpanzé, pela inteligência. Os vermes e as bactérias, pela inveja.	u le'a~w~ 'Sa~.ma a a.te~'sa~w~ puX 'su.a 'foX.sa, a 'a.gja, 'pe.la a.Zi.li'da.Di, u 'siz.ni, 'pe.la e.le'ga~.sja, u Si~.pa~'zE, 'pe.la i~.te.li'Ze~.sja, us 'vER.miz i as bak'tE.rjas, 'pe.la i~'vE.Za
Atropelei os sonhos, venci as mágoas, convivi com os fracos, suportei os falsos e hoje sei a força que eu tenho para enfrentar qualquer obstáculo.	a.tro.pe'lej us 'so~.Jus, ve~'si as 'ma.gwas, ko~.vi'vi ko~ us 'fra.kus, su.poX'tej us 'faw.suz i 'o.Zi 'sej a 'foX.sa ki ew 'te~.Ju 'pa.ra e~.fre~'taX kwaw'kEr obs'ta.ku.lu
Sabe o porquê tem muita gente odiando? Simples, odiar é fácil e não exige força. Agora, tente amar! Amar, não raramente, é dar as mãos ao sofrimento	'sa.bi u puX'ke te~j~ 'mu~j~.ta 'Ze~.Ti o.Di'a~.du, 'si~.plis, o.Di'ar E 'fa.siw i 'na~w~ e'zi.Zi 'foX.sa, a'gO.ra, 'te~.Ti a~'maX, a~'maX, 'na~w~ Ra.ra~'me~.Ti, E 'dar as 'ma~w~z aw so.fri~'me~.tu
E o teu medo de ter medo, de ter medo, de ter medo, não faz da minha força confusão.	i u 'tew 'me.du Di 'teR 'me.du, Di 'teR 'me.du, Di 'teR 'me.du, 'na~w~ 'fajz da 'mi~.Ja 'foX.sa ko~.fu'za~w~
Há algo que move a todos com a mesma força vital, a busca da felicidade e a realização pessoal.	'a 'aw.gu ki 'mO.vi a 'to.dus ko~ a 'mez.ma 'foX.sa vi'taw, a 'bus.ka da fe.li.si'da.Di i a Re.a.li.za'sa~w~ pe.so'aw
O amor é a maior força que a esperança tem para continuar a viver.	u a~'mor E a maj'OX 'foX.sa ki a es.pe'ra~.sa te~j~ 'pa.ra ko~.Ti~.nu'ar a vi'veX
Guerra é Paz Liberdade é Escravidão Ignorância é Força.	'gE.Ra E 'pajz li.beR'da.Di E es.kra.vi'da~w~ i.gi~.no'ra~.sja E 'foX.sa
Somente quando de tudo desesperamos é que a esperança começa a ser a verdadeira força.	sO~'me~.Ti 'kwa~.du Di 'tu.du de.zes.pe'ra~.muz E ki a es.pe'ra~.sa ko~'mE.sa a 'ser a veR.da'dej.ra 'foX.sa
Além de dar morada no seu abraço, ele me ajuda a remar com mais força.	a'le~j~ Di 'daR mo'ra.da nu 'sew a'bra.su, 'e.li mi a'Zu.da a Re~'maX ko~ 'majs 'foX.sa
Ser um ateu requer força mental e bondade de coração encontradas em um entre milhares.	'ser u~ a'tew Re'kEX 'foX.sa me~'taw i bo~'da.Di Di ko.ra'sa~w~ e~.ko~'tra.daz e~j~ 'u~ 'e~.tri mi'La.ris
Quem tem força, abusa.	'ke~j~ te~j~ 'foX.sa, a'bu.za
A grandeza não está em ser forte, mas no uso correto da força.	a gra~'de.za 'na~w~ es'ta e~j~ 'seX 'fOX.Ti, majs nu 'u.zu ko'RE.tu da 'foX.sa
Para eles, a família é uma fraqueza, e vão atrás dela. Para mim a família é uma força, e tenho negócios a fazer.	'pa.ra 'e.lis, a fa~'mi.lja E u~.ma fra'ke.za, i 'va~w~ a'trajs 'dE.la, 'pa.ra 'mi~ a fa~'mi.lja E u~.ma 'foX.sa, i 'te~.Ju ne'gO.sjuz a fa'zeX
Obrigar os outros a aceitar pontos de vista pessoais por meio de força, chantagem, trapaça ou manipulação sutil, também faz parte da nossa atividade emocional.	o.bri'gar uz 'ow.truz a a.sej'taX 'po~.tus Di 'vis.ta pe.so'ajs puR 'mej.u Di 'foX.sa, Sa~'ta.Ze~j~, tra'pa.sa ow ma~.ni.pu.la'sa~w~ su'Tiw, ta~'be~j~ 'fajs 'paX.Ti da 'nO.sa a.Ti.vi'da.Di e~.mo.si.o~'naw
Aquele que sua força conhece e sua fraqueza esconde, vale um império.	a'ke.li ki 'su.a 'foX.sa ko~'JE.si i 'su.a fra'ke.za es'ko~.Di, 'va.li u~ i~'pE.rju
Toda força será fraca, se não estiver unida.	'to.da 'foX.sa se'ra 'fra.ka, si 'na~w~ es.Ti'vEr u~'ni.da
Se você não tem incentivo de alguém, é bom ter muita força de vontade.	si vo'se 'na~w~ te~j~ i~.se~'Ti.vu Di aw'ge~j~, E 'bo~ 'teR 'mu~j~.ta 'foX.sa Di vo~'ta.Di
Lembre-se: sua verdadeira força, vem de dentro.	'le~.bri si, 'su.a veR.da'dej.ra 'foX.sa, 've~j~ Di 'de~.tru
Os pactos sem a espada são apenas palavras e não têm a força para defender ninguém.	us 'pak.tus se~j~ a es'pa.da 'sa~w~ a'pe~.nas pa'la.vraz i 'na~w~ 'te~j~ a 'foX.sa 'pa.ra de.fe~'deR ni~'ge~j~
Eu busco força, não para ser maior que os outros, mas para lutar contra meu maior inimigo, que é a dúvida dentro de mim mesma.	ew 'bus.ku 'foX.sa, 'na~w~ 'pa.ra 'seR maj'OX ki uz 'ow.trus, majs 'pa.ra lu'taX 'ko~.tra 'mew maj'Or i~.ni~'mi.gu, ki E a 'du.vi.da 'de~.tru Di 'mi~ 'mez.ma
o que perde, golpeia o gênio virtuoso através da pura força de vontade	u ki 'pER.Di, gow'pej.a u 'Ze~.nju viX.tu'o.zu a.tra'vEjs da 'pu.ra 'foX.sa Di vo~'ta.Di
Não existe morte. Existe Força.	'na~w~ e'zis.Ti 'mOX.Ti, e'zis.Ti 'foX.sa
Há certo gosto em pensar sozinho. É ato individual, como nascer e morrer.	'a 'sEX.tu 'gos.tu e~j~ pe~'saX sO'zi~.Ju, E 'a.tu i~.Di.vi.du'aw, 'ko~.mu na'ser i mo'ReX
Só se deve beber por gosto: beber por desgosto é uma cretinice.	'sO si 'dE.vi be'beX puR 'gos.tu, be'beX puR dez'gos.tu E u~.ma kre.Ti~'ni.si
Gosto e preciso de ti, Mas quero logo explicar, Não gosto porque preciso. Preciso sim, por gostar.	'gOs.tu i pre'si.zu Di 'Ti, majs 'kE.ru 'lO.gu es.pli'kaX, 'na~w~ 'gOs.tu puX'ke pre'si.zu, pre'si.zu 'si~, puR gos'taX
Gosto daquele que sonha o impossível.	'gOs.tu da'ke.li ki 'so~.Ja u i~.po'si.vew
Gosto um pouco mais da verdade quando sou eu que a descubro e não outro que me a mostra.	'gOs.tu u~ 'pow.ku 'majs da veR'da.Di 'kwa~.du 'sow ew ki a des'ku.bru i 'na~w~ 'ow.tru ki mi a 'mOs.tra
Gosto desta ideia: que o amor é uma forma de conversação em que as palavras agem em vez de serem faladas.	'gOs.tu 'dEs.ta i'dEj.a, ki u a~'mor E u~.ma 'fOR.ma Di ko~.veX.sa'sa~w~ e~j~ ki as pa'la.vraz 'a.Ze~j~ e~j~ 'vejz Di 'se.re~j~ fa'la.das
O que obviamente não presta sempre me interessou muito. Gosto de um modo carinhoso do inacabado, do malfeito, daquilo que desajeitadamente tenta um pequeno vôo e cai sem graça no chão.	u ki Ob.vi.a~'me~.Ti 'na~w~ 'prEs.ta 'se~.pri mi i~.te.re'sow 'mu~j~.tu, 'gOs.tu Di u~ 'mO.du ka.ri~'Jo.zu du i~.na.ka'ba.du, du maw'fej.tu, da'ki.lu ki de.za.Zej.ta.da~'me~.Ti 'te~.ta u~ pe'ke~.nu 'vow i 'kaj se~j~ 'gra.sa nu 'Sa~w~
Gosto dos venenos mais lentos! Das bebidas mais fortes! Dos cafés mais amargos! E os delírios mais loucos. Você pode até me empurrar de um penhasco que eu vou dizer: E daí? Eu adoro voar!	'gOs.tu dus ve~'ne~.nus 'majs 'le~.tus, das be'bi.das 'majs 'fOX.Tis, dus ka'fEjs 'majz a~'maR.gus, i us de'li.rjus 'majs 'low.kus, vo'se 'pO.Di a'tE mi e~.pu'RaR Di u~ pe~'Jas.ku ki ew 'vow Di'zeX, i da'i, ew a'dO.ru vo'aX
Eu gosto das pessoas pelo prazer de gostar e não porque deu tempo de gostar delas.	ew 'gOs.tu das pe'so.as 'pe.lu pra'zeR Di gos'tar i 'na~w~ puX'ke 'dew 'te~.pu Di gos'taR 'dE.las
Eu gosto do estranho, do incomum. Gosto daquilo que confunde, que permite diferentes interpretações, que fica nas entrelinhas.	ew 'gOs.tu du es'tra~.Ju, du i~.ko~'mu~, 'gOs.tu da'ki.lu ki ko~'fu~.Di, ki peR'mi.Ti Di.fe're~.Tiz i~.teX.pre.ta'so~j~s, ki 'fi.ka naz e~.tre'li~.Jas
Meu gosto é muito simples. Gosto do melhor de tudo.	'mew 'gos.tu E 'mu~j~.tu 'si~.plis, 'gOs.tu du me'LOR Di 'tu.du
Estou sempre disposto a aprender, mas nem sempre gosto que me ensinem.	es'tow 'se~.pri Dis'pos.tu a a.pre~'deX, majs ne~j~ 'se~.pri 'gOs.tu ki mi e~'si~.ne~j~
Quanto mais gosto da humanidade em geral, menos aprecio as pessoas em particular, como indivíduos.	'kwa~.tu 'majs 'gOs.tu da u~.ma~.ni'da.Di e~j~ Ze'raw, 'me~.nuz a.pre'si.u as pe'so.az e~j~ paX.Ti.ku'laX, 'ko~.mu i~.Di'vi.dwus
Não gosto da vida em banho-maria, gosto de fogo, pimenta, alho, ervas. Por um triz não sou uma bruxa.	'na~w~ 'gOs.tu da 'vi.da e~j~ 'ba~.Ju ma'ri.a, 'gOs.tu Di 'fo.gu, pi~'me~.ta, 'a.Lu, 'ER.vas, pur u~ 'triz 'na~w~ 'sow u~.ma 'bru.Sa
Gosto de porcos. Os cães olham-nos de baixo, os gatos de cima. Os porcos olham-nos de igual para igual.	'gOs.tu Di 'pOX.kus, us 'ka~j~z 'O.La~w~ nus Di 'baj.Su, us 'ga.tus Di 'si~.ma, us 'pOX.kuz 'O.La~w~ nus Di i'gwaw 'pa.ra i'gwaw
Quem abandona a luta não poderá nunca saborear o gosto de uma vitória.	'ke~j~ a.ba~'do~.na a 'lu.ta 'na~w~ po.de'ra 'nu~.ka sa.bo.re'ar u 'gos.tu Di u~.ma vi'tO.rja
Quando procuro o que há de fundamental em mim, é o gosto da felicidade que eu encontro.	'kwa~.du pro'ku.ru u ki 'a Di fu~.da~.me~'taw e~j~ 'mi~, E u 'gos.tu da fe.li.si'da.Di ki ew e~'ko~.tru
A vaidade dos outros só vai contra o nosso gosto quando vai contra a nossa vaidade.	a vaj'da.Di duz 'ow.trus 'sO 'vaj 'ko~.tra u 'nO.su 'gos.tu 'kwa~.du 'vaj 'ko~.tra a 'nO.sa vaj'da.Di
Defino a poesia das palavras como Criação rítmica da Beleza. O seu único juiz é o Gosto.	de'fi~.nu a po.e'zi.a das pa'la.vras 'ko~.mu kri.a'sa~w~ 'Ri.Ti~.mi.ka da be'le.za, u 'sew 'u~.ni.ku Zu'iz E u 'gos.tu
Nunca usei bombacha, não gosto de chimarrão e nem de me lembrar da última vez que subi num cavalo. Aliás, o cavalo também não gosta.	'nu~.ka u'zej bo~'ba.Sa, 'na~w~ 'gOs.tu Di Si~.ma'Ra~w~ i ne~j~ Di mi le~'braR da 'uw.Ti~.ma 'vejs ki su'bi nu~ ka'va.lu, a.li'ajs, u ka'va.lu ta~'be~j~ 'na~w~ 'gOs.ta
Não faças aos outros o que gostarias que te fizessem a ti. O gosto deles pode não ser o mesmo.	'na~w~ 'fa.saz awz 'ow.truz u ki gos.ta'ri.as ki Ti fi'zE.se~j~ a 'Ti, u 'gos.tu 'de.lis 'pO.Di 'na~w~ 'ser u 'mez.mu
Gosto dos epitáfios; eles são, entre a gente civilizada, uma expressão daquele pio e secreto egoísmo que induz o homem a arrancar à morte um farrapo ao menos da sombra que passou.	'gOs.tu duz e.pi'ta.fjus, 'e.lis 'sa~w~, 'e~.tri a 'Ze~.Ti si.vi.li'za.da, u~.ma es.pre'sa~w~ da'ke.li 'pi.u i se'krE.tu e.go'iz.mu ki i~'duz u 'o~.me~j~ a a.Ra~'kar a 'mOX.Ti u~ fa'Ra.pu aw 'me~.nus da 'so~.bra ki pa'sow
Assim como gosto do jovem que tem dentro de si algo do velho, gosto do velho que tem dentro de si algo do jovem: quem segue essa norma poderá ser velho no corpo, mas na alma não o será jamais.	a'si~ 'ko~.mu 'gOs.tu du 'ZO.ve~j~ ki te~j~ 'de~.tru Di 'si 'aw.gu du 'vE.Lu, 'gOs.tu du 'vE.Lu ki te~j~ 'de~.tru Di 'si 'aw.gu du 'ZO.ve~j~, 'ke~j~ 'sE.gi 'E.sa 'nOR.ma po.de'ra 'seR 'vE.Lu nu 'koX.pu, majs na 'aw.ma 'na~w~ u se'ra Za~'majs
Gosto mais dos sonhos do futuro do que da história do passado.	'gOs.tu 'majs dus 'so~.Jus du fu'tu.ru du ki da is'tO.rja du pa'sa.du
Trabalha com gosto e terás o gosto do trabalho.	tra'ba.La ko~ 'gos.tu i te'rajz u 'gos.tu du tra'ba.Lu
As obras de arte dividem-se em duas categorias: as de que gosto e as de que não gosto. Não conheço outro critério.	az 'O.bras Di 'aX.Ti Di'vi.de~j~ si e~j~ 'du.as ka.te.go'ri.as, as Di ki 'gOs.tu i as Di ki 'na~w~ 'gOs.tu, 'na~w~ ko~'Je.su 'ow.tru kri'tE.rju
Não gosto de trabalho, nem quando é outro a fazê-lo.	'na~w~ 'gOs.tu Di tra'ba.Lu, ne~j~ 'kwa~.du E 'ow.tru a fa'ze lu
Não gosto do trabalho, ninguém gosta; mas gosto do que é no trabalho a ocasião de se descobrir a si próprio.	'na~w~ 'gOs.tu du tra'ba.Lu, ni~'ge~j~ 'gOs.ta, majs 'gOs.tu du ki E nu tra'ba.Lu a o.ka.zi'a~w~ Di si des.ko'brir a 'si 'prO.prju
Gosto mais do engano que nos eleva, do que das verdades obscuras e baixas.	'gOs.tu 'majs du e~'ga~.nu ki nuz e'lE.va, du ki das veR'da.Diz obs'ku.raz i 'baj.Sas
Não gosto de Deus, porque não o conheço, nem do próximo, porque o conheço.	'na~w~ 'gOs.tu Di 'dews, puX'ke 'na~w~ u ko~'Je.su, ne~j~ du 'prO.si~.mu, puX'ke u ko~'Je.su
Há que trabalhar, ainda que não seja por gosto, ao menos por desespero, uma vez que, bem vistas as coisas, trabalhar é menos aborrecido do que divertirmo-nos.	'a ki tra.ba'LaX, a'i~.da ki 'na~w~ 'se.Za puR 'gos.tu, aw 'me~.nus puR de.zes'pe.ru, u~.ma 'vejs ki, 'be~j~ 'vis.taz as 'koj.zas, tra.ba'Lar E 'me~.nuz a.bo.Re'si.du du ki Di.veX'TiR.mu nus
Gosto demais dos meus filhos para lhes dar vida.	'gOs.tu de~'majs dus 'mews 'fi.Lus 'pa.ra Lis 'daR 'vi.da
Nunca me senti só. Gosto de estar comigo mesmo. Sou a melhor forma de entretenimento que posso encontrar.	'nu~.ka mi se~'Ti 'sO, 'gOs.tu Di es'taX ko~'mi.gu 'mez.mu, 'sow a me'LOX 'fOR.ma Di e~.tre.te~.ni~'me~.tu ki 'pO.su e~.ko~'traX
Nada tenho a ver com não gostar de mim. Me aceito impura, me gosto com pecados e há muito me perdoei.	'na.da 'te~.Ju a 'veX ko~ 'na~w~ gos'taR Di 'mi~, mi a'sej.tu i~'pu.ra, mi 'gOs.tu ko~ pe'ka.duz i 'a 'mu~j~.tu mi peR.do'ej
Eu amo as pessoas que me fazem rir. Sinceramente, acho que é a coisa que eu mais gosto, rir. Cura uma infinidade de males. É provavelmente a coisa mais importante em uma pessoa.	ew 'a~.mu as pe'so.as ki mi 'fa.ze~j~ 'RiX, si~.sE.ra~'me~.Ti, 'a.Su ki E a 'koj.za ki ew 'majs 'gOs.tu, 'RiX, 'ku.ra u~.ma i~.fi~.ni'da.Di Di 'ma.lis, E pro.va.vew'me~.Ti a 'koj.za 'majz i~.poX'ta~.Ti e~j~ u~.ma pe'so.a
Se eu gosto de poesia? Gosto de gente, bichos, plantas, lugares, chocolate, vinho, papos amenos, amizade, amor. Acho que a poesia está contida nisso tudo.	si ew 'gOs.tu Di po.e'zi.a, 'gOs.tu Di 'Ze~.Ti, 'bi.Sus, 'pla~.tas, lu'ga.ris, So.ko'la.Ti, 'vi~.Ju, 'pa.puz a~'me~.nus, a~.mi'za.Di, a~'moX, 'a.Su ki a po.e'zi.a es'ta ko~'Ti.da 'ni.su 'tu.du
Eu gosto de olhos que sorriem, de gestos que se desculpam, de toques que sabem conversar e de silêncios que se declaram.	ew 'gOs.tu Di 'O.Lus ki so'Ri.e~j~, Di 'ZEs.tus ki si des'kuw.pa~w~, Di 'tO.kis ki 'sa.be~j~ ko~.veX'sar i Di si'le~.sjus ki si de'kla.ra~w~
Eu gosto de catar o mínimo e o escondido. Onde ninguém mete o nariz, aí entra o meu, com a curiosidade estreita e aguda que descobre o encoberto.	ew 'gOs.tu Di ka'tar u 'mi~.ni~.mu i u es.ko~'Di.du, 'o~.Di ni~'ge~j~ 'mE.Ti u na'ris, a'i e~'tra u 'mew, ko~ a ku.ri.o.zi'da.Di es'trej.ta i a'gu.da ki des'kO.bri u e~.ko'bEX.tu
Das lembranças que eu trago na vida Você é a saudade que eu gosto de ter Só assim sinto você bem perto de mim.	das le~'bra~.sas ki ew 'tra.gu na 'vi.da vo'se E a saw'da.Di ki ew 'gOs.tu Di 'teX 'sO a'si~ 'si~.tu vo'se 'be~j~ 'pEX.tu Di 'mi~
Eu não falo porque quero salvar alguém. Eu falo porque gosto. Quem sou eu para salvar alguém? Eu é que tenho que me salvar!	ew 'na~w~ 'fa.lu puX'ke 'kE.ru saw'var aw'ge~j~, ew 'fa.lu puX'ke 'gOs.tu, 'ke~j~ 'sow ew 'pa.ra saw'var aw'ge~j~, ew E ki 'te~.Ju ki mi saw'vaX
O gosto de minha morte na boca deu-me perspectiva e coragem. O importante é a coragem de ser eu mesmo.	u 'gos.tu Di 'mi~.Ja 'mOX.Ti na 'bo.ka 'dew mi peXs.pek'Ti.va i ko'ra.Ze~j~, u i~.poX'ta~.Ti E a ko'ra.Ze~j~ Di ser 'ew 'mez.mu
Gosto dos meus erros; não quero prescindir da liberdade deliciosa de me enganar.	'gOs.tu dus 'mewz 'e.Rus, 'na~w~ 'kE.ru pre.si~'DiR da li.beR'da.Di de.li.si'O.za Di mi e~.ga~'naX
Eu gosto de delicadeza. Seja nos gestos, nas palavras, nas ações, no jeito de olhar, no dia-a-dia e até no que não é dito com palavras, mas fica no ar...	ew 'gOs.tu Di de.li.ka'de.za, 'se.Za nus 'ZEs.tus, nas pa'la.vras, naz a'so~j~s, nu 'Zej.tu Di o'LaX, nu 'Di.a a 'Di.a i a'tE nu ki 'na~w~ E 'Di.tu ko~ pa'la.vras, majs 'fi.ka nu 'aX
De alguma forma, nunca consegui me ajustar na sociedade. Não gosto da humanidade. Não tenho o menor desejo de me ajustar, nenhum senso de lealdade, nenhum objetivo de fato.	Di aw'gu~.ma 'fOR.ma, 'nu~.ka ko~.se'gi mi a.Zus'taR na so.si.e'da.Di, 'na~w~ 'gOs.tu da u~.ma~.ni'da.Di, 'na~w~ 'te~.Ju u me~'nOR de'ze.Zu Di mi a.Zus'taX, ne~'Ju~ 'se~.su Di le.aw'da.Di, ne~'Ju~ ob.Ze'Ti.vu Di 'fa.tu
Gosto dessa definição: abraço é o encontro de dois corações.	'gOs.tu 'dE.sa de.fi~.ni'sa~w~, a'bra.su E u e~'ko~.tru Di 'dojs ko.ra'so~j~s
Eu gosto de você, E gosto de ficar com você, Meu riso é tão feliz contigo O meu melhor amigo é o meu amor...	ew 'gOs.tu Di vo'se, i 'gOs.tu Di fi'kaX ko~ vo'se, 'mew 'Ri.zu E 'ta~w~ fe'lis ko~'Ti.gu u 'mew me'LOr a~'mi.gu E u 'mew a~'moX
Às vezes te odeio por quase um segundo depois te amo mais teus pelos, teu gosto, teu rosto, tudo tudo que não me deixa em paz	as 've.zis Ti o'dej.u puX 'kwa.zi u~ se'gu~.du de'pojs Ti 'a~.mu 'majs 'tews 'pe.lus, 'tew 'gos.tu, 'tew 'Ros.tu, 'tu.du 'tu.du ki 'na~w~ mi 'dej.Sa e~j~ 'pajs
Realmente, eu não gosto da natureza humana a menos que esteja toda temperada com arte.	Re.aw'me~.Ti, ew 'na~w~ 'gOs.tu da na.tu're.za u~'ma~.na a 'me~.nus ki es'te.Za 'to.da te~.pe'ra.da ko~ 'aX.Ti
Eu gosto de escutar. Eu aprendi muito escutando cuidadosamente. A maioria das pessoas nunca escuta.	ew 'gOs.tu Di es.ku'taX, ew a.pre~'Di 'mu~j~.tu es.ku'ta~.du kuj.da.dO.za~'me~.Ti, a maj.o'ri.a das pe'so.as 'nu~.ka es'ku.ta
Quando não gosto de um cara e ele me acha a misteriosa, me cai a ficha de como a gente é idiota quando tá do outro lado.	'kwa~.du 'na~w~ 'gOs.tu Di u~ 'ka.ra i 'e.li mi 'a.Sa a mis.te.ri'O.za, mi 'kaj a 'fi.Sa Di 'ko~.mu a 'Ze~.Ti E i.Di'O.ta 'kwa~.du 'ta du 'ow.tru 'la.du
Gosto da noite imensa, triste, preta, como esta estranha borboleta Que eu sinto sempre a voltejar em mim!...	'gOs.tu da 'noj.Ti i~'me~.sa, 'tris.Ti, 'pre.ta, 'ko~.mu 'Es.ta es'tra~.Ja boR.bo'le.ta ki ew 'si~.tu 'se~.pri a vow.te'Zar e~j~ 'mi~
Gosto de fazer as pessoas felizes, mesmo quando eu estou triste.	'gOs.tu Di fa'zer as pe'so.as fe'li.zis, 'mez.mu 'kwa~.du ew es'tow 'tris.Ti
Eu gosto de estar bem vestida ou inteiramente despida. Não me preocupo com o meio termo.	ew 'gOs.tu Di es'taR 'be~j~ ves'Ti.da ow i~.tej.ra~'me~.Ti des'pi.da, 'na~w~ mi prew'ku.pu ko~ u 'mej.u 'teR.mu
Gosto da minha solidão, mas você se surpreenderia com o tamanho dela.	'gOs.tu da 'mi~.Ja so.li'da~w~, majs vo'se si suX.pre.e~.de'ri.a ko~ u ta~'ma~.Ju 'dE.la
Não gosto desse passarinho. Não gosto de violão. Não gosto de nada que põe saudades na gente.	'na~w~ 'gOs.tu 'de.si pa.sa'ri~.Ju, 'na~w~ 'gOs.tu Di vi.o'la~w~, 'na~w~ 'gOs.tu Di 'na.da ki 'po~j~ saw'da.Dis na 'Ze~.Ti
A verdade é que eu sempre gosto das mulheres. Gosto da falta de convencionalismo delas. Gosto da integridade delas. Gosto do anonimato delas.	a veR'da.Di E ki ew 'se~.pri 'gOs.tu das mu'LE.ris, 'gOs.tu da 'faw.ta Di ko~.ve~.si.o~.na'liz.mu 'dE.las, 'gOs.tu da i~.te.gri'da.Di 'dE.las, 'gOs.tu du a~.no~.ni~'ma.tu 'dE.las
Eu gosto do sabor intenso das coisas desmedidas. Tudo que é bom, que eu viva em exagero! Mas não é que eu queira morrer de um jeito fulgás. O que eu quero é viver em êxtase!	ew 'gOs.tu du sa'bor i~'te~.su das 'koj.zas dez.me'Di.das, 'tu.du ki E 'bo~, ki ew 'vi.va e~j~ e.za'Ze.ru, majs 'na~w~ E ki ew 'kej.ra mo'ReR Di u~ 'Zej.tu fuw'gajs, u ki ew 'kE.ru E vi'ver e~j~ 'es.ta.zi
Eu gosto de você. Eu posso sentir isso. Então, por favor, não estrague e capriche e dê valor. Porque não é sempre e quase nunca. Então, por favor, olha só, eu G O S T O de você.	ew 'gOs.tu Di vo'se, ew 'pO.su se~'Tir 'i.su, e~'ta~w~, puX fa'voX, 'na~w~ es'tra.gi i ka'pri.Si i 'de va'loX, puX'ke 'na~w~ E 'se~.pri i 'kwa.zi 'nu~.ka, e~'ta~w~, puX fa'voX, 'O.La 'sO, ew 'ge 'O 'E.si 'te 'O Di vo'se
Pois minha imaginação não tem estrada. E eu não gosto mesmo da estrada. Gosto do desvio e do desver.	'pojs 'mi~.Ja i~.ma.Zi~.na'sa~w~ 'na~w~ te~j~ es'tra.da, i ew 'na~w~ 'gOs.tu 'mez.mu da es'tra.da, 'gOs.tu du dez'vi.u i du dez'veX
Gosto de viver. Algumas vezes me sinto muito, desesperadamente, loucamente miserável, atormentada pela aflição, mas mesmo diante disso tudo eu compreendo que estar viva é uma coisa grandiosa.	'gOs.tu Di vi'veX, aw'gu~.mas 've.zis mi 'si~.tu 'mu~j~.tu, de.zes.pe.ra.da~'me~.Ti, low.ka~'me~.Ti mi.ze'ra.vew, a.toR.me~'ta.da 'pe.la a.fli'sa~w~, majs 'mez.mu Di'a~.Ti 'Di.su 'tu.du ew ko~.pre'e~.du ki es'taR 'vi.va E u~.ma 'koj.za gra~.Di'O.za
Não é por nada que olho: é que eu gosto de ver as pessoas sendo.	'na~w~ E puR 'na.da ki 'O.Lu, E ki ew 'gOs.tu Di 'ver as pe'so.as 'se~.du
Posso relaxar com os imprestáveis, porque sou um imprestável. Não gosto de leis, morais, religiões, regras. Não gosto de ser moldado pela sociedade.	'pO.su Re.la'SaX ko~ uz i~.pres'ta.vejs, puX'ke 'sow u~ i~.pres'ta.vew, 'na~w~ 'gOs.tu Di 'lejs, mo'rajs, Re.li.Zi'o~j~s, 'RE.gras, 'na~w~ 'gOs.tu Di 'seR mow'da.du 'pe.la so.si.e'da.Di
Eu não sou tão forte como pareço. Eu não gosto de me sentir sozinha e eu sinto sua falta.	ew 'na~w~ 'sow 'ta~w~ 'fOX.Ti 'ko~.mu pa're.su, ew 'na~w~ 'gOs.tu Di mi se~'TiX sO'zi~.Ja i ew 'si~.tu 'su.a 'faw.ta
Mesmo a ausência dele é uma coisa que está comigo. E eu gosto tanto dele que não sei como o desejar.	'mez.mu a aw'ze~.sja 'de.li E u~.ma 'koj.za ki es'ta ko~'mi.gu, i ew 'gOs.tu 'ta~.tu 'de.li ki 'na~w~ 'sej 'ko~.mu u de.ze'ZaX
Confie na minha transparência. Sou eternamente explícita. Se não gosto, não faço charme. Doa a quem doer, minha sinceridade e bem-estar são colocados em primeiro lugar, não nego.	ko~'fi.i na 'mi~.Ja tra~s.pa're~.sja, 'sow e.tER.na~'me~.Ti es'pli.si.ta, si 'na~w~ 'gOs.tu, 'na~w~ 'fa.su 'SaR.mi, 'do.a a 'ke~j~ do'eX, 'mi~.Ja si~.se.ri'da.Di i 'be~j~ es'taX 'sa~w~ ko.lo'ka.duz e~j~ pri~'mej.ru lu'gaX, 'na~w~ 'nE.gu
Eu nunca gosto de nada e gostei tanto de você.	ew 'nu~.ka 'gOs.tu Di 'na.da i gos'tej 'ta~.tu Di vo'se
Não vou a praia para ficar morena, gosto de ser loira.	'na~w~ 'vow a 'praj.a 'pa.ra fi'kaR mo're~.na, 'gOs.tu Di 'seR 'loj.ra
Não me diga como devo ser, gosto do jeito que sou. Quem insiste em julgar os outros sempre tem alguma coisa para esconder.	'na~w~ mi 'Di.ga 'ko~.mu 'de.vu 'seX, 'gOs.tu du 'Zej.tu ki 'sow, 'ke~j~ i~'sis.Ti e~j~ Zuw'gar uz 'ow.trus 'se~.pri te~j~ aw'gu~.ma 'koj.za 'pa.ra es.ko~'deX
Você é o cara que, quando foi embora, me deixou sentindo uma dor bem enorme, mas eu gosto de você, você não fez por mal. Seu mal nunca foi por mal.	vo'se E u 'ka.ra ki, 'kwa~.du 'foj e~'bO.ra, mi dej'Sow se~'Ti~.du u~.ma 'doR 'be~j~ e~'nOR.mi, majz ew 'gOs.tu Di vo'se, vo'se 'na~w~ 'fejs puR 'maw, 'sew 'maw 'nu~.ka 'foj puR 'maw
Não gosto nada de saber o que dizem de mim nas minhas costas. Faz com que eu fique convencido demais.	'na~w~ 'gOs.tu 'na.da Di sa'ber u ki 'Di.ze~j~ Di 'mi~ nas 'mi~.Jas 'kOs.tas, 'fajs ko~ ki ew 'fi.ki ko~.ve~'si.du de~'majs
Eram tão raros os nossos momentos e sempre eram bons. Gosto tanto de lembrar tudo o que vivemos.	'E.ra~w~ 'ta~w~ 'Ra.ruz us 'nO.sus mo~'me~.tuz i 'se~.pri 'E.ra~w~ 'bo~s, 'gOs.tu 'ta~.tu Di le~'braX 'tu.du u ki vi've~.mus
Quem é firme em seus propósitos molda o mundo a seu gosto.	'ke~j~ E 'fiR.mi e~j~ 'sews pro'pO.zi.tus 'mOw.da u 'mu~.du a 'sew 'gos.tu
Adoro sua voz. E da sua mão quente e do seu beijo calminho e intenso. Eu não gosto nunca de nada e gostei tanto de você.	a'dO.ru 'su.a 'vOjs, i da 'su.a 'ma~w~ 'ke~.Ti i du 'sew 'bej.Zu kaw'mi~.Ju i i~'te~.su, ew 'na~w~ 'gOs.tu 'nu~.ka Di 'na.da i gos'tej 'ta~.tu Di vo'se
Não morreria por nada deste mundo, Porque eu gosto realmente é de viver. Nem de amores eu morreria, Porque eu gosto mesmo é de viver de amores.	'na~w~ mo.Re'ri.a puR 'na.da 'des.Ti 'mu~.du, puX'ke ew 'gOs.tu Re.aw'me~.Ti E Di vi'veX, ne~j~ Di a~'mo.riz ew mo.Re'ri.a, puX'ke ew 'gOs.tu 'mez.mu E Di vi'veR Di a~'mo.ris
Eu sou criança. E vou crescer assim. Gosto de abraçar apertado, sentir alegria inteira, inventar mundos, inventar amores. O simples me faz rir, o complicado me aborrece.	ew 'sow kri'a~.sa, i 'vow kre'ser a'si~, 'gOs.tu Di a.bra'sar a.peX'ta.du, se~'Tir a.le'gri.a i~'tej.ra, i~.ve~'taR 'mu~.dus, i~.ve~'tar a~'mo.ris, u 'si~.plis mi 'fajz 'RiX, u ko~.pli'ka.du mi a.bo'RE.si
Sempre fui atraído pelas ideias contra a autoridade. Gosto das ideias referentes á quebra do sistema e do destronamento da ordem estabelecida.	'se~.pri 'fuj a.tra'i.du 'pe.laz i'dEj.as 'ko~.tra a aw.to.ri'da.Di, 'gOs.tu daz i'dEj.as Re.fe're~.Tiz a 'kE.bra du sis'te~.ma i du des.tro~.na~'me~.tu da 'OR.de~j~ es.ta.be.le'si.da
Gosto de ver um homem orgulhar-se do lugar onde vive. Gosto de ver um homem viver, de modo que seu lugar se orgulhe dele.	'gOs.tu Di 'ver u~ 'o~.me~j~ oR.gu'LaX si du lu'gar 'o~.Di 'vi.vi, 'gOs.tu Di 'ver u~ 'o~.me~j~ vi'veX, Di 'mO.du ki 'sew lu'gaX si oR'gu.Li 'de.li
Gosto de viajar por palavras do que de trem.	'gOs.tu Di vi.a'ZaX puX pa'la.vras du ki Di 'tre~j~
Ando sentindo umas coisas que não entendo direito. Não gosto de não entender o que sinto. Não gosto de lidar com o que não conheço.	'a~.du se~'Ti~.du u~.mas 'koj.zas ki 'na~w~ e~'te~.du Di'rej.tu, 'na~w~ 'gOs.tu Di 'na~w~ e~.te~'der u ki 'si~.tu, 'na~w~ 'gOs.tu Di li'daX ko~ u ki 'na~w~ ko~'Je.su
Não gosto de nada que é raso, de água pela canela. Ou eu mergulho até encontrar o reino submerso de Atlântida, ou fico à margem, espiando de fora.	'na~w~ 'gOs.tu Di 'na.da ki E 'Ra.zu, Di 'a.gwa 'pe.la ka~'nE.la, ow ew meR'gu.Lu a'tE e~.ko~'trar u 'Rej.nu sub'mEX.su Di a'tla~.Ti.da, ow 'fi.ku a 'maR.Ze~j~, es.pi'a~.du Di 'fO.ra
Não gosto é quando pingam limão nas  minhas profundezas e fazem com que eu me contorça toda.	'na~w~ 'gOs.tu E 'kwa~.du 'pi~.ga~w~ li~'ma~w~ nas 'mi~.Jas pro.fu~'de.zaz i 'fa.ze~j~ ko~ ki ew mi ko~'toX.sa 'to.da
Bom dia, poetas velhos. Me deixem na boca o gosto dos versos mais fortes que não farei. Dia vai vir que os saiba tão bem que vos cite como quem tê-los um tanto feito também, acredite.	'bo~ 'Di.a, po'E.tas 'vE.Lus, mi 'dej.Se~j~ na 'bo.ka u 'gos.tu dus 'vEX.sus 'majs 'fOX.Tis ki 'na~w~ fa'rej, 'Di.a 'vaj 'viX ki us 'saj.ba 'ta~w~ 'be~j~ ki vus 'si.Ti 'ko~.mu 'ke~j~ 'te luz u~ 'ta~.tu 'fej.tu ta~'be~j~, a.kre'Di.Ti
Nem de amores eu morreria porque eu gosto mesmo é de viver deles.	ne~j~ Di a~'mo.riz ew mo.Re'ri.a puX'ke ew 'gOs.tu 'mez.mu E Di vi'veR 'de.lis
Eu gosto de estar sozinho, mas não gosto de me sentir sozinho. Isso é tão difícil de entender?	ew 'gOs.tu Di es'taX sO'zi~.Ju, majs 'na~w~ 'gOs.tu Di mi se~'TiX sO'zi~.Ju, 'i.su E 'ta~w~ Di'fi.siw Di e~.te~'deX
Não sou idiota, faço graça porque gosto de ver as pessoas sorrindo.	'na~w~ 'sow i.Di'O.ta, 'fa.su 'gra.sa puX'ke 'gOs.tu Di 'ver as pe'so.as so'Ri~.du
Desculpe tanta sede, tanta insatisfação. Amanhã, amanhã recomeço. Te espero, te gosto, te beijo.	des'kuw.pi 'ta~.ta 'se.Di, 'ta~.ta i~.sa.Tis.fa'sa~w~, a~.ma~'Ja~, a~.ma~'Ja~ Re.ko~'mE.su, Ti es'pE.ru, Ti 'gOs.tu, Ti 'bej.Zu
Gosto de ouvir. Aprendi muita coisa por ouvir cuidadosamente. A maioria das pessoas nunca ouve.	'gOs.tu Di ow'viX, a.pre~'Di 'mu~j~.ta 'koj.za pur ow'viX kuj.da.dO.za~'me~.Ti, a maj.o'ri.a das pe'so.as 'nu~.ka 'ow.vi
As pessoas me perguntam por que eu escrevo coisas tão brutas. Gosto de dizer que tenho um coração de menino - está guardado num vidro em cima da minha escrivaninha.	as pe'so.as mi peR'gu~.ta~w~ puX 'ke ew es'kre.vu 'koj.zas 'ta~w~ 'bru.tas, 'gOs.tu Di Di'zeX ki 'te~.Ju u~ ko.ra'sa~w~ Di me~'ni~.nu, es'ta gwaR'da.du nu~ 'vi.dru e~j~ 'si~.ma da 'mi~.Ja es.kri.va~'ni~.Ja
A coisa que eu mais odeio no mundo é falsidade, tipo ficar rindo para quem eu não gosto ou dando explicações para as pessoas. Elas que se danem.	a 'koj.za ki ew 'majz o'dej.u nu 'mu~.du E faw.si'da.Di, 'Ti.pu fi'ka'Ri~.du 'pa.ra 'ke~j~ ew 'na~w~ 'gOs.tu ow 'da~.du es.pli.ka'so~j~s 'pa.ra as pe'so.as, 'E.las ki si 'da~.ne~j~
Sou carente, gosto de carinho, de saber que as pessoas se importam comigo e principalmente, de alguém que me mostre que tudo vai ficar bem.	'sow ka're~.Ti, 'gOs.tu Di ka'ri~.Ju, Di sa'beX ki as pe'so.as si i~'pOX.ta~w~ ko~'mi.gu i pri~.si.paw'me~.Ti, Di aw'ge~j~ ki mi 'mOs.tri ki 'tu.du 'vaj fi'kaR 'be~j~
Por muito que se recuse deixa sempre algum gosto a paixão que a gente inspira.	puR 'mu~j~.tu ki si Re'ku.zi 'dej.Sa 'se~.pri aw'gu~ 'gos.tu a paj'Sa~w~ ki a 'Ze~.Ti i~s'pi.ra
O importante, o irreversível, o definitivo, o claro nessa história toda é que eu gosto muito de ti.	u i~.poX'ta~.Ti, u i.Re.veX'si.vew, u de.fi~.ni'Ti.vu, u 'kla.ru 'nE.sa is'tO.rja 'to.da E ki ew 'gOs.tu 'mu~j~.tu Di 'Ti
Dessa vez quero acertar, por isso, combinei comigo que apesar de estar morrendo por você, não gosto de você.	'dE.sa 'vejs 'kE.ru a.seX'taX, pur 'i.su, ko~.bi~'nej ko~'mi.gu ki a.pe'zaR Di es'taR mo'Re~.du puR vo'se, 'na~w~ 'gOs.tu Di vo'se
Todo prazer sentido com gosto parece-me casto.	'to.du pra'zeX se~'Ti.du ko~ 'gos.tu pa'rE.si mi 'kas.tu
Gosto da forma como você acelera meu coração, e de quando você o acalma também.	'gOs.tu da 'fOR.ma 'ko~.mu vo'se a.se'lE.ra 'mew ko.ra'sa~w~, i Di 'kwa~.du vo'se u a'kaw.ma ta~'be~j~
O que eu gosto do sucesso é saber que tenho tantos amigos. Um monte de amigos intimos mesmo que conheci desde que entrei para o show business.	u ki ew 'gOs.tu du su'sE.su E sa'beX ki 'te~.Ju 'ta~.tuz a~'mi.gus, u~ 'mo~.Ti Di a~'mi.guz i~'Ti~.mus 'mez.mu ki ko~.Je'si 'dez.Di ki e~'trej 'pa.ra u 'Sow 'biz.nes
Sou um homem quieto, o que eu gosto é ficar num banco sentado, entre moitas, calado, anoitecendo devagar, meio triste, lembrando umas coisas, umas coisas que nem valiam a pena lembrar.	'sow u~ 'o~.me~j~ ki'E.tu, u ki ew 'gOs.tu E fi'kaR nu~ 'ba~.ku se~'ta.du, 'e~.tri 'moj.tas, ka'la.du, a~.noj.te'se~.du de.va'gaX, 'mej.u 'tris.Ti, le~'bra~.du u~.mas 'koj.zas, u~.mas 'koj.zas ki ne~j~ va'li.a~w~ a 'pe~.na le~'braX
Gosto daquela sensação de frio na barriga, ainda mais quando é causado por você.	'gOs.tu da'kE.la se~.sa'sa~w~ Di 'fri.u na ba'Ri.ga, a'i~.da 'majs 'kwa~.du E kaw'za.du puR vo'se
Todo o luxo corrompe, ou os hábitos ou o gosto.	'to.du u 'lu.Su ko'Ro~.pi, ow uz 'a.bi.tuz ow u 'gos.tu
Bom gosto é melhor que mau gosto, mas mau gosto é melhor que gosto nenhum.	'bo~ 'gos.tu E me'LOX ki 'maw 'gos.tu, majs 'maw 'gos.tu E me'LOX ki 'gos.tu ne~'Ju~
Quando mais gosto das mulheres, é quando beijam, porque então têm de estar caladas.	'kwa~.du 'majs 'gOs.tu das mu'LE.ris, E 'kwa~.du 'bej.Za~w~, puX'ke e~'ta~w~ 'te~j~ Di es'taX ka'la.das
Quanto mais gosto de quem ofende, mais sinto a ofensa.	'kwa~.tu 'majs 'gOs.tu Di 'ke~j~ o'fe~.Di, 'majs 'si~.tu a o'fe~.sa
O apetite do privilégio e o gosto da igualdade, eis as paixões dominantes e contraditórias dos franceses em todas as épocas.	u a.pe'Ti.Ti du pri.vi'lE.Zju i u 'gos.tu da i.gwaw'da.Di, 'ejz as paj'So~j~s do~.mi~'na~.Tiz i ko~.tra.Di'tO.rjas dus fra~'se.ziz e~j~ 'to.daz az 'E.po.kas
A vida parece-nos curta, e as horas parecem-nos compridas; o nosso gosto seria alongar a cadeia, encurtando os anéis.	a 'vi.da pa'rE.si nus 'kuX.ta, i az 'O.ras pa'rE.se~j~ nus ko~'pri.das, u 'nO.su 'gos.tu se'ri.a a.lo~'gar a ka'dej.a, e~.kuX'ta~.du uz a~'nEjs
O bom gosto é a capacidade de reagir continuamente contra o exagero.	u 'bo~ 'gos.tu E a ka.pa.si'da.Di Di Re.a'ZiX ko~.Ti~.nu.a~'me~.Ti 'ko~.tra u e.za'Ze.ru
Um homem que tenha rido com gosto ao menos uma vez na vida não pode ser de todo irremediavelmente ruim.	u~ 'o~.me~j~ ki 'te~.Ja 'Ri.du ko~ 'gos.tu aw 'me~.nuz u~.ma 'vejz na 'vi.da 'na~w~ 'pO.Di 'seR Di 'to.du i.Re~.me.Di.a.vew'me~.Ti Ru'i~
Quem com gosto aceita presentes perde a liberdade.	'ke~j~ ko~ 'gos.tu a'sej.ta pre'ze~.Tis 'pER.Di a li.beR'da.Di
O gosto de contentar um amigo é um demónio tentador.	u 'gos.tu Di ko~.te~'tar u~ a~'mi.gu E u~ de~'mo~.nju te~.ta'doX
Existe sempre uma grande demanda por novas mediocridades. Em todas as gerações, o gosto menos desenvolvido tem o maior apetite.	e'zis.Ti 'se~.pri u~.ma 'gra~.Di de~'ma~.da puR 'nO.vas me.Di.o.kri'da.Dis, e~j~ 'to.daz a.Ze.ra'so~j~s, u 'gos.tu 'me~.nus de.ze~.vow'vi.du te~j~ u maj'Or a.pe'Ti.Ti
O bom gosto é a flor do bom senso.	u 'bo~ 'gos.tu E a 'floR du 'bo~ 'se~.su
Cada qual tem um gosto que o arrasta.	'ka.da 'kwaw te~j~ u~ 'gos.tu ki u a'Ras.ta
Não gosto dos homens, gosto do que os devora.	'na~w~ 'gOs.tu duz 'o~.me~s, 'gOs.tu du ki us de'vO.ra
O que não tem mais vontade nem mais gosto do que a vontade e o gosto alheios, pode ser tido como verdadeiro escravo.	u ki 'na~w~ te~j~ 'majs vo~'ta.Di ne~j~ 'majs 'gos.tu du ki a vo~'ta.Di i u 'gos.tu a'Lej.us, 'pO.Di 'seX 'Ti.du 'ko~.mu veR.da'dej.ru es'kra.vu
Gosto de mais das pessoas para me repugnar fazer-lhes mal, e julgá-las é já fazer-lhes mal.	'gOs.tu Di 'majs das pe'so.as 'pa.ra mi Re.pu.gi~'naX fa'zeX Lis 'maw, i Zuw'ga laz E 'Za fa'zeX Lis 'maw
do orvalho nunca esqueça o branco gosto solitário	du oR'va.Lu 'nu~.ka es'ke.sa u 'bra~.ku 'gos.tu so.li'ta.rju
Gosto que me leiam e saibam o que acho das coisas. É uma forma de existir. Trabalho é a melhor maneira de escapar da realidade.	'gos.tu ki mi 'lej.a~w~ i 'saj.ba~w~ u ki 'a.Su das 'koj.zas, E u~.ma 'fOR.ma Di e.zis'TiX, tra'ba.Lu E a me'LOR ma~'nej.ra Di es.ka'paR da Re.a.li'da.Di
Gosto de saber que meus livros estão em suas mãos.	'gOs.tu Di sa'beX ki 'mews 'li.vruz es'ta~w~ e~j~ 'su.as 'ma~w~s
Ser tricolor não é uma questão de gosto ou opção, mas um acontecimento de fundo metafísico, um arranjo cósmico ao qual não se pode - e nem se deseja - fugir.	'seX tri.ko'loR 'na~w~ E u~.ma kes'ta~w~ Di 'gos.tu ow op'sa~w~, majz u~ a.ko~.te.si~'me~.tu Di 'fu~.du mE.ta'fi.zi.ku, u~ a'Ra~.Zu 'kOz.mi.ku aw 'kwaw 'na~w~ si 'pO.Di, i ne~j~ si de'ze.Za, fu'ZiX
Eu só gosto das pessoas que eu mando embora. E eu só amo as que vão.	ew 'sO 'gOs.tu das pe'so.as ki ew 'ma~.du e~'bO.ra, i ew 'sO 'a~.mu as ki 'va~w~
E eu gosto de você porque gostar não faz sentido.	i ew 'gOs.tu Di vo'se puX'ke gos'taR 'na~w~ 'fajs se~'Ti.du
Gosto da sua risada. E eu gosto que você me faça rir. Como se fosse a primeira vez.	'gOs.tu da 'su.a Ri'za.da, i ew 'gOs.tu ki vo'se mi 'fa.sa 'RiX, 'ko~.mu si 'fo.si a pri~'mej.ra 'vejs
Nem bonito, nem rico, nem sarado. Eu gosto mesmo é de gente com coração e sentimentos.	ne~j~ bo~'ni.tu, ne~j~ 'Ri.ku, ne~j~ sa'ra.du, ew 'gOs.tu 'mez.mu E Di 'Ze~.Ti ko~ ko.ra'sa~w~ i se~.Ti~'me~.tus
Gosto de pessoas estúpidas e idiotas - elas me fazem rir :)	'gOs.tu Di pe'so.az es'tu.pi.daz i i.Di'O.tas, 'E.las mi 'fa.ze~j~ 'RiX
E eu te espero. E te curto todos os dias. E te gosto. Muito.	i ew Ti es'pE.ru, i Ti 'kuX.tu 'to.duz us 'Di.as, i Ti 'gOs.tu, 'mu~j~.tu
Eu gosto de você. Eu estou meio bêbado. Estou ficando completamente torto. Me dá uma chance. E parecia verdadeiro, pequenino e desamparado, repetindo: Eu gosto de você, eu gosto tanto de você.	ew 'gOs.tu Di vo'se, ew es'tow 'mej.u 'be.ba.du, es'tow fi'ka~.du ko~.plE.ta~'me~.Ti 'toX.tu, mi 'da u~.ma 'Sa~.si, i pa.re'si.a veR.da'dej.ru, pe.ke~'ni~.nu i de.za~.pa'ra.du, Re.pe'Ti~.du, ew 'gOs.tu Di vo'se, ew 'gOs.tu 'ta~.tu Di vo'se
Pra falar a verdade, eu gosto de quando você me provoca e gosto até dos seus ciúmes.	pra fa'lar a veR'da.Di, ew 'gOs.tu Di 'kwa~.du vo'se mi pro'vO.ka i 'gOs.tu a'tE dus 'sews si'u~.mis
Vou perder o resto do medo do mau gosto, vou começar meu exercício de coragem, viver não é coragem, saber que se vive é a coragem.	'vow peR'der u 'REs.tu du 'me.du du 'maw 'gos.tu, 'vow ko~.me'saR 'mew e.zeX'si.sju Di ko'ra.Ze~j~, vi'veR 'na~w~ E ko'ra.Ze~j~, sa'beX ki si 'vi.vi E a ko'ra.Ze~j~
Sorriram um para o outro. E tudo estava certo, outra vez, e tudo tinha um gosto bom.	so'Ri.ra~w~ 'u~ 'pa.ra u 'ow.tru, i 'tu.du es'ta.va 'sEX.tu, 'ow.tra 'vejs, i 'tu.du 'Ti~.Ja u~ 'gos.tu 'bo~
Eu gosto de rotina.	ew 'gOs.tu Di Ro'Ti~.na
Sou desastrada, não tenho o corpo perfeito, gosto rápido das pessoas, meu cabelo é bagunçado, mas tento ser forte.	'sow de.zas'tra.da, 'na~w~ 'te~.Ju u 'koX.pu peX'fej.tu, 'gOs.tu 'Ra.pi.du das pe'so.as, 'mew ka'be.lu E ba.gu~'sa.du, majs 'te~.tu 'seX 'fOX.Ti
Eu confio na minha beleza. Eu não confio é no bom gosto dos outros.	ew ko~'fi.u na 'mi~.Ja be'le.za, ew 'na~w~ ko~'fi.u E nu 'bo~ 'gos.tu duz 'ow.trus
Gosto de pensar assim: se a gente faz o que manda o coração, lá na frente, tudo se explica. Por isso, faço a minha sorte. Sou fiel ao que sinto.	'gOs.tu Di pe~'sar a'si~, si a 'Ze~.Ti 'fajz u ki 'ma~.da u ko.ra'sa~w~, 'la na 'fre~.Ti, 'tu.du si es'pli.ka, pur 'i.su, 'fa.su a 'mi~.Ja 'sOX.Ti, 'sow fi'Ew aw ki 'si~.tu
Eu não gosto nunca de nada, e gostei tanto de você.	ew 'na~w~ 'gOs.tu 'nu~.ka Di 'na.da, i gos'tej 'ta~.tu Di vo'se
Entenda, não é porque não gosto de você, que te considero inimiga. Mesmo porque até pra ser minha inimiga, tem que ter capacidade !	e~'te~.da, 'na~w~ E puX'ke 'na~w~ 'gOs.tu Di vo'se, ki Ti ko~.si'dE.ru i~.ni~'mi.ga, 'mez.mu puX'ke a'tE pra 'seR 'mi~.Ja i~.ni~'mi.ga, te~j~ ki 'teX ka.pa.si'da.Di
É impressionante como eu não gosto de ninguém mas, de vez em quando, escapa um momento, um gesto, uma pessoa perdida e linda e única	E i~.pre.si.o~'na~.Ti 'ko~.mu ew 'na~w~ 'gOs.tu Di ni~'ge~j~ majs, Di 'vejz e~j~ 'kwa~.du, es'ka.pa u~ mo~'me~.tu, u~ 'ZEs.tu, u~.ma pe'so.a peR'Di.da i 'li~.da i 'u~.ni.ka
Todo mundo tem um lado bonito. Eu gosto disso.	'to.du 'mu~.du te~j~ u~ 'la.du bo~'ni.tu, ew 'gOs.tu 'Di.su
Quem dera um esforço de conscientização resolvesse o assunto: não gosto mais dele, não quero mais saber daquele prepotente, desapareça, um, dois e já.	'ke~j~ 'dE.ra u~ es'foX.su Di ko~.si.e~.Ti.za'sa~w~ Re.zow've.si u a'su~.tu, 'na~w~ 'gOs.tu 'majs 'de.li, 'na~w~ 'kE.ru 'majs sa'beR da'ke.li pre.po'te~.Ti, de.za.pa're.sa, 'u~, 'dojz i 'Za
Eu não gosto de ficar em casa, é chato.	ew 'na~w~ 'gOs.tu Di fi'kar e~j~ 'ka.za, E 'Sa.tu
Eu só quero que as pessoas que eu gosto muito, mas muito mesmo, sejam muito felizes porque isso me dá uma paz danada.	ew 'sO 'kE.ru ki as pe'so.as ki ew 'gOs.tu 'mu~j~.tu, majs 'mu~j~.tu 'mez.mu, 'se.Za~w~ 'mu~j~.tu fe'li.zis puX'ke 'i.su mi 'da u~.ma 'pajz da~'na.da
Gosto de caras que não fazem promessas, que não dizem o que estão sentindo antes de realmente ter certeza disso.	'gOs.tu Di 'ka.ras ki 'na~w~ 'fa.ze~j~ pro~'mE.sas, ki 'na~w~ 'Di.ze~j~ u ki es'ta~w~ se~'Ti~.du 'a~.Tis Di Re.aw'me~.Ti 'teX seX'te.za 'Di.su
Não adoro nem venero, mas gosto na medida sadia e humana em que uma pessoa pode gostar de outra. O resto é detalhe.	'na~w~ a'dO.ru ne~j~ ve~'nE.ru, majs 'gOs.tu na me'Di.da sa'Di.a i u~'ma~.na e~j~ ki u~.ma pe'so.a 'pO.Di gos'taR Di 'ow.tra, u 'REs.tu E de'ta.Li
Ando sentindo umas coisas que não entendo direito. Não gosto de não entender o que sinto.	'a~.du se~'Ti~.du u~.mas 'koj.zas ki 'na~w~ e~'te~.du Di'rej.tu, 'na~w~ 'gOs.tu Di 'na~w~ e~.te~'der u ki 'si~.tu
Tenho gostos extremamente simples: somente o melhor me satisfaz.	'te~.Ju 'gOs.tuz es.tre~.ma~'me~.Ti 'si~.plis, sO~'me~.Ti u me'LOR mi sa.Tis'fajs
Das lembranças que gosto de ter, e as trago em minha vida, você é uma saudade que gosto de lembrar...	das le~'bra~.sas ki 'gOs.tu Di 'teX, i as 'tra.gu e~j~ 'mi~.Ja 'vi.da, vo'se E u~.ma saw'da.Di ki 'gOs.tu Di le~'braX
Eu gosto do impossível porque lá a concorrência é menor.	ew 'gOs.tu du i~.po'si.vew puX'ke 'la a ko~.ko'Re~.sja E me~'nOX
Eu gosto de viver. Já me senti ferozmente, desesperadamente, agudamente feliz, dilacerada pelo sofrimento, mas através de tudo ainda sei, com absoluta certeza, que estar viva é sensacional.	ew 'gOs.tu Di vi'veX, 'Za mi se~'Ti fe.rOz'me~.Ti, de.zes.pe.ra.da~'me~.Ti, a.gu.da~'me~.Ti fe'lis, Di.la.se'ra.da 'pe.lu so.fri~'me~.tu, majz a.tra'vEjs Di 'tu.du a'i~.da 'sej, ko~ ab.so'lu.ta seX'te.za, ki es'taR 'vi.va E se~.sa.si.o~'naw
Você se foi e eu afundei numa melancolia de dar gosto.	vo'se si 'foj i ew a.fu~'dej 'nu~.ma me.la~.ko'li.a Di 'daR 'gos.tu
Eu gosto da noite. Sem a escuridão, não poderíamos ver as estrelas.	ew 'gOs.tu da 'noj.Ti, se~j~ a es.ku.ri'da~w~, 'na~w~ po.de'ri.a~.mus 'ver az es'tre.las
Gosto de pessoas e amores inteiros. Porque não sei me dar pela metade nem por partes. Eu transbordo. E se você também for do time que transborda, vem pra cá.	'gOs.tu Di pe'so.az i a~'mo.riz i~'tej.rus, puX'ke 'na~w~ 'sej mi 'daX 'pe.la me'ta.Di ne~j~ puX 'paX.Tis, ew tra~z'bOR.du, i si vo'se ta~'be~j~ 'foR du 'Ti~.mi ki tra~z'bOR.da, 've~j~ pra 'ka
Porque uso óculos escuros? É porque não gosto de ter alguém dentro dos meus olhos, e uma maneira de guardar um pouquinho de mim.	puX'ke 'u.zu 'O.ku.luz es'ku.rus, E puX'ke 'na~w~ 'gOs.tu Di 'ter aw'ge~j~ 'de~.tru dus 'mewz 'O.Lus, i u~.ma ma~'nej.ra Di gwaR'dar u~ pow'ki~.Ju Di 'mi~
Ou talvez eu só precise de férias, um porre e um novo amor. Eu gosto de gostos, eu gosto de pele, de cheiro, de amor verdadeiro.	ow taw'vejz ew 'sO pre'si.zi Di 'fE.rjas, u~ 'pO.Ri i u~ 'no.vu a~'moX, ew 'gOs.tu Di 'gos.tus, ew 'gOs.tu Di 'pE.li, Di 'Sej.ru, Di a~'moR veR.da'dej.ru
Não acredito em destino. Porque não gosto da idéia de não poder controlar minha vida.	'na~w~ a.kre'Di.tu e~j~ des'Ti~.nu, puX'ke 'na~w~ 'gOs.tu da i'dEj.a Di 'na~w~ po'deX ko~.tro'laR 'mi~.Ja 'vi.da
A honra e a moral deles são uma piada de mau gosto.	a 'o~.Ra i a mo'raw 'de.lis 'sa~w~ u~.ma pi'a.da Di 'maw 'gos.tu
Gosto de pessoas doces, gosto de situações claras;  e por tudo isso, ando cada vez mais só...	'gOs.tu Di pe'so.as 'do.sis, 'gOs.tu Di si.tu.a'so~j~s 'kla.ras, i puX 'tu.du 'i.su, 'a~.du 'ka.da 'vejz 'majs 'sO
Gosto sempre do mistério, mas gosto mais da verdade.	'gOs.tu 'se~.pri du mis'tE.rju, majs 'gOs.tu 'majs da veR'da.Di
Sou insuportável e prefiro não me apegar. Mas se por acaso um dia eu te disser que gosto de alguém, serão as palavras mais sinceras que você terá escutado.	'sow i~.su.poX'ta.vew i pre'fi.ru 'na~w~ mi a.pe'gaX, majs si pur a'ka.zu u~ 'Di.a ew Ti Di'sEX ki 'gOs.tu Di aw'ge~j~, se'ra~w~ as pa'la.vras 'majs si~'sE.ras ki vo'se te'ra es.ku'ta.du
A lembrança tem gosto doce porque a memória tem mania de esquecimento.	a le~'bra~.sa te~j~ 'gos.tu 'do.si puX'ke a me~'mO.rja te~j~ ma~'ni.a Di es.ke.si~'me~.tu
Acordar na manhã seguinte com gosto de corrimão de escada na boca: mais frustração que ressaca, desgosto generalizado que aspirina alguma cura.	a.koR'daR na ma~'Ja~ se'gi~.Ti ko~ 'gos.tu Di ko.Ri~'ma~w~ Di es'ka.da na 'bo.ka, 'majs frus.tra'sa~w~ ki Re'sa.ka, dez'gos.tu Ze~.ne.ra.li'za.du ki as.pi'ri~.na aw'gu~.ma 'ku.ra
Nessa horas de silêncio. de tristeza e de amor, Eu gosto de ouvir ao longe, cheio de mágoa e de dor, o sino do companaro que fala tão alto solitário com esse som mortuário que nos enche de pavor.	'nE.sa 'O.ras Di si'le~.sju, Di tris'te.za i Di a~'moX, ew 'gOs.tu Di ow'vir aw 'lo~.Zi, 'Sej.u Di 'ma.gwa i Di 'doX, u 'si~.nu du ko~.pa~'na.ru ki 'fa.la 'ta~w~ 'aw.tu so.li'ta.rju ko~ 'e.si 'so~ moX.tu'a.rju ki nuz 'e~.Si Di pa'voX
Tudo o que gosto tem sabor de pecado, é feio, censurado, imoral, fora da Lei, engorda e faz mal pra saúde...	'tu.du u ki 'gos.tu te~j~ sa'boR Di pe'ka.du, E 'fej.u, se~.su'ra.du, i~.mo'raw, 'fO.ra da 'lej, e~'gOR.da i 'fajz 'maw pra sa'u.Di
Ah! Meu pedacinho de gente, meu amor, como eu gosto de ouir esse riso! Pois é ele o meu presente.	'a, 'mew pe.da'si~.Ju Di 'Ze~.Ti, 'mew a~'moX, 'ko~.mu ew 'gOs.tu Di ow'vir 'e.si 'Ri.zu, 'pojz E 'e.li u 'mew pre'ze~.Ti
Sou avessa a equações, fórmulas e respostas certas. Não gosto de nada definido. Certezas não me calam.	'sow a've.sa a e.kwa'so~j~s, 'fOR.mu.laz i Res'pOs.tas 'sEX.tas, 'na~w~ 'gOs.tu Di 'na.da de.fi~'ni.du, seX'te.zas 'na~w~ mi 'ka.la~w~
Algumas mulheres são feitas, mas eu, eu mesma, gosto de pensar que fui criada por um propósito especial.	aw'gu~.mas mu'LE.ris 'sa~w~ 'fej.tas, majz ew, ew 'mez.ma, 'gOs.tu Di pe~'saX ki 'fuj kri'a.da pur u~ pro'pO.zi.tu es.pe.si'aw
Um abraço apertado, Um beijo no rosto, A vontade infinita De sentir o teu gosto. O carinho , a carícia O toque o desejo, E no olhar a malícia de quem quer outro beijo.	u~ a'bra.su a.peX'ta.du, u~ 'bej.Zu nu 'Ros.tu, a vo~'ta.Di i~.fi~'ni.ta Di se~'Tir u 'tew 'gos.tu, u ka'ri~.Ju, a ka'ri.sja u 'tO.ki u de'ze.Zu, i nu o'Lar a ma'li.sja Di 'ke~j~ 'kEr 'ow.tru 'bej.Zu
Gosto de perceber que as dores são cada vez mais rapidamente superadas.	'gOs.tu Di peX.se'beX ki as 'do.ris 'sa~w~ 'ka.da 'vejz 'majs Ra.pi.da~'me~.Ti su.pe'ra.das
Vários eu gosto, alguns eu amo. Muitos, eu só aturo. E olhe lá.	'va.rjuz ew 'gOs.tu, aw'gu~z ew 'a~.mu, 'mu~j~.tus, ew 'sO a'tu.ru, i 'O.Li 'la
Não gosto de ficar de mãos dadas, eu gosto de abraços.	'na~w~ 'gOs.tu Di fi'kaR Di 'ma~w~s 'da.das, ew 'gOs.tu Di a'bra.sus
Bem no fundo, há coisas que são só minhas. E embora me assustem às vezes, é delas que mais gosto.	'be~j~ nu 'fu~.du, 'a 'koj.zas ki 'sa~w~ 'sO 'mi~.Jas, i e~'bO.ra mi a'sus.te~j~ as 've.zis, E 'dE.las ki 'majs 'gos.tu
Eu não gosto daquele homem. Eu preciso conhecê-lo melhor.	ew 'na~w~ 'gOs.tu da'ke.li 'o~.me~j~, ew pre'si.zu ko~.Je'se lu me'LOX
Muito bem cérebro, eu não gosto de você e você também não gosta de mim! Vamos fazer logo esse teste que eu voltarei a te encher de cerveja!	'mu~j~.tu 'be~j~ 'sE.re.bru, ew 'na~w~ 'gOs.tu Di vo'se i vo'se ta~'be~j~ 'na~w~ 'gOs.ta Di 'mi~, 'va~.mus fa'zeR 'lO.gu 'e.si 'tEs.Ti ki ew vow.ta'rej a Ti e~'SeR Di seR've.Za
Quero ficar só. Gosto muito das pessoas, mas às vezes tenho essa necessidade voraz de me libertar de todos.	'kE.ru fi'kaX 'sO, 'gOs.tu 'mu~j~.tu das pe'so.as, majz as 've.zis 'te~.Ju 'E.sa ne.se.si'da.Di vo'rajz Di mi li.beX'taR Di 'to.dus
Gosto de dar carinho mais do que de receber. Presenteio sem datas especiais. Minha motivação é sempre um sorriso.	'gOs.tu Di 'daX ka'ri~.Ju 'majs du ki Di Re.se'beX, pre.ze~'tej.u se~j~ 'da.taz es.pe.si'ajs, 'mi~.Ja mo.Ti.va'sa~w~ E 'se~.pri u~ so'Ri.zu
Gosto das coisas de dentro. O que está por fora muda a cada estação. A essência, não.	'gOs.tu das 'koj.zas Di 'de~.tru, u ki es'ta puX 'fO.ra 'mu.da a 'ka.da es.ta'sa~w~, a e'se~.sja, 'na~w~
Eu gosto de ficar sozinha, mas eu não sou solitária, minha solidão me faz companhia.	ew 'gOs.tu Di fi'kaX sO'zi~.Ja, majz ew 'na~w~ 'sow so.li'ta.rja, 'mi~.Ja so.li'da~w~ mi 'fajs ko~.pa~'Ji.a
Eu não quero viver num mundo em que não possa fazer uma piada de mau gosto.	ew 'na~w~ 'kE.ru vi'veR nu~ 'mu~.du e~j~ ki 'na~w~ 'pO.sa fa'zer u~.ma pi'a.da Di 'maw 'gos.tu
Gosto das pessoas sinceras, porque me poupa o trabalho de estudá-las para conhecê-las. Pessoas falsas nos fazem perder  o tempo que poderíamos dedicar a quem são verdadeiras.	'gOs.tu das pe'so.as si~'sE.ras, puX'ke mi 'pow.pa u tra'ba.Lu Di es.tu'da las 'pa.ra ko~.Je'se las, pe'so.as 'faw.sas nus 'fa.ze~j~ peR'der u 'te~.pu ki po.de'ri.a~.mus de.Di'kar a 'ke~j~ 'sa~w~ veR.da'dej.ras
Algumas pessoas chamam de péssimo gosto para homens, eu chamo de enxergar o interior e não o exterior.	aw'gu~.mas pe'so.a'Sa~.ma~w~ Di 'pE.si~.mu 'gos.tu 'pa.ra 'o~.me~s, ew 'Sa~.mu Di e~.SeR'gar u i~.te.ri'or i 'na~w~ u es.te.ri'oX
Eu gosto de você, mas você erra. Erra ao pensar que vou esperar pra sempre, ao pensar que tenho todo tempo do mundo, erra ao pensar que eu não sofro com sua ausência.	ew 'gOs.tu Di vo'se, majs vo'se 'E.Ra, 'E.Ra aw pe~'saX ki 'vow es.pe'raX pra 'se~.pri, aw pe~'saX ki 'te~.Ju 'to.du 'te~.pu du 'mu~.du, 'E.Ra aw pe~'saX ki ew 'na~w~ 'so.fru ko~ 'su.a aw'ze~.sja
Eu não conheço metade de vocês como gostaria; e gosto de menos da metade de vocês a metade do que vocês merecem.	ew 'na~w~ ko~'Je.su me'ta.Di Di vo'sejs 'ko~.mu gos.ta'ri.a, i 'gOs.tu Di 'me~.nus da me'ta.Di Di vo'sejz a me'ta.Di du ki vo'sejs me'rE.se~j~
A cor da dor é o vermelho sangue, seu gosto é o de metal amargo, seu som é de uma voz gritando no fundo da alma	a 'koR da 'dor E u veR'me.Lu 'sa~.gi, 'sew 'gos.tu E u Di me'taw a~'maR.gu, 'sew 'so~ E Di u~.ma 'vOjz gri'ta~.du nu 'fu~.du da 'aw.ma
Um pouco de conflito em você. Eu gosto disso.	u~ 'pow.ku Di ko~'fli.tu e~j~ vo'se, ew 'gOs.tu 'Di.su
Palavras? Quem se importa com palavras se elas são vazias e frias? Eu gosto mesmo é do intenso calor da demonstração!	pa'la.vras, 'ke~j~ si i~'pOX.ta ko~ pa'la.vras si 'E.las 'sa~w~ va'zi.az i 'fri.as, ew 'gOs.tu 'mez.mu E du i~'te~.su ka'loR da de~.mo~s.tra'sa~w~
Eu gosto de textos que começam com a palavra eu. Tenho que tomar cuidado com a minha tendência a me incluir em todos os assuntos, minha mania de querer saber de tudo, estar em todos os lugares.	ew 'gOs.tu Di 'tes.tus ki ko~'mE.sa~w~ ko~ a pa'la.vra ew, 'te~.Ju ki to~'maX kuj'da.du ko~ a 'mi~.Ja te~'de~.sja a mi i~.klu'ir e~j~ 'to.duz uz a'su~.tus, 'mi~.Ja ma~'ni.a Di ke'reX sa'beR Di 'tu.du, es'tar e~j~ 'to.duz us lu'ga.ris
Vou fazer com que meu sentimento por você seja recíproco: Você ama, eu amo; Você gosta, eu gosto; Você quer, eu quero; Então, por favor! Não me despreze...	'vow fa'zeX ko~ ki 'mew se~.Ti~'me~.tu puR vo'se 'se.Za Re'si.pro.ku, vo'se 'a~.ma, ew 'a~.mu, vo'se 'gOs.ta, ew 'gOs.tu, vo'se 'kEX, ew 'kE.ru, e~'ta~w~, puX fa'voX, 'na~w~ mi des'prE.zi
Eu faço o que eu gosto, eu simplesmente não me importo.	ew 'fa.su u ki ew 'gOs.tu, ew si~.pliz'me~.Ti 'na~w~ mi i~'pOX.tu
Gosto daquilo que me desafia. O fácil nunca me interessou, já o obviamente impossível sempre me atraiu - e muito.	'gOs.tu da'ki.lu ki mi de.za'fi.a, u 'fa.siw 'nu~.ka mi i~.te.re'sow, 'Za u Ob.vi.a~'me~.Ti i~.po'si.vew 'se~.pri mi a.tra'iw, i 'mu~j~.tu
Gosto de gente de verdade. Se você não consegue ser, por favor, não perca o seu tempo comigo.	'gOs.tu Di 'Ze~.Ti Di veR'da.Di, si vo'se 'na~w~ ko~'sE.gi 'seX, puX fa'voX, 'na~w~ 'peX.ka u 'sew 'te~.pu ko~'mi.gu
Gosto da Rosa Branca por ser linda Flor, Gosto da minha Sogra por ser Mãe do meu Amor.	'gOs.tu da 'RO.za 'bra~.ka puX 'seR 'li~.da 'floX, 'gOs.tu da 'mi~.Ja 'sO.gra puX 'seR 'ma~j~ du 'mew a~'moX
Eu gosto de palavras claras e sentimentos puros. Muitos não entendem esse meu jeito, mas não me assusto, nem me espanto: Deixo rolar.	ew 'gOs.tu Di pa'la.vras 'kla.raz i se~.Ti~'me~.tus 'pu.rus, 'mu~j~.tus 'na~w~ e~'te~.de~j~ 'e.si 'mew 'Zej.tu, majs 'na~w~ mi a'sus.tu, ne~j~ mi es'pa~.tu, 'dej.Su Ro'laX
Você é a estrela que gosto de olhar; A lua que gosto de admirar; O sol que gosto que me aqueça; A lembrança que gosto de lembrar; A esperança que gosto de esperar.	vo'se E a es'tre.la ki 'gOs.tu Di o'LaX, a 'lu.a ki 'gOs.tu Di a.Di~.mi'raX, u 'sOw ki 'gOs.tu ki mi a'ke.sa, a le~'bra~.sa ki 'gOs.tu Di le~'braX, a es.pe'ra~.sa ki 'gOs.tu Di es.pe'raX
Eu gosto de não saber o que está se passando lá fora...	ew 'gOs.tu Di 'na~w~ sa'ber u ki es'ta si pa'sa~.du 'la 'fO.ra
Eu gosto de encerrar cada dia sabendo que eu aprendi algo novo.	ew 'gOs.tu Di e~.se'RaX 'ka.da 'Di.a sa'be~.du ki ew a.pre~'Di 'aw.gu 'no.vu
Gosto das coisas que estão acontecendo. Queria contar, mas tem coisas que não dá pra colocar em simples palavras	'gOs.tu das 'koj.zas ki es'ta~w~ a.ko~.te'se~.du, ke'ri.a ko~'taX, majs te~j~ 'koj.zas ki 'na~w~ 'da pra ko.lo'kar e~j~ 'si~.plis pa'la.vras
Sou impreciso, não sei o que quero, não sei do que gosto. Não sei quem amo, não sei quem odeio. Se bobear não sei nem quem sou.	'sow i~.pre'si.zu, 'na~w~ 'sej u ki 'kE.ru, 'na~w~ 'sej du ki 'gos.tu, 'na~w~ 'sej 'ke~j~ 'a~.mu, 'na~w~ 'sej 'ke~j~ o'dej.u, si bo.be'aR 'na~w~ 'sej ne~j~ 'ke~j~ 'sow
Eu gosto sabe? Gosto quando você me arranca sorrisos, aqueles verdadeiros, aqueles que evoluem pra gargalhada, aqueles que me tiram o ar.	ew 'gOs.tu 'sa.bi, 'gos.tu 'kwa~.du vo'se mi a'Ra~.ka so'Ri.zus, a'ke.lis veR.da'dej.rus, a'ke.lis ki e.vo'lu.e~j~ pra gaR.ga'La.da, a'ke.lis ki mi 'Ti.ra~w~ u 'aX
O quanto gosto de você pode ser medido pelo quanto parece que eu não estou nem aí.	u 'kwa~.tu 'gOs.tu Di vo'se 'pO.Di 'seR me'Di.du 'pe.lu 'kwa~.tu pa'rE.si ki ew 'na~w~ es'tow ne~j~ 'aj
Não sei mais falar, abraçar, dar beijos, dizer coisas aparentemente simples como Eu gosto de você. Gosto de mim.	'na~w~ 'sej 'majs fa'laX, a.bra'saX, 'daR 'bej.Zus, Di'zeX 'koj.zaz a.pa.re~.Ti~'me~.Ti 'si~.plis 'ko~.mu ew 'gOs.tu Di vo'se, 'gOs.tu Di 'mi~
Gosto de pessoas que não perguntam porque estou calado. Gosto de pessoas que entendem o meu silêncio e apenas continuam ali.	'gOs.tu Di pe'so.as ki 'na~w~ peR'gu~.ta~w~ puX'ke es'tow ka'la.du, 'gOs.tu Di pe'so.as ki e~'te~.de~j~ u 'mew si'le~.sju i a'pe~.nas ko~.Ti~'nu.a~w~ a'li
A beleza da mulher tá por dentro, tá no conceito, tá no caráter, por fora é questão de gosto de cada um.	a be'le.za da mu'LEX 'ta puR 'de~.tru, 'ta nu ko~'sej.tu, 'ta nu ka'ra.teX, puX 'fO.ra E kes'ta~w~ Di 'gos.tu Di 'ka.da 'u~
Não gosto de pessoas que, para ter algum efeito, necesitam estourar como bombas, e junto às quais há sempre perigo de perdermos subitamente a audição - e mesmo alguma coisa a mais.	'na~w~ 'gOs.tu Di pe'so.as ki, 'pa.ra 'ter aw'gu~ e'fej.tu, ne.se'zi.ta~w~ es.tow'raX 'ko~.mu 'bo~.bas, i 'Zu~.tu as 'kwajz 'a 'se~.pri pe'ri.gu Di peR'deR.mus su.bi.ta~'me~.Ti a aw.Di'sa~w~, i 'mez.mu aw'gu~.ma 'koj.za a 'majs
Gosto de ficar sozinho. Ou pelo menos, penso que fico melhor assim.	'gOs.tu Di fi'kaX sO'zi~.Ju, ow 'pe.lu 'me~.nus, 'pe~.su ki 'fi.ku me'LOr a'si~
Sabe muito bem que gosto de você. Gosto mais do que devia gostar, e exatamente por isso, não gosto. Confuso e simples assim.	'sa.bi 'mu~j~.tu 'be~j~ ki 'gOs.tu Di vo'se, 'gOs.tu 'majs du ki de'vi.a gos'taX, i e.za.ta~'me~.Ti pur 'i.su, 'na~w~ 'gOs.tu, ko~'fu.zu i 'si~.pliz a'si~
Gosto de quem presta atenção em mim. De quem procura novidade mesmo me conhecendo do avesso. De quem não desiste de me descobrir. De quem não se cansa da rotina. De quem se entrega. Sempre.	'gOs.tu Di 'ke~j~ 'prEs.ta a.te~'sa~w~ e~j~ 'mi~, Di 'ke~j~ pro'ku.ra no.vi'da.Di 'mez.mu mi ko~.Je'se~.du du a've.su, Di 'ke~j~ 'na~w~ de'zis.Ti Di mi des.ko'briX, Di 'ke~j~ 'na~w~ si 'ka~.sa da Ro'Ti~.na, Di 'ke~j~ si e~'trE.ga, 'se~.pri
Prefiro me arriscar fazendo algo que gosto perdidamente que se sentir perdido por não fazer o que amo	pre'fi.ru mi a.Ris'kaX fa'ze~.du 'aw.gu ki 'gOs.tu peR.Di.da~'me~.Ti ki si se~'TiX peR'Di.du puR 'na~w~ fa'zer u ki 'a~.mu
Não sou forte o tempo inteiro e não gosto de admitir isso, então não espalha. Eu sou fraca às vezes. Muitas vezes.	'na~w~ 'sow 'fOX.Ti u 'te~.pu i~'tej.ru i 'na~w~ 'gOs.tu Di a.Di~.mi'Tir 'i.su, e~'ta~w~ 'na~w~ es'pa.La, ew 'sow 'fra.ka as 've.zis, 'mu~j~.tas 've.zis
Eu gosto de pessoas malucas, que não ligam pra nada.	ew 'gOs.tu Di pe'so.as ma'lu.kas, ki 'na~w~ 'li.ga~w~ pra 'na.da
Confiança é essencial Felicidade é uma vantagem Ansiedade é uma pressa Audácia, eu gosto em forma bruta	ko~.fi'a~.sa E e.se~.si'aw fe.li.si'da.Di E u~.ma va~'ta.Ze~j~ a~.si.e'da.Di E u~.ma 'prE.sa aw'da.sja, ew 'gOs.tu e~j~ 'fOR.ma 'bru.ta
Não gosto de situações nas quais eu sei se vou ganhar ou perder. Por que isso não é jogar de verdade.	'na~w~ 'gOs.tu Di si.tu.a'so~j~s nas 'kwajz ew 'sej si 'vow ga~'Jar ow peR'deX, puX 'ke 'i.su 'na~w~ E Zo'gaR Di veR'da.Di
Não gosto gostar de você! Porque sei que você não gosta de mim. Isso me parece meio louca mais fazer o que ?	'na~w~ 'gOs.tu gos'taR Di vo'se, puX'ke 'sej ki vo'se 'na~w~ 'gOs.ta Di 'mi~, 'i.su mi pa'rE.si 'mej.u 'low.ka 'majs fa'zer u ki
Sempre precisei De um pouco de atenção. Acho que não sei quem sou, só sei do que não gosto. Nesses dias tão estranhos, fica a poeira se escondendo pelos cantos.	'se~.pri pre.si'zej Di u~ 'pow.ku Di a.te~'sa~w~, 'a.Su ki 'na~w~ 'sej 'ke~j~ 'sow, 'sO 'sej du ki 'na~w~ 'gOs.tu, 'ne.sis 'Di.as 'ta~w~ es'tra~.Jus, 'fi.ka a po'ej.ra si es.ko~'de~.du 'pe.lus 'ka~.tus
Eu gosto de ser gostado.	ew 'gOs.tu Di 'seR gos'ta.du
Bebo uma bebida amarga de gosto forte E torço para que ela faça vomitar toda essa mágoa Toda essa falta que você faz...	'be.bu u~.ma be'bi.da a~'maR.ga Di 'gos.tu 'fOX.Ti i 'toX.su 'pa.ra ki 'E.la 'fa.sa vo~.mi'taX 'to.da 'E.sa 'ma.gwa 'to.da 'E.sa 'faw.ta ki vo'se 'fajs
Damon: Devia ter me conhecido em 1864. Teria gostado de mim. Elena: Gosto de você do jeito que você é!	da~'mo~, de'vi.a 'teR mi ko~.Je'si.du e~j~ 'miw oj.tu'se~.tuz i se'se~.ta i 'kwa.tru, te'ri.a gos'ta.du Di 'mi~, e'le~.na, 'gOs.tu Di vo'se du 'Zej.tu ki vo'se E
Não falo nada da boca pra fora. Se eu te gosto, te gosto. Nunca vou mentir que gosto de você. Sou franca comigo e com meus sentimentos.	'na~w~ 'fa.lu 'na.da da 'bo.ka pra 'fO.ra, si ew Ti 'gOs.tu, Ti 'gOs.tu, 'nu~.ka 'vow me~'TiX ki 'gOs.tu Di vo'se, 'sow 'fra~.ka ko~'mi.gu i ko~ 'mews se~.Ti~'me~.tus
Elegância é como o estilo, não se pode comprar. É o seu gosto pela arte, a maneira como se movimenta. Você não precisa de dinheiro para ser elegante porque isso vem de dentro.	e.le'ga~.sja E 'ko~.mu u es'Ti.lu, 'na~w~ si 'pO.Di ko~'praX, E u 'sew 'gos.tu 'pe.la 'aX.Ti, a ma~'nej.ra 'ko~.mu si mo.vi~'me~.ta, vo'se 'na~w~ pre'si.za Di Di~'Jej.ru 'pa.ra 'ser e.le'ga~.Ti puX'ke 'i.su 've~j~ Di 'de~.tru
Eu gosto dos que têm fome  Dos que morrem de vontade  Dos que secam de desejo  Dos que ardem...	ew 'gOs.tu dus ki 'te~j~ 'fo~.mi dus ki 'mO.Re~j~ Di vo~'ta.Di dus ki 'sE.ka~w~ Di de'ze.Zu dus ki 'aR.de~j~
Ninguém gosta do gosto do álcool. Gostamos do efeito do álcool.	ni~'ge~j~ 'gOs.ta du 'gos.tu du 'aw.kow, gos'ta~.mus du e'fej.tu du 'aw.kow
Tenho vontade de sumir! Algumas pessoas terei muito gosto que sintam minha falta, porém outras não merecem a minha ausencia!	'te~.Ju vo~'ta.Di Di su~'miX, aw'gu~.mas pe'so.as te'rej 'mu~j~.tu 'gos.tu ki 'si~.ta~w~ 'mi~.Ja 'faw.ta, po're~j~ 'ow.tras 'na~w~ me'rE.se~j~ a 'mi~.Ja aw.ze~'si.a
Descobri no abraço de muitos amigos o gosto amargo da falta de amizade.	des.ko'bri nu a'bra.su Di 'mu~j~.tuz a~'mi.guz u 'gos.tu a~'maR.gu da 'faw.ta Di a~.mi'za.Di
Vire na próxima curva à esquerda.	'vi.ri na 'prO.si~.ma 'kuR.va a es'keR.da
Mantenha-se na pista da esquerda e vire a 400 metros.	ma~'te~.Ja si na 'pis.ta da es'keR.da i 'vi.ri a kwa.tro'se~.tus 'mE.trus
Siga na direção sudoeste na Ladeira Ary Barroso em direção à Rua General Ribeiro da Costa	'si.ga na Di.re'sa~w~ su.do'Es.Ti na la'dej.ra a'ri ba'Ro.zu e~j~ Di.re'sa~w~ a 'Ru.a Ze~.ne'raw Ri'bej.ru da 'kOs.ta
Vire à direita na Rua General Ribeiro da Costa	'vi.ri a Di'rej.ta na 'Ru.a Ze~.ne'raw Ri'bej.ru da 'kOs.ta
Vire à esquerda na Rua Anchieta	'vi.ri a es'keR.da na 'Ru.a a~.Si'e.ta
Vire à direita na Rua Gustavo Sampaio	'vi.ri a Di'rej.ta na 'Ru.a gus'ta.vu sa~'paj.u
Vire à direita na Av. Princesa Isabel	'vi.ri a Di'rej.ta na a.ve~'ni.da pri~'se.za i.za'bEw
Vire à esquerda na Av. Nossa Senhora de Copacabana	'vi.ri a es'keR.da na a.ve~'ni.da 'nO.sa se~'JO.ra Di ko.pa.ka'ba~.na
Vire à direita na Av. Prado Júnior	'vi.ri a Di'rej.ta na a.ve~'ni.da 'pra.du 'Zu~.njoX
Vire à esquerda na Rua Ministro Viveiros de Castro	'vi.ri a es'keR.da na 'Ru.a mi~'nis.tru vi'vej.rus Di 'kas.tru
Vire à direita na Rua Rodolfo Dantas	'vi.ri a Di'rej.ta na 'Ru.a Ro'dow.fu 'da~.tas
Rua Rodolfo Dantas faz uma curva suave à esquerda e se torna Rua Tonelero	'Ru.a Ro'dow.fu 'da~.tas 'fajz u~.ma 'kuR.va su'a.vi a es'keR.da i si 'tOR.na 'Ru.a to~.ne'lE.ru
Vire à direita na Ladeira do Leme	'vi.ri a Di'rej.ta na la'dej.ra du 'le~.mi
Continue para a Av. Carlos Peixoto	ko~.Ti~'nuj 'pa.ra a a.ve~'ni.da 'kaR.lus pej'So.tu
Continue para a Av. Lauro Sodré	ko~.Ti~'nuj 'pa.ra a a.ve~'ni.da 'law.ru so'drE
Curva suave à esquerda na Rua General Góes Monteiro	'kuR.va su'a.vi a es'keR.da na 'Ru.a Ze~.ne'raw 'gOjs mo~'tej.ru
Vire à direita na Rua da Passagem	'vi.ri a Di'rej.ta na 'Ru.a da pa'sa.Ze~j~
Curva suave à direita para permanecer na Rua da Passagem	'kuR.va su'a.vi a Di'rej.ta 'pa.ra peR.ma~.ne'seR na 'Ru.a da pa'sa.Ze~j~
Vire à esquerda para permanecer na Rua da Passagem	'vi.ri a es'keR.da 'pa.ra peR.ma~.ne'seR na 'Ru.a da pa'sa.Ze~j~
Curva suave à esquerda em direção à Rua Professor Álvaro Rodrigues	'kuR.va su'a.vi a es'keR.da e~j~ Di.re'sa~w~ a 'Ru.a pro.fe'sor 'aw.va.ru Ro'dri.gis
Vire à direita na Rua Professor Álvaro Rodrigues	'vi.ri a Di'rej.ta na 'Ru.a pro.fe'sor 'aw.va.ru Ro'dri.gis
Vire à esquerda na Praia de Botafogo	'vi.ri a es'keR.da na 'praj.a Di bO.ta'fo.gu
Vire à direita para permanecer na Praia de Botafogo	'vi.ri a Di'rej.ta 'pa.ra peR.ma~.ne'seR na 'praj.a Di bO.ta'fo.gu
Vire à direita na Rua Visconde de Ouro Preto	'vi.ri a Di'rej.ta na 'Ru.a vis'ko~.Di Di 'ow.ru 'pre.tu
Curva suave à esquerda no Viaduto Santiago Dantas	'kuR.va su'a.vi a es'keR.da nu vi.a'du.tu sa~.Ti'a.gu 'da~.tas
Continue para a Rua Pinheiro Machado	ko~.Ti~'nuj 'pa.ra a 'Ru.a pi~'Jej.ru ma'Sa.du
Vire à esquerda na Rua Coelho Neto	'vi.ri a es'keR.da na 'Ru.a ko'e.Lu 'nE.tu
Vire à direita na Rua Pinheiro Machado	'vi.ri a Di'rej.ta na 'Ru.a pi~'Jej.ru ma'Sa.du
Vire à esquerda na Rua Álvaro Chaves	'vi.ri a es'keR.da na 'Ru.a 'aw.va.ru 'Sa.vis
O destino estará à esquerda	u des'Ti~.nu es.ta'ra a es'keR.da
Rua Álvaro Chaves, 41 - Laranjeiras	'Ru.a 'aw.va.ru 'Sa.vis, kwa're~.ta i 'u~, la.ra~'Zej.ras
Rio de Janeiro - RJ	'Ri.u Di Za~'nej.ru, 'E.Ri 'ZO.ta
Siga na direção sudoeste na Rua Álvaro Chaves em direção à Rua Soares Cabral	'si.ga na Di.re'sa~w~ su.do'Es.Ti na 'Ru.a 'aw.va.ru 'Sa.viz e~j~ Di.re'sa~w~ a 'Ru.a so'a.ris ka'braw
Continue para a Rua Soares Cabral	ko~.Ti~'nuj 'pa.ra a 'Ru.a so'a.ris ka'braw
Vire à direita na Rua Almirante Benjamin Sodré	'vi.ri a Di'rej.ta na 'Ru.a aw.mi'ra~.Ti be~.Za~'mi~ so'drE
Continue para a Rua Muniz Barreto	ko~.Ti~'nuj 'pa.ra a 'Ru.a mu~'niz ba'Re.tu
Vire à direita na Rua São Clemente	'vi.ri a Di'rej.ta na 'Ru.a 'sa~w~ kle~'me~.Ti
Continue para a Rua Humaitá	ko~.Ti~'nuj 'pa.ra a 'Ru.a u~.maj'ta
Vire à direita na Rua Frei Veloso	'vi.ri a Di'rej.ta na 'Ru.a 'frej ve'lo.zu
Continue para a Av. Vital Brasil	ko~.Ti~'nuj 'pa.ra a a.ve~'ni.da vi'taw bra'ziw
Continue para o Túnel André Rebouças	ko~.Ti~'nuj 'pa.ra u 'tu~.new a~'drE Re'bow.sas
Continue para o Viaduto elevado Engenheiro Freyssinet	ko~.Ti~'nuj 'pa.ra u vi.a'du.tu e.le'va.du e~.Ze~'Jej.ru frej.si~'ne
Continue para o Viaduto elevado Professor Rufino de Almeida Pizarro	ko~.Ti~'nuj 'pa.ra u vi.a'du.tu e.le'va.du pro.fe'so.Ru'fi~.nu Di aw'mej.da pi'za.Ru
Continue para a Linha Vermelha Via Presidente João Goulart	ko~.Ti~'nuj 'pa.ra a 'li~.Ja veR'me.La 'vi.a pre.zi'de~.Ti Zo'a~w~ gu'laX
Continue para a Rodovia Presidente Dutra	ko~.Ti~'nuj 'pa.ra a Ro.do'vi.a pre.zi'de~.Ti 'du.tra
Estrada com pedágio em alguns trechos	es'tra.da ko~ pe'da.Zju e~j~ aw'gu~s 'tre.Sus
Pegue a saída em direção a Rodovia Governador Carvalho Pinto	'pE.gi a sa'i.da e~j~ Di.re'sa~w~ a Ro.do'vi.a go.veR.na'doX kaR'va.Lu 'pi~.tu
Vire à direita na Rodovia Governador Carvalho Pinto	'vi.ri a Di'rej.ta na Ro.do'vi.a go.veR.na'doX kaR'va.Lu 'pi~.tu
Pegue a Rodovia Ayrton Senna da Silva	'pE.gi a Ro.do'vi.a a'iX.to~ 'se~.na da 'siw.va
Continue para a Av. Marginal Tietê, Av. Morvan Dias de Figueiredo	ko~.Ti~'nuj 'pa.ra a a.ve~'ni.da, maR.Zi~'naw Ti.e'te, a.ve~'ni.da moR'va~ 'Di.as Di fi.gej're.du
Continue na Av. Marginal Tietê	ko~.Ti~'nuj na a.ve~'ni.da maR.Zi~'naw Ti.e'te
Continue para a Av. Marginal Direita do Tietê	ko~.Ti~'nuj 'pa.ra a a.ve~'ni.da maR.Zi~'naw Di'rej.ta du Ti.e'te
Pegue a saída para a Rodovia Presidente Castelo Branco	'pE.gi a sa'i.da 'pa.ra a Ro.do'vi.a pre.zi'de~.Ti kas'tE.lu 'bra~.ku
Pegue a saída para o Rodoanel Mário Covas	'pE.gi a sa'i.da 'pa.ra u Ro.do.a~'nEw 'ma.rju 'kO.vas
Pegue a saída para a Rodovia Régis Bittencourt	'pE.gi a sa'i.da 'pa.ra a Ro.do'vi.a 'RE.Zis bi.te~'kuX
Curva suave à esquerda no Rodoanel Contorno Leste	'kuR.va su'a.vi a es'keR.da nu Ro.do.a~'nEw ko~'toR.nu 'lEs.Ti
Pegue a saída para a BR Três Sete Meia	'pE.gi a sa'i.da 'pa.ra a 'be 'E.Ri 'trejs 'sE.Ti 'mej.a
Pegue a saída para a BR 376	'pE.gi a sa'i.da 'pa.ra a 'be 'E.Ri tre'ze~.tuz i se'te~.ta i 'sejs
BR Três Sete Meia faz uma curva suave à esquerda e se torna BR 101	'be 'E.Ri 'trejs 'sE.Ti 'mej.a 'fajz u~.ma 'kuR.va su'a.vi a es'keR.da i si 'tOR.na 'be 'E.Ri 'se~.tu i 'u~
BR 376 faz uma curva suave à esquerda e se torna BR 101	'be 'E.Ri tre'ze~.tuz i se'te~.ta i 'sejs 'fajz u~.ma 'kuR.va su'a.vi a es'keR.da i si 'tOR.na 'be 'E.Ri 'se~.tu i 'u~
Sair na Rua Eliane Motta	sa'iR na 'Ru.a e.li'a~.ni 'mO.ta
Curva suave à esquerda na Rua Cândido Amaro Damásio	'kuR.va su'a.vi a es'keR.da na 'Ru.a 'ka~.Di.du a~'ma.ru da~'ma.sju
Na rotatória, pegue a 1ª saída para a Av. Leoberto Leal	na Ro.ta'tO.rja, 'pE.gi a pri~'mej.ra sa'i.da 'pa.ra a a.ve~'ni.da le.o'bEX.tu le'aw
Continue para a Rua Marechal Max Schramm	ko~.Ti~'nuj 'pa.ra a 'Ru.a ma.re'Saw 'maks 'Sra~
Continue para a Av. Marechal Max Schramm	ko~.Ti~'nuj 'pa.ra a a.ve~'ni.da ma.re'Saw 'maks 'Sra~
Vire à direita na Av. Santa Catarina	'vi.ri a Di'rej.ta na a.ve~'ni.da 'sa~.ta ka.ta'ri~.na
Pegue a segunda à esquerda para pegar a Rua Humaitá	'pE.gi a se'gu~.da a es'keR.da 'pa.ra pe'gar a 'Ru.a u~.maj'ta
Estádio Orlando Scarpelli	es'ta.Dju oR'la~.du skaX'pE.li
Rua Humaitá, 194	'Ru.a u~.maj'ta, 'se~.tu i no've~.ta i 'kwa.tru
Florianópolis	flo.ri.a~'nO.po.lis
Intercontinental Hotels  Resorts	i~.teX.ko~.Ti~.ne~'taw o'tEws Re'zOX.Tis
Av. Pref Mendes Morais, 222 - São Conrado	a.ve~'ni.da pref 'me~.Dis mo'rajs, du'ze~.tuz i 'vi~.Ti i 'dojs, 'sa~w~ ko~'Ra.du
Siga na direção nordeste na Av. Aquarela do Brasil	'si.ga na Di.re'sa~w~ noR'dEs.Ti na a.ve~'ni.da a.kwa'rE.la du bra'ziw
Vire à esquerda em direção à Av. Almirante Álvaro Alberto	'vi.ri a es'keR.da e~j~ Di.re'sa~w~ a a.ve~'ni.da aw.mi'ra~.Ti 'aw.va.ru aw'bEX.tu
Vire à esquerda na Av. Almirante Álvaro Alberto	'vi.ri a es'keR.da na a.ve~'ni.da aw.mi'ra~.Ti 'aw.va.ru aw'bEX.tu
Pegue a rampa de acesso para a Estrada Lagoa Barra	'pE.gi a 'Ra~.pa Di a'sE.su 'pa.ra a es'tra.da la'go.a 'ba.Ra
Continue para o Túnel Zuzu Angel	ko~.Ti~'nuj 'pa.ra u 'tu~.new zu'zu a~'ZEw
Continue para a Estrada Lagoa Barra	ko~.Ti~'nuj 'pa.ra a es'tra.da la'go.a 'ba.Ra
Continue para a Av. Padre Leonel França	ko~.Ti~'nuj 'pa.ra a a.ve~'ni.da 'pa.dri le.o~'nEw 'fra~.sa
Continue para a Rua Mário Ribeiro	ko~.Ti~'nuj 'pa.ra a 'Ru.a 'ma.rju Ri'bej.ru
Continue para a Av. Borges de Medeiros	ko~.Ti~'nuj 'pa.ra a a.ve~'ni.da 'bOR.Zis Di me'dej.rus
Pegue a saída em direção ao Viaduto Engenheiro Humberto Vital Bandeira de Mello	'pE.gi a sa'i.da e~j~ Di.re'sa~w~ aw vi.a'du.tu e~.Ze~'Jej.ru u~'bEX.tu vi'taw ba~'dej.ra Di 'mE.lu
Vire à esquerda no Viaduto Engenheiro Humberto Vital Bandeira de Mello	'vi.ri a es'keR.da nu vi.a'du.tu e~.Ze~'Jej.ru u~'bEX.tu vi'taw ba~'dej.ra Di 'mE.lu
Curva suave à direita no acesso para a Av. Paulo de Frontin	'kuR.va su'a.vi a Di'rej.ta nu a'sE.su 'pa.ra a a.ve~'ni.da 'paw.lu Di fro~'Ti~
Curva suave à esquerda no Viaduto dos Aviadores	'kuR.va su'a.vi a es'keR.da nu vi.a'du.tu duz a.vi.a'do.ris
Continue para a Av. Osvaldo Aranha	ko~.Ti~'nuj 'pa.ra a a.ve~'ni.da oz'vaw.du a'ra~.Ja
Pegue a rampa de acesso para o Viaduto Oduvaldo Cozzi	'pE.gi a 'Ra~.pa Di a'sE.su 'pa.ra u vi.a'du.tu o.du'vaw.du 'kO.zi
Continue para a Av. Maracanã	ko~.Ti~'nuj 'pa.ra a a.ve~'ni.da ma.ra.ka~'na~
Haicai, haicais (ou como o mais importante poema japonês foi abrasileirado)	Raj'kaj, Raj'kajs, ow 'ko~.mu u 'majz i~.poX'ta~.Ti po'e~.ma Za.po~'nejs 'foj a.bra.zi.lej'ra.du
Hokku, Haikai, Haiku, Haicai	Ro'ku, Raj'kaj, Raj'ku, Raj'kaj
A partir de então, a poesia tradicional japonesa adotará esse metro.	a paX'TiR Di e~'ta~w~, a po.e'zi.a tra.Di.si.o~'naw Za.po~'ne.za a.do.ta'ra 'e.si 'mE.tru
Elaborada entre os séculos VI e VIII, a obra é constituída por vinte volumes e reúne cerca de 4500 poemas.	e.la.bo'ra.da 'e~.tri us 'sE.ku.lus 'ses.tu i oj'ta.vu, a 'O.bra E ko~s.Ti.tu'i.da puR 'vi~.Ti vo'lu~.miz i Re'u~.ni 'seX.ka Di 'kwa.tru 'miw i ki~'Je~.tus po'e~.mas
No período Kamakura, o pequeno poema irá tornar-se uma espécie de entretenimento entre os cortesãos da aristocracia feudal.	nu pe'ri.o.du ka~.ma'ku.ra, u pe'ke~.nu po'e~.ma i'ra toR'naX si u~.ma es'pE.si Di e~.tre.te~.ni~'me~.tu 'e~.tri us koX.te'za~w~s da a.ris.to.kra'si.a few'daw
Entre os anos 913 e 1439, os imperadores japoneses encomendaram 21 antologias aos poetas do período, cada uma com cerca de vinte volumes.	'e~.tri uz 'a~.nus nO.vi'se~.tuz i 'tre.zi i 'miw kwa.tro'se~.tuz i 'tri~.ta i 'nO.vi, uz i~.pe.ra'do.ri.Za.po~'ne.ziz e~.ko~.me~'da.ra~w~ 'vi~.Ti i 'u~ma a~.to.lo'Zi.az aws po'E.tas du pe'ri.o.du, 'ka.da u~.ma ko~ 'seX.ka Di 'vi~.Ti vo'lu~.mis
O conjunto ficou conhecido por Chokusen Waka-Shú (Coletânea de poemas waka).	u ko~'Zu~.tu fi'kow ko~.Je'si.du puX To.ku'se~ 'wa.ka 'Su, ko.le'ta~.nja Di po'e~.mas 'wa.ka
Com o tempo, a composição passará a ligar-se a outras estrofes da mesma medida, somando uma centena de versos.	ko~ u 'te~.pu, a ko~.po.zi'sa~w~ pa.sa'ra a li'gaX si a 'ow.traz es'trO.fis da 'mez.ma me'Di.da, so~'ma~.du u~.ma se~'te~.na Di 'vEX.sus
A nova forma ficou conhecida por renga e, em seguida, por renga haikai, ou renku.	a 'nO.va 'fOR.ma fi'kow ko~.Je'si.da pu'Re~.ga i, e~j~ se'gi.da, pu'Re~.ga Raj'kaj, ow 'Re~.ku
Seguida por monges, representantes da burguesia e de artistas populares, essa escola enfatizava o coloquialismo e, em alguns casos, as expressões vulgares e o humor rasteiro, repercutindo, em seus poemas, a temática das coisas simples e cotidianas.	se'gi.da puR 'mo~.Zis, Re.pre.ze~'ta~.Tis da buR.ge'zi.a i Di aX'Tis.tas po.pu'la.ris, 'E.sa es'kO.la e~.fa.Ti'za.va u ko.lo.ki.a'liz.mu i, e~j~ aw'gu~s 'ka.zus, az es.pre'so~j~s vuw'ga.riz i u u~'mo.Ras'tej.ru, Re.peX.ku'Ti~.du, e~j~ 'sews po'e~.mas, a te~'ma.Ti.ka das 'koj.zas 'si~.pliz i ko.Ti.Di'a~.nas
O terceto atingirá seu apogeu no século XVII, durante o período do Edo, sob o mando do clã Tokugawa, quando Matsuo Bashô, filho de samurai e samurai por nascimento, renuncia à sua classe social para, aos 25 anos, tornar-se monge andarilho.	u teX'se.tu a.Ti~.Zi'ra 'sew a.po'Zew nu 'sE.ku.lu de.ze'sE.Ti, du'ra~.Ti u pe'ri.o.du du 'e.du, sob u 'ma~.du du 'kla~ to.ku'ga.wa, 'kwa~.du 'ma.tsu.o ba'So, fi'Lu Di sa~.mu.raj i sa~.mu'raj puR na.si~'me~.tu, Re~.nu~'si.a a 'su.a 'kla.si so.si'aw 'pa.ra, aws 'vi~.Ti i 'si~.ku 'a~.nus, toR'naX si 'mo~.Zi a~.da'ri.Lu
Em seu ofício, Bashô irá revelar a beleza existente nas coisas modestas, humildes, imperfeitas, transitórias e não convencionais (sintetizada pelo conceito wabi-sabi).	e~j~ 'sew o'fi.sju, ba'So i'ra Re.ve'lar a be'le.za e.zis'te~.Ti nas 'koj.zas mo'dEs.tas, u~'miw.Dis, i~.peX'fej.tas, tra~.zi'tO.rjaz i 'na~w~ ko~.ve~.si.o~'najs, si~.te.Ti'za.da 'pe.lu ko~'sej.tu wa'bi 'sa.bi
Sua escola ficará conhecida por Shomôn, ou escola de Bashô.	'su.a es'kO.la fi.ka'ra ko~.Je'si.da puX So~'mo~, ow es'kO.la Di ba'So
Em seguida a esse período virtuoso, Buson, Kobayashi Issa e Massoka Shiki irão estabelecer novos padrões para o pequeno poema, e ascender ao panteão dos haijins (ou praticantes do haicai) clássicos.	e~j~ se'gi.da a 'e.si pe'ri.o.du viX.tu'o.zu, bu'zo~, ko.ba'ja.Si i'sa i ma'so.ka 'Si.ki i'ra~w~ es.ta.be.le'seR 'nO.vus pa'dro~j~s 'pa.ra u pe'ke~.nu po'e~.ma, i a.se~'der aw pa~.te'a~w~ duz Raj'Zi~s, ow pra.Ti'ka~.Tis du Raj'kaj, 'kla.si.kus
Um período em que o Japão permanecerá isolado de todo o contato com o mundo exterior.	u~ pe'ri.o.du e~j~ ki u Za'pa~w~ peR.ma~.ne.se'ra i.zo'la.du Di 'to.du u ko~'ta.tu ko~ u 'mu~.du es.te.ri'oX
Nesse contexto, o projeto de vida de Shiki será preservar a integridade da poesia japonesa e do haicai como forma original e local.	'ne.si ko~'tes.tu, u pro'ZE.tu Di 'vi.da Di Si'ki se'ra pre.zeR'var a i~.te.gri'da.Di da po.e'zi.a Za.po~'ne.za i du Raj'kaj 'ko~.mu 'fOR.ma o.ri.Zi~'naw i lo'kaw
Como parte desse empreendimento, o poeta criará o neologismo haiku (aglutinação de haikai e hokku) para nomear o poema de dezessete sílabas.	'ko~.mu 'paX.Ti 'de.si e~.pre.e~.Di~'me~.tu, u po'E.ta kri.a'ra u ne.o.lo'Ziz.mu Raj'ku, a.glu.Ti~.na'sa~w~ Di Raj'kaj i Ro'ku, 'pa.ra no~.me'ar u po'e~.ma Di de.ze'sE.Ti 'si.la.bas
Irá também estabelecer regras rígidas para sua composição, fundando, em 1892, a escola Nippon-ha.	i'ra ta~'be~j~ es.ta.be.le'se'RE.gras 'Ri.Zi.das 'pa.ra 'su.a ko~.po.zi'sa~w~, fu~'da~.du, e~j~ 'miw oj.tu'se~.tuz i no've~.ta i 'dojs, a es'kO.la ni'po~ 'Ra
Entre as principais regras, o poema deveria ser breve, resumindo-se a dezessete fonemas, ou sílabas; conter a referência à estação do ano (ou Kigô) e ao local de sua criação; ser rico em onomatopeias; e, por fim, explicitar o kireji, partícula expletiva que pode introduzir uma pausa, denotar a dúvida ou a emoção do poeta diante do acontecimento que inaugura o poema - tal como a interjeição ah! na sintaxe ocidental.	'e~.tri as pri~.si'pajs 'RE.gras, u po'e~.ma de.ve'ri.a 'seR 'brE.vi, Re.zu~'mi~.du si a de.ze'sE.Ti fo~'ne~.mas, ow 'si.la.bas, ko~'ter a Re.fe're~.sja a es.ta'sa~w~ du 'a~.nu, ow ki'go, i aw lo'kaw Di 'su.a kri.a'sa~w~, 'se'Ri.ku e~j~ o~.no~.ma.to'pEj.as, i, puX 'fi~, es.pli.si'tar u ki.re'Zi, paX'Ti.ku.la es.ple'Ti.va ki 'pO.Di i~.tro.du'zir u~.ma 'paw.za, de~.no'tar a 'du.vi.da ow a e~.mo'sa~w~ du po'E.ta Di'a~.Ti du a.ko~.te.si~'me~.tu ki i~.naw'gu.ra u po'e~.ma, 'taw 'ko~.mu a i~.teR.Zej'sa~w~ 'a, na si~'ta.si o.si.de~'taw
Mais próximo à poética de Buson que a de Bashô, Shiki afirmava que seu maior mestre continuava sendo a natureza, em todas as suas sutis manifestações.	'majs 'prO.si~.mu a po'E.Ti.ka Di bu'zo~ ki a Di ba'So, Si'ki a.fiR'ma.va ki 'sew maj'OR 'mEs.tri ko~.Ti~.nu'a.va 'se~.du a na.tu're.za, e~j~ 'to.daz as 'su.as su'Tis ma~.ni.fes.ta'so~j~s
Antecedentes no Brasil	a~.te.se'de~.Tis nu bra'ziw
Passados quatro anos da morte do último grande haijin clássico japonês, o haicai (como o termo será abrasileirado) estreará no Brasil em 1906, por obra de Monteiro Lobato, então redator, editor e fac-totum de O Minarete, pequeno jornal de Pindamonhangaba, interior de São Paulo.	pa'sa.dus 'kwa.tru 'a~.nus da 'mOX.Ti du 'uw.Ti~.mu 'gra~.Di Raj'Zi~ 'kla.si.ku Za.po~'nejs, u Raj'kaj, 'ko~.mu u 'teR.mu se'ra a.bra.zi.lej'ra.du, es.tre.a'ra nu bra'ziw e~j~ 'miw nO.vi'se~.tuz i 'sejs, pur 'O.bra Di mo~'tej.ru lo'ba.tu, e~'ta~w~ Re.da'toX, e.Di'tor i 'fak 'tO.tu~ Di u mi~.na'rE.Ti, pe'ke~.nu ZoR'naw Di pi~.da~.mo~.Ja~'ga.ba, i~.te.ri'oR Di 'sa~w~ 'paw.lu
Na ocasião, Lobato irá publicar na gazeta o artigo A poesia japonesa, em que pioneiramente traduz seis haicais.	na o.ka.zi'a~w~, lo'ba.tu i'ra pu.bli'kaR na ga'ze.ta u aX'Ti.gu a po.e'zi.a Za.po~'ne.za, e~j~ ki pi.o~.nej.ra~'me~.Ti tra'dujs 'sejz Raj'kajs
Dono de espírito crítico e inovador, o autor de O sítio do Picapau Amarelo exercerá grande influência sobre a geração de escritores e poetas que, em 1922, romperá com a sintaxe passadista e inaugurará o modernismo no país - inspirados não somente, mas de forma marcante, pela oralidade, pelo coloquialismo e pelo despojamento da narrativa lobatiana.	'do~.nu Di es'pi.ri.tu 'kri.Ti.ku i i~.no.va'doX, u aw'toR Di u 'si.Tju du pi.ka'paw a~.ma'rE.lu e.zeX.se'ra 'gra~.Di i~.flu'e~.sja 'so.bri a Ze.ra'sa~w~ Di es.kri'to.riz i po'E.tas ki, e~j~ 'miw nO.vi'se~.tuz i 'vi~.Ti i 'dojs, Ro~.pe'ra ko~ a si~'ta.si pa.sa'Dis.ta i i~.naw.gu.ra'ra u mo.deR'niz.mu nu pa'is, i~s.pi'ra.dus 'na~w~ sO~'me~.Ti, majs Di 'fOR.ma maX'ka~.Ti, 'pe.la o.ra.li'da.Di, 'pe.lu ko.lo.ki.a'liz.mu i 'pe.lu des.po.Za~'me~.tu da na.Ra'Ti.va lo.ba.Ti'a~.na
Na onda do escrito de Lobato, mais precisamente em 18 de junho de 1908, aportará em Santos a fabulosa nau Kasato Maru, trazendo a bordo 781 japoneses.	na 'o~.da du es'kri.tu Di lo'ba.tu, 'majs pre.si.za~'me~.Ti e~j~ de'zoj.tu Di 'Zu~.Ju Di 'miw nO.vi'se~.tuz i 'oj.tu, a.poX.ta'ra e~j~ 'sa~.tuz a fa.bu'lO.za 'naw ka'sa.to ma'ru, tra'ze~.du a 'bOR.du sE.Ti'se~.tuz i oj'te~.ta i 'u~ Za.po~'ne.zis
Segundo Massuda Goga, haiku no meigo, ou nome de haicaísta, de Hidekasu Massuda, o primeiro haiku em território brasileiro foi escrito por Shûhei Uetsuka momentos antes de atracar:	se'gu~.du ma'su.da 'gO.ga, Raj'ku nu 'mej.gu, ow 'no~.mi Di Raj.ka'is.ta, Di Ri.de'ka.su ma'su.da, u pri~'mej.ru Raj'ku e~j~ te.Ri'tO.rju bra.zi'lej.ru 'foj es'kri.tu puX 'Su.Rej u.e'tsu.ka mo~'me~.tuz 'a~.Tis Di a.tra'kaX
a nau imigrante	a 'naw i~.mi'gra~.Ti
chegando: vê-se lá no alto	Se'ga~.du, 've si 'la nu 'aw.tu
a cascata seca	a kas'ka.ta 'se.ka
Durante anos, o poema (assim como outras manifestações culturais e artísticas tradicionais) ficará em segundo plano entre os novos colonizadores, empenhados que estavam em garantir sua sobrevivência no Brasil.	du'ra~.Ti 'a~.nus, u po'e~.ma, a'si~ 'ko~.mu 'ow.tras ma~.ni.fes.ta'so~j~s kuw.tu'rajz i aX'Tis.Ti.kas tra.Di.si.o~'najs, fi.ka'ra e~j~ se'gu~.du 'pla~.nu 'e~.tri us 'nO.vus ko.lo~.ni.za'do.ris, e~.pe~'Ja.dus ki es'ta.va~w~ e~j~ ga.ra~'TiX 'su.a so.bre.vi've~.sja nu bra'ziw
Somente nos anos 1930 surgirão os primeiros núcleos de haiku entre os colonos, logo interrompidos com o início da Segunda Grande Guerra.	sO~'me~.Ti nuz 'a~.nus 'miw nO.vi'se~.tuz i 'tri~.ta suR.Zi'ra~w~ us pri~'mej.rus 'nu.kljus Di Raj'ku 'e~.tri us ko'lo~.nus, 'lO.gu i~.te.Ro~'pi.dus ko~ u i~'ni.sju da se'gu~.da 'gra~.Di 'gE.Ra
Nesse ambiente de grandes e tão duras limitações, Nempuku Sato irá destacar-se: interlocutor de Uetsuka e mentor de Goga, Nempuku irá comentar e difundir, a partir de 1933, o haiku produzido no idioma japonês no Brasil.	'ne.si a~.bi'e~.Ti Di 'gra~.Diz i 'ta~w~ 'du.ras li~.mi.ta'so~j~s, ne~'pu.ku 'sa.tu i'ra des.ta'kaX si, i~.teR.lo.ku'toR Di u.e'tsu.ka i me~'toR Di 'gO.ga, ne~'pu.ku i'ra ko~.me~'tar i Di.fu~'DiX, a paX'TiR Di 'miw nO.vi'se~.tuz i 'tri~.ta i 'trejs, u Raj'ku pro.du'zi.du nu i.Di'o~.ma Za.po~'nejs nu bra'ziw
Em 1948, lançará a revista mensal Kokage, dedicada ao poema (que deixará de circular em outubro de 1979, ano da morte do poeta, após 372 números ininterruptos).	e~j~ 'miw nO.vi'se~.tuz i kwa're~.ta i 'oj.tu, la~.sa'ra a Re'vis.ta me~'saw ko'ka.Zi, de.Di'ka.da aw po'e~.ma, ki dej.Sa'ra Di siX.ku'lar e~j~ ow'tu.bru Di 'miw nO.vi'se~.tuz i se'te~.ta i 'nO.vi, 'a~.nu da 'mOX.Ti du po'E.ta, a'pOjs tre'ze~.tuz i se'te~.ta i 'dojs 'nu~.me.ruz i~.ni~.te'Rup.tus
Tendo em vista a qualidade de sua reflexão e criação poética, Nempuku irá tornar-se o principal representante no Brasil da escola Nippon-Ha, de Massaoka Shiki.	'te~.du e~j~ 'vis.ta a kwa.li'da.Di Di 'su.a Re.flek'sa~w~ i kri.a'sa~w~ po'E.Ti.ka, ne~'pu.ku i'ra toR'naX si u pri~.si'paw Re.pre.ze~'ta~.Ti nu bra'ziw da es'kO.la ni'po~ 'Ra, Di ma.sa'o.ka Si'ki
Considerando o ambiente de preconceito e exclusão que cercava a comunidade japonesa desde sua chegada ao país, especialmente após a guerra, os primeiros intercâmbios culturais apenas serão admitidos, ao menos publicamente, a partir do final dos anos 1940, graças à iniciativa de Guilherme de Almeida.	ko~.si.de'ra~.du u a~.bi'e~.Ti Di pre.ko~'sej.tu i es.klu'za~w~ ki seX'ka.va a ko~.mu~.ni'da.Di Za.po~'ne.za 'dez.Di 'su.a Se'ga.da aw pa'is, es.pe.si.aw'me~.Ti a'pOjz a 'gE.Ra, us pri~'mej.ruz i~.teX'ka~.bjus kuw.tu'rajz a'pe~.nas se'ra~w~ a.Di~.mi'Ti.dus, aw 'me~.nus pu.bli.ka~'me~.Ti, a paX'TiR du fi~'naw duz 'a~.nus 'miw nO.vi'se~.tuz i kwa're~.ta, 'gra.saz a i~.ni.si.a'Ti.va Di gi'LER.mi Di aw'mej.da
Pouco mais de uma década após a chegada dos primeiros imigrantes japoneses, caberá ao poeta, historiador e crítico literário Afrânio Peixoto fixar, em 1919, a forma do haicai à brasileira: três versos com cinto, sete e cinco pés, respectivamente, totalizando dezessete sílabas métricas.	'pow.ku 'majs Di u~.ma 'dE.ka.da a'pOjz a Se'ga.da dus pri~'mej.ruz i~.mi'gra~.Ti.Za.po~'ne.zis, ka.be'ra aw po'E.ta, is.to.ri.a'dor i 'kri.Ti.ku li.te'ra.rju a'fra~.nju pej'So.tu fik'saX, e~j~ 'miw nO.vi'se~.tuz i de.ze~'nO.vi, a 'fOR.ma du Raj'kaj a bra.zi'lej.ra, 'trejs 'vEX.sus ko~ 'si~.tu, 'sE.Ti i 'si~.ku 'pEjs, Res.pek.Ti.va~'me~.Ti, to.ta.li'za~.du de.ze'sE.Ti 'si.la.bas 'mE.tri.kas
E nada mais.	i 'na.da 'majs
Nesse período, uma grande e impactante mudança estava para ocorrer no ambiente literário: no início dos anos 1920, os modernistas romperão com a sintaxe e a métrica tradicionais, inaugurando o verso livre e, principalmente, impondo a linguagem coloquial na poesia (guardadas as circunstâncias, da mesma maneira que o movimento empreendido pela escola Danrin no Japão do século XVII)	'ne.si pe'ri.o.du, u~.ma 'gra~.Di i i~.pak'ta~.Ti mu'da~.sa es'ta.va 'pa.ra o.ko'ReR nu a~.bi'e~.Ti li.te'ra.rju, nu i~'ni.sju duz 'a~.nus 'miw nO.vi'se~.tuz i 'vi~.Ti, us mo.deR'nis.tas Ro~.pe'ra~w~ ko~ a si~'ta.si i a 'mE.tri.ka tra.Di.si.o~'najs, i~.naw.gu'ra~.du u 'vEX.su 'li.vri i, pri~.si.paw'me~.Ti, i~'po~.du a li~'gwa.Ze~j~ ko.lo.ki'aw na po.e'zi.a, gwaR'da.daz as siX.ku~s'ta~.sjas, da 'mez.ma ma~'nej.ra ki u mo.vi~'me~.tu e~.pre.e~'Di.du 'pe.la es'kO.la da~'Ri~ nu Za'pa~w~ du 'sE.ku.lu de.ze'sE.Ti
A temática também será virada pelo avesso: na era da novíssima Revolução Industrial e da velocidade, o poeta descerá do Monte Parnaso e arredores (muitos a contragosto) para viver o bulício das ruas.	a te~'ma.Ti.ka ta~'be~j~ se'ra vi'ra.da 'pe.lu a've.su, na 'E.ra da nO'vi.si~.ma Re.vo.lu'sa~w~ i~.dus.tri'aw i da ve.lo.si'da.Di, u po'E.ta de.se'ra du 'mo~.Ti 'paR.na.zu i a.Re'dO.ris, 'mu~j~.tuz a ko~.tra'gos.tu, 'pa.ra vi'ver u bu'li.sju das 'Ru.as
Nesse contexto, o haicai reduzir-se-á a um terceto breve e bem-humorado, cujo tema refletirá a novidade da vida urbana e burguesa, em contraste com a pasmaceira da roça do Brasil profundo, representada pela figura emblemática do Jeca-Tatu, de Monteiro Lobato - o mesmo Lobato que, se de um lado inspira os modernistas a adotarem uma sintaxe livre, nativa e inventiva, deles se afasta, de outro, em virtude de seus valores éticos e estéticos.	'ne.si ko~'tes.tu, u Raj'kaj Re.du'ziX si a a 'u~ teX'se.tu 'brE.vi i 'be~j~ u~.mo'ra.du, 'ku.Zu 'te~.ma Re.fle.Ti'ra a no.vi'da.Di da 'vi.da uR'ba~.na i buR'ge.za, e~j~ ko~'tras.Ti ko~ a paz.ma'sej.ra da 'RO.sa du bra'ziw pro'fu~.du, Re.pre.ze~'ta.da 'pe.la fi'gu.ra e~.ble~'ma.Ti.ka du 'ZE.ka ta'tu, Di mo~'tej.ru lo'ba.tu, u 'mez.mu lo'ba.tu ki, si Di u~ 'la.du i~s'pi.ra us mo.deR'nis.taz a a.do'ta.re~j~ u~.ma si~'ta.si 'li.vri, na'Ti.va i i~.ve~'Ti.va, 'de.lis si a'fajs.ta, Di 'ow.tru, e~j~ viX'tu.Di Di 'sews va'lo.riz 'E.Ti.kuz i es'tE.Ti.kus
1922 e o Haicai	'miw nO.vi'se~.tuz i 'vi~.Ti i 'dojz i u Raj'kaj
Em 1922, o haicai era não somente praticado como também discutido por poetas que participaram da Semana de Arte Moderna: após a consagradora estreia da rapaziada no Teatro Municipal de São Paulo, a revista Klaxon irá comentar, em seu segundo número, as transformações promovidas na poesia japonesa a partir de 1895 (no caso do haiku, como vimos, produzidas por Shiki).	e~j~ 'miw nO.vi'se~.tuz i 'vi~.Ti i 'dojs, u Raj'kaj 'E.ra 'na~w~ sO~'me~.Ti pra.Ti'ka.du 'ko~.mu ta~'be~j~ Dis.ku'Ti.du puX po'E.tas ki paX.Ti.si'pa.ra~w~ da se~'ma~.na Di 'aX.Ti mo'dER.na, a'pOjz a ko~.sa.gra'do.ra es'trEj.a da Ra.pa.zi'a.da nu Ti'a.tru mu~.ni.si'paw Di 'sa~w~ 'paw.lu, a Re'vis.ta 'klak.so~ i'ra ko~.me~'taX, e~j~ 'sew se'gu~.du 'nu~.me.ru, as tra~s.foR.ma'so~j~s pro~.mo'vi.das na po.e'zi.a Za.po~'ne.za a paX'TiR Di 'miw oj.tu'se~.tuz i no've~.ta i 'si~.ku, nu 'ka.zu du Raj'ku, 'ko~.mu 'vi~.mus, pro.du'zi.das puX Si'ki
Intitulado A poesia japonesa contemporânea, o texto será assinado pelo poeta japonês Nico Horigoutchi, colaborador da revista.	i~.Ti.tu'la.du a po.e'zi.a Za.po~'ne.za ko~.te~.po'ra~.ne.a, u 'tes.tu se'ra a.si~'na.du 'pe.lu po'E.ta Za.po~'nejs 'ni.ku Ro.ri.go.u'Ti, ko.la.bo.ra'doR da Re'vis.ta
Foi também nesse ano mítico que Luís Aranha entregou a Mário de Andrade os manuscritos daquele que seria seu primeiro livro de poesia.	'foj ta~'be~j~ 'ne.si 'a~.nu 'mi.Ti.ku ki lu'iz a'ra~.Ja e~.tre'gow a 'ma.rju Di a~'dra.Di us ma~.nus'kri.tus da'ke.li ki se'ri.a 'sew pri~'mej.ru 'li.vru Di po.e'zi.a
Intitulado Cocktails, o livrinho continha quatro poemas anteriormente publicados em Klaxon, além de muitos inéditos.	i~.Ti.tu'la.du kO.ki'tej.us, u li'vri~.Ju ko~'Ti~.Ja 'kwa.tru po'e~.maz a~.te.ri.oR'me~.Ti pu.bli'ka.duz e~j~ 'klak'so~, a'le~j~ Di 'mu~j~.tuz i~'nE.Di.tus
Em sua própria avaliação, Mário foi demasiado severo, qualificando a poesia de Luís Aranha como preparatoriana, e o livro como desastre definitivo.	e~j~ 'su.a 'prO.prja a.va.li.a'sa~w~, 'ma.rju 'foj de~.ma.zi'a.du se'vE.ru, kwa.li.fi'ka~.du a po.e'zi.a Di lu'iz a'ra~.Ja 'ko~.mu pre.pa.ra.to.ri'a~.na, i u 'li.vru 'ko~.mu de'zas.tri de.fi~.ni'Ti.vu
Segundo mais de um crítico, seu juízo implacável condenaria o jovem autor ao silêncio estéril, encerrando, com esse episódio, sua trajetória poética - Cocktails será publicado somente em 1986, seis décadas após sua concepção.	se'gu~.du 'majs Di 'u~ 'kri.Ti.ku, 'sew Zu'i.zu i~.pla'ka.vew ko~.de~.na'ri.a u 'ZO.ve~j~ aw'tor aw si'le~.sju es'tE.riw, e~.se'Ra~.du, ko~ 'e.si e.pi'zO.Dju, 'su.a tra.Ze'tO.rja po'E.Ti.ka, kO.ki'tej.us se'ra pu.bli'ka.du sO~'me~.Ti e~j~ 'miw nO.vi'se~.tuz i oj'te~.ta i 'sejs, 'sejs 'dE.ka.daz a'pOjs 'su.a ko~.sep'sa~w~
Em Drogaria de éter e de sombra, um dos três poemas longos que compõem a obra, Luís Aranha inseriu dois haicais, o mais saboroso deles inspirado em conhecido poema de Yamazaki Sokán.	e~j~ dro.ga'ri.a Di 'E.ter i Di 'so~.bra, u~ dus 'trejs po'e~.mas 'lo~.gus ki ko~'po~.e~j~ a 'O.bra, lu'iz a'ra~.Ja i~.se'riw 'dojz Raj'kajs, u 'majs sa.bo'ro.zu 'de.liz i~s.pi'ra.du e~j~ ko~.Je'si.du po'e~.ma Di ja~.ma'za.ki so'kan
Trata-se dos primeiros haicais concebidos por um poeta brasileiro.	'tra.ta si dus pri~'mej.ruz Raj'kajs ko~.se'bi.dus pur u~ po'E.ta bra.zi'lej.ru
Após essa iniciativa pioneira, coube ao campeão do modernismo Oswald de Andrade adotar o haicai em Pau Brasil, marco da poesia moderna.	a'pOjz 'E.sa i~.ni.si.a'Ti.va pi.o~'nej.ra, 'kow.bi aw ka~.pe'a~w~ du mo.deR'niz.mu 'oz.vaw.Di Di a~'dra.Di a.do'tar u Raj'kaj e~j~ 'paw bra'ziw, 'maX.ku da po.e'zi.a mo'dER.na
Paulo Prado, prefaciador do livrinho publicado em Paris, em 1925, identifica na poética oswaldiana a concisão e a agudeza do haijin.	'paw.lu 'pra.du, pre.fa.si.a'doR du li'vri~.Ju pu.bli'ka.du e~j~ pa'ris, e~j~ 'miw nO.vi'se~.tuz i 'vi~.Ti i 'si~.ku, i.de~.Ti'fi.ka na po'E.Ti.ka oz.vaw.Di'a~.na a ko~.si'za~w~ i a a.gu'de.za du Raj'Zi~
Passados quatro anos, Oswald voltará ao terceto no livro-experimento Primeiro caderno de poesia do aluno Oswald de Andrade.	pa'sa.dus 'kwa.tru 'a~.nus, 'oz.vaw.Di vow.ta'ra aw teX'se.tu nu 'li.vru es.pe.ri~'me~.tu pri~'mej.ru ka'dER.nu Di po.e'zi.a du a'lu~.nu 'oz.vaw.Di Di a~'dra.Di
Tendo em vista sua inclinação para a zombaria, muitos de seus poemas serão (deliberadamente) mal interpretados, recebendo o epíteto de poema-piada, especialmente seus haicais.	'te~.du e~j~ 'vis.ta 'su.a i~.kli~.na'sa~w~ 'pa.ra a zo~.ba'ri.a, 'mu~j~.tus Di 'sews po'e~.mas se'ra~w~, de.li.be.ra.da~'me~.Ti, 'maw i~.teX.pre'ta.dus, Re.se'be~.du u e'pi.te.tu Di po'e~.ma pi'a.da, es.pe.si.aw'me~.Ti 'sewz Raj'kajs
No mesmo ano, Carlos Drummond de Andrade, ainda noviço na cena poética, irá praticar o haicai logo após reunir-se, em 1924, com Oswald, Mário em outros expoentes do modernismo em Belo Horizonte, por ocasião de uma antológica jornada empreendida pelos paulistas às cidades históricas mineiras, com a intenção de redescobrir o Brasil.	nu 'mez.mu 'a~.nu, 'kaR.lus dru~'mo~.Di Di a~'dra.Di, a'i~.da no'vi.su na 'se~.na po'E.Ti.ka, i'ra pra.Ti'kar u Raj'kaj 'lO.gu a'pOjs Re.u~'niX si, e~j~ 'miw nO.vi'se~.tuz i 'vi~.Ti i 'kwa.tru, ko~ 'oz.vaw.Di, 'ma.rju e~j~ 'ow.truz es.po'e~.Tis du mo.deR'niz.mu e~j~ 'bE.lu o.ri'zo~.Ti, pur o.ka.zi'a~w~ Di u~.ma a~.to'lO.Zi.ka ZoR'na.da e~.pre.e~'Di.da 'pe.lus paw'lis.taz as si'da.Diz is'tO.ri.kas mi~'nej.ras, ko~ a i~.te~'sa~w~ Di Re.des.ko'brir u bra'ziw
Seus seis primeiros haicais serão publicados na edição de 27 de junho de 1925 da então prestigiosa revista de variedades Para Todos.	'sews 'sejs pri~'mej.ruz Raj'kajs se'ra~w~ pu.bli'ka.dus na e.Di'sa~w~ Di 'vi~.Ti i 'sE.Ti Di 'Zu~.Ju Di 'miw nO.vi'se~.tuz i 'vi~.Ti i 'si~.ku da e~'ta~w~ pres.Ti.Zi'O.za Re'vis.ta Di va.ri.e'da.Dis 'pa.ra 'to.dus
O poeta voltará ao gênero em diversas oportunidades, seja para espinafrar a censura nos anos de chumbo, seja para transpor em palavras a dor incomunicável de Pietá, de Michelangelo.	u po'E.ta vow.ta'ra aw 'Ze~.ne.ru e~j~ Di'vEX.saz o.poX.tu~.ni'da.Dis, 'se.Za 'pa.ra es.pi~.na'frar a se~'su.ra nuz 'a~.nus Di 'Su~.bu, 'se.Za 'pa.ra tra~s'por e~j~ pa'la.vraz a 'dor i~.ko~.mu~.ni'ka.vew Di pi.e'ta, Di mi.ke'la~'Ze.lu
Outro modernista de primeira hora que se encantou com o poema japonês foi Manuel Bandeira.	'ow.tru mo.deR'nis.ta Di pri~'mej.ra 'O.ra ki si e~.ka~'tow ko~ u po'e~.ma Za.po~'nejs 'foj ma~.nu'Ew ba~'dej.ra
Dedicou também grande atenção ao poema no tratado Versificação em língua portuguesa, publicado em 1956 pela Enciclopédia Delta Larousse.	de.Di'kow ta~'be~j~ 'gra~.Di a.te~'sa~w~ aw po'e~.ma nu tra'ta.du veX.si.fi.ka'sa~w~ e~j~ 'li~.gwa poX.tu'ge.za, pu.bli'ka.du e~j~ 'miw nO.vi'se~.tuz i si~'kwe~.ta i 'sejs 'pe.la e~.si.klo'pE.Dja 'dEw.ta la'row.si
O haicai estará igualmente presente em sua obra crítica e na correspondência com amigos de ofício, entre os quais Carlos Drummond de Andrade.	u Raj'kaj es.ta'ra i.gwaw'me~.Ti pre'ze~.Ti e~j~ 'su.a 'O.bra 'kri.Ti.ka i na ko.Res.po~'de~.sja ko~ a~'mi.gus Di o'fi.sju, 'e~.tri us 'kwajs 'kaR.lus dru~'mo~.Di Di a~'dra.Di
Guilherme, Guimarães Rosa, Quintana, Millôr e Concretos	gi'LER.mi, gi~.ma'ra~j~s 'RO.za, ki~'ta~.na, mi'lor i ko~'krE.tus
Três versos de dezessete sílabas métricas: o primeiro com cinco, o segundo com sete e o terceiro novamente com cinco sílabas.	'trejs 'vEX.sus Di de.ze'sE.Ti 'si.la.bas 'mE.tri.kas, u pri~'mej.ru ko~ 'si~.ku, u se'gu~.du ko~ 'sE.Ti i u teX'sej.ru nO.va~'me~.Ti ko~ 'si~.ku 'si.la.bas
Para rematar, uma rima interna no segundo verso, entre a segunda e a sétima sílabas, e outra ligando o primeiro ao terceiro verso, como representado no diagrama que segue:	'pa.ra Re~.ma'taX, u~.ma 'Ri~.ma i~'tER.na nu se'gu~.du 'vEX.su, 'e~.tri a se'gu~.da i a 'sE.Ti~.ma 'si.la.bas, i 'ow.tra li'ga~.du u pri~'mej.ru aw teX'sej.ru 'vEX.su, 'ko~.mu Re.pre.ze~'ta.du nu Di.a'gra~.ma ki 'sE.gi
Guilherme (segundo Bandeira, o maior artista do verso em língua portuguesa) se destacará entre seus pares por transitar pelas diferentes formas poéticas sempre com maestria.	gi'LER.mi, se'gu~.du ba~'dej.ra, u maj'Or aX'Tis.ta du 'vEX.su e~j~ 'li~.gwa poX.tu'ge.za, si des.ta.ka'ra 'e~.tri 'sews 'pa.ris puX tra~.zi'taX 'pe.las Di.fe're~.Tis 'fOR.mas po'E.Ti.kas 'se~.pri ko~ ma.es'tri.a
Foi também Guilherme quem inaugurou, como já foi dito, as primeiras trocas de informações sobre o haiku e o haicai entre os primeiros imigrantes e seus descendentes e os poetas nativos.	'foj ta~'be~j~ gi'LER.mi 'ke~j~ i~.naw.gu'row, 'ko~.mu 'Za 'foj 'Di.tu, as pri~'mej.ras 'trO.kas Di i~.foR.ma'so~j~s 'so.bri u Raj'ku i u Raj'kaj 'e~.tri us pri~'mej.ruz i~.mi'gra~.Tiz i 'sews de.se~'de~.Tiz i us po'E.tas na'Ti.vus
Nesse contexto, o Guilherme e seguidores irão atualizar o espírito da escola Teimon na cena literária tupiniquim.	'ne.si ko~'tes.tu, u gi'LER.mi i se.gi'do.riz i'ra~w~ a.tu.a.li'zar u es'pi.ri.tu da es'kO.la tej~'mo~ na 'se~.na li.te'ra.rja tu.pi~.ni'ki~
Não se ache horrível pela manhã, acorde ao meio dia.	'na~w~ si 'a.Si o'Ri.vew 'pe.la ma~'Ja~, a'kOR.Di aw 'mej.u 'Di.a
Não existe uma pessoa totalmente inútil.	'na~w~ e'zis.Ti u~.ma pe'so.a to.taw'me~.Ti i~'nu.Tiw
Em último caso, serve como mau exemplo.	e~j~ 'uw.Ti~.mu 'ka.zu, 'sER.vi 'ko~.mu 'maw e'ze~.plu
Wilson Sanchez	'wiw.so~ 'sa~.Ses
Nenhum divertimento é tão barato quanto ler, nenhum prazer dura tanto.	ne~'Ju~ Di.veX.Ti~'me~.tu E 'ta~w~ ba'ra.tu 'kwa~.tu 'leX, ne~'Ju~ pra'zeR 'du.ra 'ta~.tu
Mary Wortley Montagu	'ma.ri 'wOX.Ti.lej mo~.ta'gu
O tempo que você passa rindo é o tempo que você passa com os deuses.	u 'te~.pu ki vo'se 'pa.sa 'Ri~.du E u 'te~.pu ki vo'se 'pa.sa ko~ us 'dew.zis
Provérbio Japonês	pro'vER.bju Za.po~'nejs
Não tenho um caminho novo.	'na~w~ 'te~.Ju u~ ka~'mi~.Ju 'no.vu
O que eu tenho novo é um jeito de caminhar.	u ki ew 'te~.Ju 'no.vu E u~ 'Zej.tu Di ka~.mi~'JaX
Thiago de Melo	ti'a.gu Di 'mE.lu
O que as vitórias têm de mal é que não são definitivas.	u ki as vi'tO.rjas 'te~j~ Di 'maw E ki 'na~w~ 'sa~w~ de.fi~.ni'Ti.vas
O que as derrotas têm de bom é que também não são definitivas.	u ki as de'RO.tas 'te~j~ Di 'bo~ E ki ta~'be~j~ 'na~w~ 'sa~w~ de.fi~.ni'Ti.vas
José Saramago	Zu'zE sa.ra~'ma.gu
Eu estou aprendendo tanto com meus erros que estou pensando em cometer mais alguns.	ew es'tow a.pre~'de~.du 'ta~.tu ko~ 'mewz 'e.Rus ki es'tow pe~'sa~.du e~j~ ko~.me'teR 'majz aw'gu~s
Ashleigh Brilliant	'ES.lej 'bri.lja~.Ti
As melhores coisas da vida não são as coisas.	as me'LO.ris 'koj.zas da 'vi.da 'na~w~ 'sa~w~ as 'koj.zas
Livros não mudam o mundo.	'li.vrus 'na~w~ 'mu.da~w~ u 'mu~.du
Quem muda o mundo são as pessoas.	'ke~j~ 'mu.da u 'mu~.du 'sa~w~ as pe'so.as
Os livros só mudam as pessoas.	us 'li.vrus 'sO 'mu.da~w~ as pe'so.as
Caio Graco	'kaj.u 'gra.ku
O pessimista vê a dificuldade em cada oportunidade, o otimista a oportunidade em cada dificuldade.	u pe.si~'mis.ta 've a Di.fi.kuw'da.Di e~j~ 'ka.da o.poX.tu~.ni'da.Di, u o.Ti~'mis.ta a o.poX.tu~.ni'da.Di e~j~ 'ka.da Di.fi.kuw'da.Di
Albert Flanders	'aw.beX.T 'fla~.deXs
Minha mente encontra o céu	'mi~.Ja 'me~.Ti e~'ko~.tra u 'sEw
A trajetória forma um véu	a tra.Ze'tO.rja 'fOR.ma u~ 'vEw
Minha mente descansa	'mi~.Ja 'me~.Ti des'ka~.sa
A imaginação avança	a i~.ma.Zi~.na'sa~w~ a'va~.sa
Vou te abraçar	'vow Ti a.bra'saX
Uma forma, um lugar	u~.ma 'fOR.ma, u~ lu'gaX
Meu destino é você	'mew des'Ti~.nu E vo'se
Minha paz interior	'mi~.Ja 'pajz i~.te.ri'oX
Eu vou sobreviver	ew 'vow so.bre.vi'veX
Encontrei o meu amor	e~.ko~'trej u 'mew a~'moX
Vagando e voando	va'ga~.du i vo'a~.du
Eu te encontrei	ew Ti e~.ko~'trej
Pairando e revoando	paj'ra~.du i Re.vo'a~.du
Minhas conclusões tirei	'mi~.Jas ko~.klu'zo~j~s Ti'rej
Cantando e meditando	ka~'ta~.du i me.Di'ta~.du
Eu te amei	ew Ti a~'mej
O sujeito, ao saber que a querida sogra viria visitá-los, mandou cortar o rabo do cachorro.	u su'Zej.tu, aw sa'beX ki a ke'ri.da 'sO.gra vi'ri.a vi.zi'ta lus, ma~'dow koX'tar u 'Ra.bu du ka'So.Ru
A esposa, indignada, pergunta: Mas querido, porque você fez isso?	a es'po.za, i~.Di.gi~'na.da, peR'gu~.ta, majs ke'ri.du, puX'ke vo'se 'fejz 'i.su
É simples.	E 'si~.plis
Quando a sua mãe chegar eu não quero ver nenhuma manifestação de alegria nesta casa!	'kwa~.du a 'su.a 'ma~j~ Se'gar ew 'na~w~ 'kE.ru 'veR ne~'Ju~.ma ma~.ni.fes.ta'sa~w~ Di a.le'gri.a 'nEs.ta 'ka.za
Sogra deveria ter só dois dentes: um para abrir garrafa e outro pra doer o dia inteiro.	'sO.gra de.ve'ri.a 'teX 'sO 'dojs 'de~.Tis, 'u~ 'pa.ra a'briR ga'Ra.fa i 'ow.tru pra do'er u 'Di.a i~'tej.ru
Genro é um homem casado com uma mulher cuja mãe se mete em tudo.	'Ze~.Ru E u~ 'o~.me~j~ ka'za.du ko~ u~.ma mu'LEX 'ku.Za 'ma~j~ si 'mE.Ti e~j~ 'tu.du
Mistérios da vida familiar: Como pode um genro que não presta para nada tornar-se o pai das crianças mais lindas e inteligentes do mundo?	mis'tE.rjus da 'vi.da fa~.mi.li'aX, 'ko~.mu 'pO.Di u~ 'Ze~.Ru ki 'na~w~ 'prEs.ta 'pa.ra 'na.da toR'naX si u 'paj das kri'a~.sas 'majs 'li~.daz i i~.te.li'Ze~.Tis du 'mu~.du
Sogra não é parente.	'sO.gra 'na~w~ E pa're~.Ti
É castigo.	E kas'Ti.gu
Feliz foi Adão que não teve sogra.	fe'lis 'foj a'da~w~ ki 'na~w~ 'te.vi 'sO.gra
A sogra venenosa é o único réptil do mundo que vê novela e faz tricô.	a 'sO.gra ve~.ne~'nO.za E u 'u~.ni.ku 'REp.Tiw du 'mu~.du ki 've no'vE.la i 'fajs tri'ko
Adoro a sogra da minha mulher.	a'dO.ru a 'sO.gra da 'mi~.Ja mu'LEX
A sogra ideal é aquela que não mora tão perto que possa vir de chinelos e nem tão longe que possa aparecer com as malas.	a 'sO.gra i.de'aw E a'kE.la ki 'na~w~ 'mO.ra 'ta~w~ 'pEX.tu ki 'pO.sa 'viR Di Si~'nE.luz i ne~j~ 'ta~w~ 'lo~.Zi ki 'pO.sa a.pa.re'seX ko~ as 'ma.las
Citado pelo meu cunhado Orlando Conceição, que sempre faz questão de dizer a todos que a minha mãe é a melhor sogra que ele tem.	si'ta.du 'pe.lu 'mew ku~'Ja.du oR'la~.du ko~.sej'sa~w~, ki 'se~.pri 'fajs kes'ta~w~ Di Di'zer a 'to.dus ki a 'mi~.Ja 'ma~j~ E a me'LOX 'sO.gra ki 'e.li 'te~j~
Sogra ideal é aquela que mora uns sete palmos abaixo do chão.	'sO.gra i.de'aw E a'kE.la ki 'mO.ra u~s 'sE.Ti 'paw.muz a'baj.Su du 'Sa~w~
Sogra: inferno a domicílio.	'sO.gra, i~'fER.nu a do~.mi'si.lju
Filha! Tô dentro.	'fi.La, 'to 'de~.tru
Querido, o relógio da sala caiu da parede e por pouco não bateu na cabeça da mamãe.	ke'ri.du, u Re'lO.Zju da 'sa.la ka'iw da pa're.Di i puX 'pow.ku 'na~w~ ba'tew na ka'be.sa da ma~'ma~j~
Maldito relógio! Sempre atrasado...	maw'Di.tu Re'lO.Zju, 'se~.pri a.tra'za.du
Minha sogra caiu do céu.	'mi~.Ja 'sO.gra ka'iw du 'sEw
A vassoura da véia quebrou enquanto ela sobrevoava minha casa.	a va'sow.ra da 'vEj.a ke'brow e~'kwa~.tu 'E.la so.bre.vo'a.va 'mi~.Ja 'ka.za
A pior punição da bigamia é ter duas sogras.	a pi'OX pu~.ni'sa~w~ da bi.ga~'mi.a E 'teR 'du.as 'sO.gras
Com uma sogra dessas, eu é que não quero outra!	ko~ u~.ma 'sO.gra 'dE.sas, ew E ki 'na~w~ 'kE.ru 'ow.tra
Só não mando minha sogra pro inferno porque tenho pena do capeta.	'sO 'na~w~ 'ma~.du 'mi~.Ja 'sO.gra pru i~'fER.nu puX'ke 'te~.Ju 'pe~.na du ka'pe.ta
Se sua sogra é uma jóia, nós temos a caixinha.	si 'su.a 'sO.gra E u~.ma 'ZOj.a, 'nOjs 'te~.muz a kaj'Si~.Ja
Senhor, receba-a com a mesma alegria com que te mando.	se~'JoX, Re'sE.ba a ko~ a 'mez.ma a.le'gri.a ko~ ki Ti 'ma~.du
Aqui jaz minha sogra: descanso em paz.	a'ki 'Zajz 'mi~.Ja 'sO.gra, des'ka~.su e~j~ 'pajs
Minha mulher fugiu com meu melhor amigo.	'mi~.Ja mu'LEX fu'Ziw ko~ 'mew me'LOr a~'mi.gu
E quem é esse filho da mãe?	i 'ke~j~ E 'e.si 'fi.Lu da 'ma~j~
Sei lá!	'sej 'la
Só sei que agora é o meu melhor amigo.	'sO 'sej ki a'gO.ra E u 'mew me'LOr a~'mi.gu
Se você vai fazer alguma coisa errada, aproveite.	si vo'se 'vaj fa'zer aw'gu~.ma 'koj.za e'Ra.da, a.pro'vej.Ti
Apressemo-nos a sucumbir à tentação antes que ela se vá.	a.pre'se~.mu nuz a su.ku~'bir a te~.ta'sa~w~ 'a~.Tis ki 'E.la si 'va
Um moralista é, quase sempre um hipócrita; uma moralista é, invariavelmente, um bagulho.	u~ mo.ra'lis.ta E, 'kwa.zi 'se~.pri u~ i'pO.kri.ta, u~.ma mo.ra'lis.ta E, i~.va.ri.a.vew'me~.Ti, u~ ba'gu.Lu
Bonitinha é uma mulher feia arrumada.	bo~.ni'Ti~.Ja E u~.ma mu'LEX 'fej.a a.Ru~'ma.da
Feia? Pra feia a coitadinha tinha que melhorar muito!	'fej.a, pra 'fej.a a koj.ta'Di~.Ja 'Ti~.Ja ki me.Lo'raR 'mu~j~.tu
Não era feia. Era lazarenta de feia!	'na~w~ 'E.ra 'fej.a, 'E.ra la.za're~.ta Di 'fej.a
Quem gosta de beleza interior é decorador.	'ke~j~ 'gOs.ta Di be'le.za i~.te.ri'or E de.ko.ra'doX
Dinheiro e mulher bonita só vejo na mão dos outros.	Di~'Jej.ru i mu'LER bo~'ni.ta 'sO 've.Zu na 'ma~w~ duz 'ow.trus
Algumas mulheres se acham tão lindas que, quando se olham no espelho, não se reconhecem.	aw'gu~.mas mu'LE.ris si 'a.Sa~w~ 'ta~w~ 'li~.das ki, 'kwa~.du si 'O.La~w~ nu es'pe.Lu, 'na~w~ si Re.ko~'JE.se~j~
Um dia a rosa encontrou a couve-flor e disse: que petulância se chamar de flor!	u~ 'Di.a a 'RO.za e~.ko~'trow a 'kow.vi 'flor i 'Di.si, ki pe.tu'la~.sja si Sa~'maR Di 'floX
Veja sua pele áspera sendo que a minha é lisa e sedosa.	've.Za 'su.a 'pE.li 'as.pe.ra 'se~.du ki a 'mi~.Ja E 'li.za i se'dO.za
Veja seu cheiro desagradável em comparação com o meu perfume sensual e envolvente.	've.Za 'sew 'Sej.ru de.za.gra'da.vew e~j~ ko~.pa.ra'sa~w~ ko~ u 'mew peX'fu~.mi se~.su'aw i e~.vow've~.Ti
Veja seu corpo grosseiro, e o meu, delgado e elegante.	've.Za 'sew 'koX.pu gro'sej.ru, i u 'mew, dew'ga.du i e.le'ga~.Ti
Eu sim sou uma flor!	ew 'si~ 'sow u~.ma 'floX
Marido de mulher feia acorda sempre assustado.	ma'ri.du Di mu'LEX 'fej.a a'kOR.da 'se~.pri a.sus'ta.du
Parceiro feio é que nem pantufa: dentro de casa pode até ser confortável, mas na rua dá uma vergonha!	paX'sej.ru 'fej.u E ki ne~j~ pa~'tu.fa, 'de~.tru Di 'ka.za 'pO.Di a'tE 'seX ko~.foX'ta.vew, majs na 'Ru.a 'da u~.ma veR'go~.Ja
Não há nada de errado com seu rosto que uma boa tijolada não possa melhorar.	'na~w~ 'a 'na.da Di e'Ra.du ko~ 'sew 'Ros.tu ki u~.ma 'bo.a Ti.Zo'la.da 'na~w~ 'pO.sa me.Lo'raX
Deixemos as mulheres bonitas para os homens sem imaginação.	dej'Se~.muz as mu'LE.ris bo~'ni.tas 'pa.ra uz 'o~.me~s se~j~ i~.ma.Zi~.na'sa~w~
Mula perdida e mulher feia só quem procura é o dono.	'mu.la peR'Di.da i mu'LEX 'fej.a 'sO 'ke~j~ pro'ku.ra E u 'do~.nu
Quem gosta de mulher feia é salão de beleza.	'ke~j~ 'gOs.ta Di mu'LEX 'fej.a E sa'la~w~ Di be'le.za
Não se gasta vela boa com defundo ruim.	'na~w~ si 'gas.ta 'vE.la 'bo.a ko~ de'fu~.du Ru'i~
Mau defunto, pouca cera.	'maw de'fu~.tu, 'pow.ka 'se.ra
Mocréia: Você tem que saber evitar!	mo'krEj.a, vo'se te~j~ ki sa'ber e.vi'taX
Um homem entra em casa correndo e grita para a mulher: Marta, Marta, arrume suas coisas.	u~ 'o~.me~j~ 'e~.tra e~j~ 'ka.za ko'Re~.du i 'gri.ta 'pa.ra a mu'LEX, 'maX.ta, 'maX.ta, a'Ru~.mi 'su.as 'koj.zas
Acabei de ganhar na loteria!	a.ka'bej Di ga~'JaR na lo.te'ri.a
E você acha melhor que eu leve roupas de frio ou de calor?	i vo'se 'a.Sa me'LOX ki ew 'lE.vi 'Row.pas Di 'fri.u ow Di ka'loX
Sabe como se chama aquele pedaço insensível localizado na base do pênis?	'sa.bi 'ko~.mu si 'Sa~.ma a'ke.li pe'da.su i~.se~'si.vew lo.ka.li'za.du na 'ba.zi du 'pe~.nis
Chama-se homem...	'Sa~.ma si 'o~.me~j~
Por que é tão difícil achar homens bonitos, sensíveis e carinhosos?	puX 'ke E 'ta~w~ Di'fi.siw a'Sar 'o~.me~s bo~'ni.tus, se~'si.vejz i ka.ri~'JO.zus
Porque normalmente eles já têm namorados.	puX'ke noR.maw'me~.Ti 'e.li'Za 'te~j~ na~.mo'ra.dus
Homem é como orelhão.	'o~.me~j~ E 'ko~.mu o.re'La~w~
A cidade está cheia deles, só que 75 porcento não funcionam e o restante está ocupado.	a si'da.Di es'ta 'Sej.a 'de.lis, 'sO ki se'te~.ta i 'si~.ku poX'se~.tu 'na~w~ fu~.si'o~.na~w~ i u Res'ta~.Ti es'ta o.ku'pa.du
Qual a semelhança entre um homem e um espermatozóide?	'kwaw a se~.me'La~.sa 'e~.tri u~ 'o~.me~j~ i u~ es.peR.ma.to'zOj.Di
Ambos têm uma chance em um milhão de se tornarem um dia seres humanos.	'a~.bus 'te~j~ u~.ma 'Sa~.si e~j~ 'u~ mi'La~w~ Di si toR'na.re~j~ u~ 'Di.a 'se.riz u~'ma~.nus
A mulher que não tem sorte com os homens não sabe a sorte que tem.	a mu'LEX ki 'na~w~ te~j~ 'sOX.Ti ko~ uz 'o~.me~s 'na~w~ 'sa.bi a 'sOX.Ti ki 'te~j~
Se você fisgar um homem, o melhor que faz é devolvê-lo ao mar.	si vo'se fiz'gar u~ 'o~.me~j~, u me'LOX ki 'fajz E de.vow've lu aw 'maX
Sabe qual é a ideia que os homens fazem sobre preliminares?	'sa.bi 'kwaw E a i'dej.a ki uz 'o~.me~s 'fa.ze~j~ 'so.bri pre.li~.mi~'na.ris
Meia hora de paquera.	'mej.a 'O.ra Di pa'kE.ra
Mamãe, mamãe, o que é um orgasmo?	ma~'ma~j~, ma~'ma~j~, u ki E u~ oR'gaz.mu
Não sei, pergunte ao seu pai.	'na~w~ 'sej, peR'gu~.Ti aw 'sew 'paj
Os homens são como relógios: uns se atrasam, outros se adiantam, poucos regulam bem.	uz 'o~.me~s 'sa~w~ 'ko~.mu Re'lO.Zjus, u~s si a'tra.za~w~, 'ow.trus si a.Di'a~.ta~w~, 'pow.kus Re'gu.la~w~ 'be~j~
O que os homens e as garrafas de cerveja têm em comum?	u ki uz 'o~.me~z i as ga'Ra.fas Di seR've.Za 'te~j~ e~j~ ko~'mu~
Ambos são vazios do pescoço pra cima.	'a~.bus 'sa~w~ va'zi.us du pes'ko.su pra 'si~.ma
Sabe por que a psicanálise é mais rápida pros homens do que para as mulheres?	'sa.bi puX 'ke a psi.ka~'na.li.zi E 'majs 'Ra.pi.da pruz 'o~.me~s du ki 'pa.ra as mu'LE.ris
Porque, quando dizem para eles voltarem à infância, eles já estão lá.	puX'ke, 'kwa~.du 'Di.ze~j~ 'pa.ra 'e.lis vow'ta.re~j~ a i~'fa~.sja, 'e.li'Za es'ta~w~ 'la
A mulher é capaz de fazer tudo que o homem faz, exceto xixi de pé, contra o muro.	a mu'LEr E ka'pajz Di fa'zeX 'tu.du ki u 'o~.me~j~ 'fajs, e'sE.tu Si'Si Di 'pE, 'ko~.tra u 'mu.ru
Se um homem comete um erro, as pessoas dizem: Que cara distraído!.	si u~ 'o~.me~j~ ko~'mE.Ti u~ 'e.Ru, as pe'so.as 'Di.ze~j~, ki 'ka.ra Dis.tra'i.du
Agora, quando esse erro é cometido por uma mulher, dizem mais ou menos assim: Essa mulherada é muito burra mesmo!	a'gO.ra, 'kwa~.du 'e.si 'e.Ru E ko~.me'Ti.du pur u~.ma mu'LEX, 'Di.ze~j~ 'majz ow 'me~.nuz a'si~, 'E.sa mu.Le'ra.da E 'mu~j~.tu 'bu.Ra 'mez.mu
Por que os homens gostam de mulheres inteligentes?	puX 'ke uz 'o~.me~s 'gOs.ta~w~ Di mu'LE.riz i~.te.li'Ze~.Tis
Porque os opostos se atraem.	puX'ke uz o'pOs.tus si a'tra.e~j~
Nunca subestime a capacidade de um homem de subestimar uma mulher.	'nu~.ka su.bes'Ti~.mi a ka.pa.si'da.Di Di u~ 'o~.me~j~ Di su.bes.Ti~'mar u~.ma mu'LEX
Para conquistar o sucesso, a mulher profissional deve parecer uma mulher, comportar-se como dama, pensar como homem e trabalhar como um cachorro.	'pa.ra ko~.kis'tar u su'sE.su, a mu'LEX pro.fi.si.o~'naw 'dE.vi pa.re'ser u~.ma mu'LEX, ko~.poX'taX si 'ko~.mu 'da~.ma, pe~'saX 'ko~.mu 'o~.me~j~ i tra.ba'LaX 'ko~.mu u~ ka'So.Ru
O que quer que as mulheres façam, devem fazer duas vezes melhor do que os homens para serem consideradas tão boas quanto eles.	u ki 'kEX ki as mu'LE.ris 'fa.sa~w~, 'dE.ve~j~ fa'zeR 'du.as 've.zis me'LOR du ki uz 'o~.me~s 'pa.ra 'se.re~j~ ko~.si.de'ra.das 'ta~w~ 'bo.as 'kwa~.tu 'e.lis
Felizmente, isso não é difícil.	fe.liz'me~.Ti, 'i.su 'na~w~ E Di'fi.siw
O primeiro-ministro britânico, Winston Churchill, discursava na Câmara dos Comuns.	u pri~'mej.ru mi~'nis.tru bri'ta~.ni.ku, 'wi~s.to~ 'SuX.Siww, Dis.kuX'sa.va na 'ka~.ma.ra dus ko~'mu~s
Nancy Astor, a primeira mulher eleita para fazer parte daquela casa, levantou-se e interrompeu, furiosa:	'na~.si as'toX, a pri~'mej.ra mu'LEr e'lej.ta 'pa.ra fa'zeX 'paX.Ti da'kE.la 'ka.za, le.va~'tow si i i~.te.Ro~'pew, fu.ri'O.za
Winston, se você fosse meu marido, eu poria veneno no seu café!	'wi~s.to~, si vo'se 'fo.si 'mew ma'ri.du, ew po'ri.a ve~'ne~.nu nu 'sew ka'fE
Churchill não pestanejou:	'SuX.Siw 'na~w~ pes.ta~.ne'Zow
Senhora, se eu fosse seu marido, tomaria o café.	se~'JO.ra, si ew 'fo.si 'sew ma'ri.du, to~.ma'ri.a u ka'fE
O bom senso das mulheres está colocado entre seus lábios.	u 'bo~ 'se~.su das mu'LE.riz es'ta ko.lo'ka.du 'e~.tri 'sews 'la.bjus
Logo que elas os abrem, escapa-se.	'lO.gu ki 'E.laz uz 'a.bre~j~, es'ka.pa si
Seguem alguns depoimentos comprobatórios desta teoria:	'sE.ge~j~ aw'gu~s de.po.i~'me~.tus ko~.pro.ba'tO.rjus 'dEs.ta te.o'ri.a
Você é de Santa Catarina?	vo'se E Di 'sa~.ta ka.ta'ri~.na
Oba, mais um gaúcho no meu programa!	'o.ba, 'majz 'u~ ga'u.Su nu 'mew pro'gra~.ma
A única coisa que me tira do sério é a injustiça.	a 'u~.ni.ka 'koj.za ki mi 'Ti.ra du 'sE.rju E a i~.Zus'Ti.sa
Principalmente contra quem não merece.	pri~.si.paw'me~.Ti 'ko~.tra 'ke~j~ 'na~w~ me'rE.si
A carreira artística é difícil porque tem muitas dificuldades.	a ka'Rej.ra aX'Tis.Ti.ka E Di'fi.siw puX'ke te~j~ 'mu~j~.tas Di.fi.kuw'da.Dis
Se houvesse um holocausto nuclear, qual casal (homem + mulher) você escolheria para preservar e multiplicar a raça humana?	si ow'vE.si u~ o.lo'kaws.tu nu.kle'aX, 'kwaw ka'zaw, 'o~.me~j~ 'majs mu'LEX, vo'se es.ko.Le'ri.a 'pa.ra pre.zeR'var i muw.Ti.pli'kar a 'Ra.sa u~'ma~.na
Resposta: O papa e a Madre Teresa de Calcutá.	Res'pOs.ta, u 'pa.pa i a 'ma.dri te're.za Di kaw.ku'ta
Eu vou intretenir vocês.	ew 'vow i~.tre.te~'niR vo'sejs
A mulher, em geral, prefere ser bonita do que inteligente, porque sabe que o homem, em geral, tem mais facilidade para olhar do que para pensar.	a mu'LEX, e~j~ Ze'raw, pre'fE.ri 'seR bo~'ni.ta du ki i~.te.li'Ze~.Ti, puX'ke 'sa.bi ki u 'o~.me~j~, e~j~ Ze'raw, te~j~ 'majs fa.si.li'da.Di 'pa.ra o'LaR du ki 'pa.ra pe~'saX
Da mesma forma que encontramos frequentemente homens inteligentes acompanhados de mulheres burras, dificilmente encontramos mulheres inteligentes acompanhadas de sujeitos burros.	da 'mez.ma 'fOR.ma ki e~.ko~'tra~.mus fre.kwe~.Ti~'me~.Ti 'o~.me~z i~.te.li'Ze~.Tiz a.ko~.pa~'Ja.dus Di mu'LE.ris 'bu.Ras, Di.fi.siw'me~.Ti e~.ko~'tra~.mus mu'LE.riz i~.te.li'Ze~.Tiz a.ko~.pa~'Ja.das Di su'Zej.tus 'bu.Rus
Isso significa que o julgamento da inteligência entre sexos é algo absolutamente relativo.	'i.su si.gi~.ni'fi.ka ki u Zuw.ga~'me~.tu da i~.te.li'Ze~.sja 'e~.tri 'sEk.suz E 'aw.gu ab.so.lu.ta~'me~.Ti Re.la'Ti.vu
O inventor do silicone merece um busto em praça pública.	u i~.ve~'toR du si.li'ko~.ni me'rE.si u~ 'bus.tu e~j~ 'pra.sa 'pu.bli.ka
Mas não o dele, é claro.	majs 'na~w~ u 'de.li, E 'kla.ru
tinha os seios tão flácidos que, se saísse correndo, era capaz de ficar com o olho roxo.	'Ti~.Ja us sej'us 'ta~w~ 'fla.si.dus ki, si sa'i.si ko'Re~.du, 'E.ra ka'pajz Di fi'kaX ko~ u 'o.Lu 'Ro.Su
Nem todos os peitos olham pra cima a vida toda.	ne~j~ 'to.duz us 'pej.tuz 'O.La~w~ pra 'si~.ma a 'vi.da 'to.da
Levantarei os caídos e oprimirei os grandes.	le.va~.ta'rej us ka'i.duz i o.pri~.mi'rej us 'gra~.Dis
Consolando a despeitada:	ko~.so'la~.du a des.pej'ta.da
É das uvas pequenas que sai o vinho mais doce.	E daz 'u.vas pe'ke~.nas ki 'saj u 'vi~.Ju 'majs 'do.si
Soneto triste da mulher de pequenos seios	so~'ne.tu 'tris.Ti da mu'LER Di pe'ke~.nus sej'us
Ó, tábua, planície sem elevação que rouba o bom sorriso do sutiã	'O, 'ta.bwa, pla~'ni.si se~j~ e.le.va'sa~w~ ki 'Row.ba u 'bo~ so'Ri.zu du su.Ti'a~
Ó, retilíneo e uniforme torso, de escassa ou quase nenhuma graça	'O, Re.Ti'li~.nju i u~.ni'fOR.mi 'toX.su, Di es'ka.sa ow 'kwa.zi ne~'Ju~.ma 'gra.sa
Nem com augusto, imagulado esforço: teu busto não se salva de meia-taça.	ne~j~ ko~ aw'gus.tu, i~.ma.gu'la.du es'foX.su, 'tew 'bus.tu 'na~w~ si 'saw.va Di 'mej.a 'ta.sa
Não chega a ser fulminante empecilho mas és diminuta nas lides do leito, imperfeita para amamentar o filho.	'na~w~ 'Se.ga a 'seX fuw.mi~'na~.Ti e~.pe'si.Lu majz 'Ejs Di~.mi~'nu.ta nas 'li.Dis du 'lej.tu, i~.peX'fej.ta 'pa.ra a~.ma~.me~'tar u 'fi.Lu
Ó, mulher, teus seios pequenos enjeito.	'O, mu'LEX, 'tews sej'us pe'ke~.nuz e~'Zej.tu
Todo homem tem quatro grandes sonhos: Ser tão bonito quanto a mãe acha que ele é, ter tanto dinheiro quanto o filho pensa que ele tem, possuir tantas mulheres quanto a mulher dele acha que ele possui e ser tão bom de cama quanto ele acredita ser.	'to.du 'o~.me~j~ te~j~ 'kwa.tru 'gra~.Dis 'so~.Jus, 'seX 'ta~w~ bo~'ni.tu 'kwa~.tu a 'ma~j~ 'a.Sa ki 'e.li E, 'teX 'ta~.tu Di~'Jej.ru 'kwa~.tu u 'fi.Lu 'pe~.sa ki 'e.li te~j~, po.su'iX 'ta~.tas mu'LE.ris 'kwa~.tu a mu'LER 'de.li 'a.Sa ki 'e.li po'suj i 'seX 'ta~w~ 'bo~ Di 'ka~.ma 'kwa~.tu 'e.li a.kre'Di.ta 'seX
Homens são como diplomas universitários: você leva um tempão para consegui-los e depois não sabe o que fazer com eles.	'o~.me~s 'sa~w~ 'ko~.mu Di'plo~.maz u~.ni.veX.si'ta.rjus, vo'se 'lE.va u~ te~'pa~w~ 'pa.ra ko~.se'gi luz i de'pojs 'na~w~ 'sa.bi u ki fa'zeX ko~ 'e.lis
As mulheres são como o vinho: com o passar dos anos umas refinam o sabor, outras azedam.	as mu'LE.ris 'sa~w~ 'ko~.mu u 'vi~.Ju, ko~ u pa'saR duz 'a~.nuz u~.mas Re'fi~.na~w~ u sa'boX, 'ow.traz a'zE.da~w~
Quanto mais conheço os homens mais gosto das mulheres.	'kwa~.tu 'majs ko~'Je.su uz 'o~.me~s 'majs 'gOs.tu das mu'LE.ris
Se Deus fez algo melhor que a mulher, ficou com ele.	si 'dews 'fejz 'aw.gu me'LOX ki a mu'LEX, fi'kow ko~ 'e.li
Sou tão viciado em mulher que acendo uma na outra.	'sow 'ta~w~ vi.si'a.du e~j~ mu'LEX ki a'se~.du u~.ma na 'ow.tra
Todo feminismo acaba com o primeiro pneu furado.	'to.du fe~.mi~'niz.mu a'ka.ba ko~ u pri~'mej.ru pi~'new fu'ra.du
Superdotado é um homem com QI de 50.	su.peR.do'ta.du E u~ 'o~.me~j~ ko~ 'ke 'i Di si~'kwe~.ta
Para uma conversação picante são necessárias três mulheres: duas para falar e uma para servir de assunto.	'pa.ra u~.ma ko~.veX.sa'sa~w~ pi'ka~.Ti 'sa~w~ ne.se'sa.rjas 'trejs mu'LE.ris, 'du.as 'pa.ra fa'lar i u~.ma 'pa.ra seR'viR Di a'su~.tu
Se você for chata, suas amigas a perdoam.	si vo'se 'foX 'Sa.ta, 'su.az a~'mi.gaz a peR'do.a~w~
Se você for brava, suas amigas a perdoam.	si vo'se 'foR 'bra.va, 'su.az a~'mi.gaz a peR'do.a~w~
Se você for egoísta, suas amigas a perdoam.	si vo'se 'for e.go'is.ta, 'su.az a~'mi.gaz a peR'do.a~w~
Agora, experimente ser magra e linda...	a'gO.ra, es.pe.ri~'me~.Ti 'seR 'ma.gra i 'li~.da
A amizade entre as mulheres é apenas uma suspensão de hostilidades.	a a~.mi'za.Di 'e~.tri as mu'LE.riz E a'pe~.naz u~.ma sus.pe~'sa~w~ Di os.Ti.li'da.Dis
Só há uma coisa na qual homens e mulheres concordam: nenhum dos dois confia em mulheres.	'sO 'a u~.ma 'koj.za na 'kwaw 'o~.me~z i mu'LE.ris ko~'kOR.da~w~, ne~'Ju~ dus 'dojs ko~'fi.a e~j~ mu'LE.ris
Como confiar em um ser que sangra cinco dias e não morre?	'ko~.mu ko~.fi'ar e~j~ u~ 'seX ki 'sa~.gra 'si~.ku 'Di.az i 'na~w~ 'mO.Ri
Quando sou boa, sou muito boa, mas quando sou má, sou melhor ainda.	'kwa~.du 'sow 'bo.a, 'sow 'mu~j~.tu 'bo.a, majs 'kwa~.du 'sow 'ma, 'sow me'LOr a'i~.da
O problema das mulheres é que elas se excitam com qualquer besteira.	u pro'ble~.ma das mu'LE.riz E ki 'E.las si e'si.ta~w~ ko~ kwaw'kER bes'tej.ra
E acabam se casando com ela...	i a'ka.ba~w~ si ka'za~.du ko~ 'E.la
Mulher não tira carteira de habilitação, tira porte de arma!	mu'LER 'na~w~ 'Ti.ra kaX'tej.ra Di a.bi.li.ta'sa~w~, 'Ti.ra 'pOX.Ti Di 'aR.ma
Sabe qual é a única certeza que podemos ter quando vemos uma mulher sinalizando com o braço pra fora de um carro?	'sa.bi 'kwaw E a 'u~.ni.ka seX'te.za ki po'de~.mus 'teX 'kwa~.du 've~.muz u~.ma mu'LEX si~.na.li'za~.du ko~ u 'bra.su pra 'fO.ra Di u~ 'ka.Ru
A de que ela está com o vidro aberto.	a Di ki 'E.la es'ta ko~ u 'vi.dru a'bEX.tu
Por que são necessários milhões de espermatozóides para fertilizar um único óvulo?	puX 'ke 'sa~w~ ne.se'sa.rjus mi'Lo~j~s Di es.peR.ma.to'zOj.Dis 'pa.ra feX.Ti.li'zar u~ 'u~.ni.ku 'O.vu.lu
A meleca é a melhor amiga do motorista solitário.	a me'lE.ka E a me'LOr a~'mi.ga du mo.to'ris.ta so.li'ta.rju
Ironia, frases soltas que deveriam ser presas	i.ro~'ni.a, 'fra.zis 'sow.tas ki de.ve'ri.a~w~ 'seX 'pre.zas
José Francisco de Lara	Zu'zE fra~'sis.ku Di 'la.ra
Barão de Itararé	ba'ra~w~ Di i.ta.ra'rE
Adaptado de uma frase de Luis Alberto López Mayer	a.dap'ta.du Di u~.ma 'fra.zi Di lu'iz aw'bEX.tu 'lO.pez 'maj.eX
Casseta e Planeta	ka'se.ta i pla~'ne.ta
Eduardo Doss	e.du'aR.du 'dOs
Vitor Caruso	vi'toX ka'ru.zu
Citado pelo meu cunhado Orlando Conceição	si'ta.du 'pe.lu 'mew ku~'Ja.du oR'la~.du ko~.sej'sa~w~
Citado por Paulo de Lara, meu avô	si'ta.du puX 'paw.lu Di 'la.ra, 'mew a'vo
Gloria Steinem	'glO.rja 'staj.ne~j~
Marquês de Maricá	maX'kejs Di ma.ri'ka
Charlotte Whitton	SaR'lO.Ti 'wi.to~
Provérbio curdo	pro'vER.bju 'kuR.du
Carla Perez	'kaR.la 'pE.res
Tânia Alves	'ta~.nja 'aw.vis
Suzana Alves, a Tiazinha	su'za~.na 'aw.vis, a Ti.a'zi~.Ja
Carolina Zuniga, durante o Miss Chile	ka.ro'li~.na zu~'ni.ga, du'ra~.Ti u 'miz 'Si.li
Licuana Gimenez, apresentadora de TV	li.ku'a~.na Zi~.me~'nejs, a.pre.ze~.ta'do.ra Di 'te 've
Carla Camurati	'kaR.la ka~.mu'ra.Ti
Yolanda Y. Hatem	jo'la~.da 'ip.si.lo~w~, Ra'te~j~
Eduardo Mercer	e.du'aR.du meX'seX
Henry Louis Mencken	'e~.Ri 'lu.is 'me~.ke~
Citado pelo meu amigo Washington Simões	si'ta.du 'pe.lu 'mew a~'mi.gu 'wa.Si~.to~ si~'mo~j~s
Mae West	'maj 'wEs.Ti
Cher, citada pela minha amiga Nara	'SEX, si'ta.da 'pe.la 'mi~.Ja a~'mi.ga 'na.ra
João Empolgação	Zo'a~w~ e~.pow.ga'sa~w~
Em um jantar japonês	e~j~ u~ Za~'taR Za.po~'nejs
Autor: Abraão Batista	aw'toX, a.bra'a~w~ ba'Tis.ta
Conheci um japonês	ko~.Je'si u~ Za.po~'nejs
de muita qualificação	Di 'mu~j~.ta kwa.li.fi.ka'sa~w~
diplomata e educado	Di.plo~'ma.ta i e.du'ka.du
representante do Japão	Re.pre.ze~'ta~.Ti du Za'pa~w~
amigo dos cordelistas	a~'mi.gu dus koR.de'lis.tas
com toda consideração.	ko~ 'to.da ko~.si.de.ra'sa~w~
Foi por causa de seu Takô	'foj puX 'kaw.za Di 'sew ta'ko
que conheci o Japonês;	ki ko~.Je'si u Za.po~'nejs
o diplomata, é cortês	u Di.plo~'ma.ta, E koX'tejs
portanto, escrevo aqui	poX'ta~.tu, es'kre.vu a'ki
na linha da intrepidez.	na 'li~.Ja da i~.tre.pi'dejs
Como no resto do mundo	'ko~.mu nu 'REs.tu du 'mu~.du
todo japonês é igual:	'to.du Za.po~'nejz E i'gwaw
no Brasil tem gente boa	nu bra'ziw te~j~ 'Ze~.Ti 'bo.a
lá no Japão, é sem rival	'la nu Za'pa~w~, E se~j~ Ri'vaw
no trato bom, refinado	nu 'tra.tu 'bo~, Re.fi~'na.du
de uma maneira total.	Di u~.ma ma~'nej.ra to'taw
Portanto, antes de tudo	poX'ta~.tu, 'a~.Tis Di 'tu.du
vou dar uma colocação	'vow 'dar u~.ma ko.lo.ka'sa~w~
para mostrar a meu leitor	'pa.ra mos'trar a 'mew lej'toX
a minha imaginação:	a 'mi~.Ja i~.ma.Zi~.na'sa~w~
o saber do diplomata	u sa'beR du Di.plo~'ma.ta
representante do Japão.	Re.pre.ze~'ta~.Ti du Za'pa~w~
Estava em minha casa	es'ta.va e~j~ 'mi~.Ja 'ka.za
no Juazeiro do Norte,	nu Zu.a'zej.ru du 'nOX.Ti
quando bateu no meu portão	'kwa~.du ba'tew nu 'mew poX'ta~w~
com simpatia bem forte	ko~ si~.pa'Ti.a 'be~j~ 'fOX.Ti
o Embaixador do Japão;	u e~.baj.Sa'doR du Za'pa~w~
então, desejei-lhe sorte.	e~'ta~w~, de.ze'Zej Li 'sOX.Ti
Bom dia! Ó meu amigo.	'bo~ 'Di.a, 'O 'mew a~'mi.gu
como vai, como passou?	'ko~.mu 'vaj, 'ko~.mu pa'sow
Que surpresa vê-lo aqui...	ki suX'pre.za 've lu a'ki
Você quase assustou.	vo'se 'kwa.zi a.sus'tow
a sua presença, digo	a 'su.a pre'ze~.sa, 'Di.gu
é saudável, e agradou.	E saw'da.vew, i a.gra'dow
Eu o conheci em Brasília	ew u ko~.Je'si e~j~ bra'zi.lja
na Feira do Livro de lá;	na 'fej.ra du 'li.vru Di 'la
e você aqui, agora...	i vo'se a'ki, a'gO.ra
O que traz então, por cá?	u ki 'trajz e~'ta~w~, puX 'ka
O japonês disse, então	u Za.po~'nejs 'Di.si, e~'ta~w~
Quero vê-lo como está.	'kE.ru 've lu 'ko~.mu es'ta
Quero ver o seu trabalho:	'kE.ru 'ver u 'sew tra'ba.Lu
como é xilogravador...	'ko~.mu E Si.lo.gra.va'doX
Da sua xilogravura	da 'su.a Si.lo.gra'vu.ra
sou um bom apreciador	'sow u~ 'bo~ a.pre.si.a'doX
alias, dos nordestinos	a'li.as, dus noR.des'Ti~.nus
sou grande admirador.	'sow 'gra~.Di a.Di~.mi.ra'doX
AB, Você traz uma surpresa	'a 'be, vo'se 'trajz u~.ma suX'pre.za
de visita prazerosa,	Di vi'zi.ta pra.ze'rO.za
a nossa casa é esta	a 'nO.sa 'ka.za E 'Es.ta
agradável e mimosa	a.gra'da.vew i mi~'mO.za
e olhando as gravuras	i o'La~.du as gra'vu.ras
entramos em boa prosa.	e~'tra~.muz e~j~ 'bo.a 'prO.za
Conversa vai, conversa vem,	ko~'vEX.sa 'vaj, ko~'vEX.sa 've~j~
o japonês, à vontade;	u Za.po~'nejs, a vo~'ta.Di
ofereci-lhe umas laranjas,	o.fe.re'si Li u~.mas la'ra~.Zas
ele chupou a metade	'e.li Su'pow a me'ta.Di
daquelas que ofereci,	da'kE.las ki o.fe.re'si
para dizer a verdade.	'pa.ra Di'zer a veR'da.Di
S. O. Quando for à Brasília	'E.si 'O 'kwa~.du 'for a bra'zi.lja
eu quero jantar com você.	ew 'kE.ru Za~'taX ko~ vo'se
Disse-me o Diplomata	'Di.si mi u Di.plo~'ma.ta
me colocando à mercê	mi ko.lo'ka~.du a meX'se
da mais pura diplomacia	da 'majs 'pu.ra Di.plo~.ma'si.a
do suchi, arroz e saquê.	du su'Si, a'Rojz i sa'ke
Já em Brasília, Otaquê	'Za e~j~ bra'zi.lja, o.ta'ke
foi me visitar outra vez	'foj mi vi.zi'tar 'ow.tra 'vejs
com sua esposa querida,	ko~ 'su.a es'po.za ke'ri.da
simpática, muito cortês	si~'pa.Ti.ka, 'mu~j~.tu koX'tejs
pedindo para marcar	pe'Di~.du 'pa.ra maX'kaX
o jantar para nós três.	u Za~'taX 'pa.ra 'nOjs 'trejs
José Lourenço, o gravador	Zu'zE low're~.su, u gra.va'doX
da terra de meu Padrinho:	da 'tE.Ra Di 'mew pa'dri~.Ju
Manasses, que também mostra	ma~'na.sis, ki ta~'be~j~ 'mOs.tra
de Bezerros, o seu caminho	Di be'ze.Rus, u 'sew ka~'mi~.Ju
que é filho de Jota Borges	ki E 'fi.Lu Di 'ZO.ta 'bOR.Zis
que vive no seu cantinho.	ki 'vi.vi nu 'sew ka~'Ti~.Ju
Foi Valter da Entre Livros	'foj 'vaw.teR da 'e~.tri 'li.vrus
o nosso comunicador	u 'nO.su ko~.mu~.ni.ka'doX
para marcar o dia certo	'pa.ra maX'kar u 'Di.a 'sEX.tu
do jantar empreendedor	du Za~'tar e~.pre.e~.de'doX
ficando todos felizes	fi'ka~.du 'to.dus fe'li.zis
dando aplausos e valor.	'da~.du a'plaw.zuz i va'loX
Eu disse para Otaquê:	ew 'Di.si 'pa.ra o.ta'ke
eu posso, então, convidar	ew 'pO.su, e~'ta~w~, ko~.vi'daX
dois amigos estudiosos	'dojz a~'mi.guz es.tu.Di'O.zus
pra enriquecer o jantar?	pra e~.Ri.ke'ser u Za~'taX
Com eles poderemos ter	ko~ 'e.lis po.de're~.mus 'teX
muito o que comemorar.	'mu~j~.tu u ki ko~.me~.mo'raX
Ficou, então, nosso jantar	fi'kow, e~'ta~w~, 'nO.su Za~'taX
elegante, confirmado	e.le'ga~.Ti, ko~.fiR'ma.du
no restaurante Saquê	nu Res.taw'ra~.Ti sa'ke
foi muito bem indicado	'foj 'mu~j~.tu 'be~j~ i~.Di'ka.du
e na hora que tinha dito	i na 'O.ra ki 'Ti~.Ja 'Di.tu
foi todo mundo achado.	'foj 'to.du 'mu~.du a'Sa.du
Primeiro, os gravadores:	pri~'mej.ru, us gra.va'do.ris
Manassés, Lourenço e eu,	ma~.na'sEjs, low're~.su i ew
logo no centro do salão	'lO.gu nu 'se~.tru du sa'la~w~
o Embaixador apareceu;	u e~.baj.Sa'dor a.pa.re'sew
levantou-se em japonês	le.va~'tow si e~j~ Za.po~'nejs
porque nos reconheceu.	puX'ke nus Re.ko~.Je'sew
Sentamos à mesa, todos,	se~'ta~.muz a 'me.za, 'to.dus
Manasses, à cabeceira,	ma~'na.sis, a ka.be'sej.ra
Lourenço, bem ao meu lado;	low're~.su, 'be~j~ aw 'mew 'la.du
com muita calma e maneira	ko~ 'mu~j~.ta 'kaw.ma i ma~'nej.ra
Otakê, à nossa frente	o.ta'ke, a 'nO.sa 'fre~.Ti
num proceder de primeira.	nu~ pro.se'deR Di pri~'mej.ra
Em seguida chegou Geová	e~j~ se'gi.da Se'gow Ze.o'va
que também é cordelista	ki ta~'be~j~ E koR.de'lis.ta
acompanhado da esposa	a.ko~.pa~'Ja.du da es'po.za
que entrou na nossa lista	ki e~'trow na 'nO.sa 'lis.ta
