Por causa do amor, a jovem escolheu dar sua vida para salvar o noivo e as tribos da morte certa.	puX 'kaw.za du a~'moX, a 'ZO.ve~j~ es.ko'Lew 'daX 'su.a 'vi.da 'pa.ra saw'var u 'noj.vu i as 'tri.bus da 'mOX.Ti 'sEX.ta
Mas, dessa vez, Missy ficou quieta quando a história terminou.	majs, 'dE.sa 'vejs, 'mi.si fi'kow ki'E.ta 'kwa~.du a is'tO.rja teR.mi~'now
Virou-se imediatamente e dirigiu-se para a van, como se dissesse: Tudo bem, não tenho mais nada para fazer aqui. Vamos indo.	vi'row si i~.me.Di.a.ta~'me~.Ti i Di.ri'Ziw si 'pa.ra a 'va~, 'ko~.mu si Di'sE.si, 'tu.du 'be~j~, 'na~w~ 'te~.Ju 'majs 'na.da 'pa.ra fa'zer a'ki, 'va~.muz 'i~.du
O lago e o local de acampamento ficavam poucos quilômetros depois de Joseph.	u 'la.gu i u lo'kaw Di a.ka~.pa~'me~.tu fi'ka.va~w~ 'pow.kus ki'lo~.me.trus de'pojs Di 'Zo.zef
Quando chegaram, arrumaram tudo, não exatamente como Nan teria preferido, mas do jeito que lhes pareceu melhor.	'kwa~.du Se'ga.ra~w~, a.Ru~'ma.ra~w~ 'tu.du, 'na~w~ e.za.ta~'me~.Ti 'ko~.mu 'na~ te'ri.a pre.fe'ri.du, majs du 'Zej.tu ki Lis pa.re'sew me'LOX
Naquele fim de tarde, sentado entre as três crianças que riam assistindo a um dos maiores espetáculos da natureza, o coração de Mack foi subitamente inundado por uma alegria inesperada.	na'ke.li 'fi~ Di 'taR.Di, se~'ta.du 'e~.tri as 'trejs kri'a~.sas ki 'Ri.a~w~ a.sis'Ti~.du a 'u~ dus maj'O.riz es.pe'ta.ku.lus da na.tu're.za, u ko.ra'sa~w~ Di 'mE.ki 'foj su.bi.ta~'me~.Ti i~.nu~'da.du pur u~.ma a.le'gri.a i~.nes.pe'ra.da
Um pôr-do-sol de cores e padrões brilhantes destacava as poucas nuvens que haviam esperado nas coxias para se tornarem os atores centrais nessa apresentação única.	u~ 'poX du 'sOw Di 'ko.riz i pa'dro~j~s bri'La~.Tis des.ta'ka.va as 'pow.kas 'nu.ve~s ki a'vi.a~w~ es.pe'ra.du nas ko'Si.as 'pa.ra si toR'na.re~j~ uz a'to.ris se~'trajs 'nE.sa a.pre.ze~.ta'sa~w~ 'u~.ni.ka
Ele era um homem rico, pensou, em todos os sentidos que mais importavam.	'e.li 'E.ra u~ 'o~.me~j~ 'Ri.ku, pe~'sow, e~j~ 'to.duz us se~'Ti.dus ki 'majz i~.poX'ta.va~w~
Quando acabaram de limpar os restos do jantar, a noite havia caído.	'kwa~.du a.ka'ba.ra~w~ Di li~'par us 'REs.tus du Za~'taX, a 'noj.Ti a'vi.a ka'i.du
Os cervos tinham ido para o lugar onde dormem.	us 'sER.vus 'Ti~.Ja~w~ 'i.du 'pa.ra u lu'gar 'o~.Di 'dOR.me~j~
Seu turno foi substituído pelos encrenqueiros noturnos: guaxinins, esquilos e tâmias, que perambulavam em bandos procurando qualquer recipiente ligeiramente aberto.	'sew 'tuR.nu 'foj subs.Ti.tu'i.du 'pe.luz e~.kre~'kej.rus no'tuR.nus, gwa.Si~'ni~s, es'ki.luz i 'ta~.mjas, ki pe.ra~.bu'la.va~w~ e~j~ 'ba~.dus pro.ku'ra~.du kwaw'kE.Re.si.pi'e~.Ti li.Zej.ra~'me~.Ti a'bEX.tu
Os Phillips sabiam disso por experiência própria.	us 'fi.lips sa'bi.a~w~ 'Di.su pur es.pe.ri'e~.sja 'prO.prja
A primeira noite que tinham passado nesses locais de acampamento lhes custara quatro dúzias de barras de cereal, uma caixa de chocolate e todos os biscoitos de creme de amendoim.	a pri~'mej.ra 'noj.Ti ki 'Ti~.Ja~w~ pa'sa.du 'ne.sis lo'kajs Di a.ka~.pa~'me~.tu Lis kus'ta.ra 'kwa.tru 'du.zjas Di 'ba.Ras Di se.re'aw, u~.ma 'kaj.Sa Di So.ko'la.Ti i 'to.duz us bis'koj.tus Di 'kre~.mi Di a~.me~.do'i~
Mack era capaz de ficar horas deitado olhando aquela vastidão.	'mE.ki 'E.ra ka'pajz Di fi'kar 'O.ras dej'ta.du o'La~.du a'kE.la vas.Ti'da~w~
Sentia-se incrivelmente pequeno, mas em paz.	se~'Ti.a si i~.kri.vew'me~.Ti pe'ke~.nu, majz e~j~ 'pajs
De todos os lugares em que a presença de Deus se fazia sentir, era ali, rodeado pela natureza e sob as estrelas, um dos mais tocantes.	Di 'to.duz us lu'ga.riz e~j~ ki a pre'ze~.sa Di 'dews si fa'zi.a se~'TiX, 'E.ra a'li, Ro.de'a.du 'pe.la na.tu're.za i sob az es'tre.las, 'u~ dus 'majs to'ka~.Tis
Quase podia ouvir o hino de adoração que os astros faziam ao Criador, e em seu coração relutante ele participava do melhor modo possível.	'kwa.zi po'Di.a ow'vir u 'i~.nu Di a.do.ra'sa~w~ ki uz 'as.trus fa'zi.a~w~ aw kri.a'doX, i e~j~ 'sew ko.ra'sa~w~ Re.lu'ta~.Ti 'e.li paX.Ti.si'pa.va du me'LOR 'mO.du po'si.vew
Então voltaram ao acampamento e, depois de várias viagens aos banheiros, Mack enfiou os três na segurança de seus sacos de dormir.	e~'ta~w~ vow'ta.ra~w~ aw a.ka~.pa~'me~.tu i, de'pojs Di 'va.rjas vi'a.Ze~z aws ba~'Jej.rus, 'mE.ki e~.fi'ow us 'trejs na se.gu'ra~.sa Di 'sews 'sa.kus Di doR'miX
Orou brevemente com Josh antes de ir até onde Kate e Missy estavam esperando.	o'row brE.ve~'me~.Ti ko~ 'ZOS 'a~.Tis Di 'ir a'tE 'o~.Di 'kej.Ti i 'mi.si es'ta.va~w~ es.pe'ra~.du
Quando chegou a vez de Missy orar, ela quis conversar com o pai.	'kwa~.du Se'gow a 'vejz Di 'mi.si o'raX, 'E.la 'kis ko~.veX'saX ko~ u 'paj
Papai, por que ela teve de morrer?	pa'paj, puX 'ke 'E.la 'te.vi Di mo'ReX
Mack demorou um momento para descobrir do que Missy estava falando.	'mE.ki de~.mo'row u~ mo~'me~.tu 'pa.ra des.ko'briR du ki 'mi.si es'ta.va fa'la~.du
Percebeu subitamente que a princesa índia devia estar na cabeça da menina desde cedo, quando ele contara a história.	peX.se'bew su.bi.ta~'me~.Ti ki a pri~'se.za 'i~.Dja de'vi.a es'taR na ka'be.sa da me~'ni~.na 'dez.Di 'se.du, 'kwa~.du 'e.li ko~'ta.ra a is'tO.rja
Querida, ela não teve de morrer.	ke'ri.da, 'E.la 'na~w~ 'te.vi Di mo'ReX
Ela escolheu morrer para salvar seu povo.	'E.la es.ko'Lew mo'ReX 'pa.ra saw'vaX 'sew 'po.vu
Eles estavam doentes e ela queria que se curassem.	'e.liz es'ta.va~w~ do'e~.Tiz i 'E.la ke'ri.a ki si ku'ra.se~j~
Houve um silêncio e Mack soube que outra pergunta estava se formando no escuro.	'ow.vi u~ si'le~.sju i 'mE.ki 'sow.bi ki 'ow.tra peR'gu~.ta es'ta.va si foR'ma~.du nu es'ku.ru
Isso aconteceu mesmo?	'i.su a.ko~.te'sew 'mez.mu
A pergunta agora vinha de Kate, obviamente interessada na conversa.	a peR'gu~.ta a'gO.ra 'vi~.Ja Di 'kej.Ti, Ob.vi.a~'me~.Ti i~.te.re'sa.da na ko~'vEX.sa
Mack pensou antes de falar.	'mE.ki pe~'sow 'a~.Tis Di fa'laX
Não sei, Kate.	'na~w~ 'sej, 'kej.Ti
É uma lenda, e às vezes as lendas são histórias que ensinam uma lição.	E u~.ma 'le~.da, i as 've.ziz as 'le~.das 'sa~w~ is'tO.rjas ki e~'si~.na~w~ u~.ma li'sa~w~
Então não aconteceu de verdade? perguntou Missy.	e~'ta~w~ 'na~w~ a.ko~.te'sew Di veR'da.Di, peR.gu~'tow 'mi.si
De novo silêncio, e depois: Então a morte de Jesus é uma lenda?	Di 'no.vu si'le~.sju, i de'pojs, e~'ta~w~ a 'mOX.Ti Di Ze'zujz E u~.ma 'le~.da
Mack podia ouvir as engrenagens girando na mente de Kate.	'mE.ki po'Di.a ow'vir az e~.gre~'na.Ze~s Zi'ra~.du na 'me~.Ti Di 'kej.Ti
Não, querida, a história de Jesus é verdadeira. E sabe de uma coisa?	'na~w~, ke'ri.da, a is'tO.rja Di Ze'zujz E veR.da'dej.ra, i 'sa.bi Di u~.ma 'koj.za
Acho que a história da princesa índia provavelmente também é.	'a.Su ki a is'tO.rja da pri~'se.za 'i~.Dja pro.va.vew'me~.Ti ta~'be~j~ E
Mack esperou enquanto suas filhas processavam os pensamentos.	'mE.ki es.pe'row e~'kwa~.tu 'su.as 'fi.Las pro.se'sa.va~w~ us pe~.sa~'me~.tus
Missy foi a próxima a perguntar: O Grande Espírito é outro nome para Deus?	'mi.si 'foj a 'prO.si~.ma a peR.gu~'taX, u 'gra~.Di es'pi.ri.tu E 'ow.tru 'no~.mi 'pa.ra 'dews
Você sabe, o pai de Jesus?	vo'se 'sa.bi, u 'paj Di Ze'zujs
Mack sorriu no escuro.	'mE.ki so'Riw nu es'ku.ru
Obviamente as orações noturnas de Nan estavam surtindo efeito.	Ob.vi.a~'me~.Ti az o.ra'so~j~s no'tuR.nas Di 'na~ es'ta.va~w~ suX'Ti~.du e'fej.tu
Acho que sim.	'a.Su ki 'si~
É um bom nome para Deus, porque ele é um espírito e é grande.	E u~ 'bo~ 'no~.mi 'pa.ra 'dews, puX'ke 'e.li E u~ es'pi.ri.tu i E 'gra~.Di
Então por que ele é tão mau?	e~'ta~w~ puX 'ke 'e.li E 'ta~w~ 'maw
Ah, ali estava a pergunta que viera crescendo na cabecinha da filha.	'a, a'li es'ta.va a peR'gu~.ta ki vi'E.ra kre'se~.du na ka.be'si~.Ja da 'fi.La
Como assim, Missy?	'ko~.mu a'si~, 'mi.si
Bom, o Grande Espírito fez a princesa pular do penhasco e fez Jesus morrer numa cruz.	'bo~, u 'gra~.Di es'pi.ri.tu 'fejz a pri~'se.za pu'laR du pe~'Jas.ku i 'fejz Ze'zujs mo'ReR 'nu~.ma 'krujs
Isso parece muito mau.	'i.su pa'rE.si 'mu~j~.tu 'maw
Mack ficou travado.	'mE.ki fi'kow tra'va.du
Não sabia como responder.	'na~w~ sa'bi.a 'ko~.mu Res.po~'deX
Com seis anos e meio, Missy estava fazendo perguntas com as quais pessoas sábias haviam lutado durante séculos.	ko~ 'sejz 'a~.nuz i 'mej.u, 'mi.si es'ta.va fa'ze~.du peR'gu~.tas ko~ as 'kwajs pe'so.as 'sa.bjaz a'vi.a~w~ lu'ta.du du'ra~.Ti 'sE.ku.lus
Querida, Jesus não achava que o pai dele era mau.	ke'ri.da, Ze'zujs 'na~w~ a'Sa.va ki u 'paj 'de.li 'E.ra 'maw
Achava que o pai era cheio de amor e que o amava muito.	a'Sa.va ki u 'paj 'E.ra 'Sej.u Di a~'mor i ki u a~'ma.va 'mu~j~.tu
O pai dele não o fez morrer.	u 'paj 'de.li 'na~w~ u 'fejz mo'ReX
Ele nos salvou da doença, como a princesa.	'e.li nus saw'vow da do'e~.sa, 'ko~.mu a pri~'se.za
Agora veio o silêncio mais longo e Mack começou a imaginar que a menina teria caído no sono.	a'gO.ra 'vej.u u si'le~.sju 'majs 'lo~.gu i 'mE.ki ko~.me'sow a i~.ma.Zi~'naX ki a me~'ni~.na te'ri.a ka'i.du nu 'so~.nu
Quando ia se inclinar para lhes dar um beijo, uma vozinha com um tremor perceptível rompeu a quietude.	'kwa~.du 'i.a si i~.kli~'naX 'pa.ra Lis 'dar u~ 'bej.Zu, u~.ma vo'zi~.Ja ko~ u~ tre~'moX peX.sep'Ti.vew Ro~'pew a ki.e'tu.Di
Sim, querida?	'si~, ke'ri.da
Algum dia eu vou ter de pular de um penhasco?	aw'gu~ 'Di.a ew 'vow 'teR Di pu'laR Di u~ pe~'Jas.ku
O coração de Mack doeu quando ele entendeu a verdadeira questão.	u ko.ra'sa~w~ Di 'mE.ki do'ew 'kwa~.du 'e.li e~.te~'dew a veR.da'dej.ra kes'ta~w~
Abraçou a menininha e a apertou.	a.bra'sow a me~.ni~'ni~.Ja i a a.peX'tow
Com a voz um pouco mais rouca do que o usual, respondeu gentilmente: Não, querida.	ko~ a 'vOjz u~ 'pow.ku 'majs 'Row.ka du ki u u.zu'aw, Res.po~'dew Ze~.Tiw'me~.Ti, 'na~w~, ke'ri.da
Nunca vou pedir para você pular de um penhasco, nunca, nunca, jamais.	'nu~.ka 'vow pe'DiX 'pa.ra vo'se pu'laR Di u~ pe~'Jas.ku, 'nu~.ka, 'nu~.ka, Za~'majs
Então Deus vai me pedir para pular de um penhasco?	e~'ta~w~ 'dews 'vaj mi pe'DiX 'pa.ra pu'laR Di u~ pe~'Jas.ku
Não, Missy.	'na~w~, 'mi.si
Ele nunca pediria que você fizesse uma coisa dessas.	'e.li 'nu~.ka pe.Di'ri.a ki vo'se fi'zE.si u~.ma 'koj.za 'dE.sas
Ela se aninhou mais fundo em seus braços.	'E.la si a~.ni~'Jow 'majs 'fu~.du e~j~ 'sews 'bra.sus
Está bem!	es'ta 'be~j~
Me dá um abraço apertado.	mi 'da u~ a'bra.su a.peX'ta.du
Boa noite, papai.	'bo.a 'noj.Ti, pa'paj
Eu te amo.	ew Ti 'a~.mu
E apagou, caindo num sono profundo embalado por sonhos bons e doces.	i a.pa'gow, ka'i~.du nu~ 'so~.nu pro'fu~.du e~.ba'la.du puX 'so~.Jus 'bo~z i 'do.sis
Depois de alguns minutos, Mack a colocou suavemente no saco de dormir.	de'pojs Di aw'gu~s mi~'nu.tus, 'mE.ki a ko.lo'kow su.a.ve~'me~.Ti nu 'sa.ku Di doR'miX
Você está bem, Kate? sussurrou enquanto lhe dava um beijo.	vo'se es'ta 'be~j~, 'kej.Ti, su.su'Row e~'kwa~.tu Li 'da.va u~ 'bej.Zu
Estou, veio a resposta murmurada.	es'tow, 'vej.u a Res'pOs.ta muR.mu'ra.da
O que é, querida?	u ki E, ke'ri.da
A Missy faz perguntas boas, não é?	a 'mi.si 'fajs peR'gu~.tas 'bo.as, 'na~w~ E
Com certeza.	ko~ seX'te.za
É uma menininha especial.	E u~.ma me~.ni~'ni~.Ja es.pe.si'aw
Agora durma, temos um grande dia pela frente.	a'gO.ra 'duR.ma, 'te~.muz u~ 'gra~.Di 'Di.a 'pe.la 'fre~.Ti
Lindos sonhos, querida.	'li~.dus 'so~.Jus, ke'ri.da
Você também, pai.	vo'se ta~'be~j~, 'paj
Te amo demais!	Ti 'a~.mu de~'majs
Te amo também, de todo o coração.	Ti 'a~.mu ta~'be~j~, Di 'to.du u ko.ra'sa~w~
Boa noite.	'bo.a 'noj.Ti
Mack fechou o zíper do reboque ao sair, assoou o nariz e enxugou as lágrimas que desciam pelo rosto.	'mE.ki fe'Sow u 'zi.peR du Re'bO.ki aw sa'iX, a.so'ow u na'riz i e~.Su'gow as 'la.gri~.mas ki de'si.a~w~ 'pe.lu 'Ros.tu
Fez uma oração silenciosa de agradecimento a Deus e foi coar um pouco de café.	'fejz u~.ma o.ra'sa~w~ si.le~.si'O.za Di a.gra.de.si~'me~.tu a 'dewz i 'foj ko'ar u~ 'pow.ku Di ka'fE
A alma é curada ao estar com crianças.	a 'aw.ma E ku'ra.da aw es'taX ko~ kri'a~.sas
O Parque Estadual do Lago Wallowa, no Oregon, e a área ao redor têm sido chamados, com propriedade, de Pequena Suíça da América.	u 'paX.ki es.ta.du'aw du 'la.gu 'wa.lo.wa, nu 'O.re.go~, i a 'a.rja aw Re'dOX 'te~j~ 'si.du Sa~'ma.dus, ko~ pro.pri.e'da.Di, Di pe'ke~.na su'i.sa da a~'mE.ri.ka
Montanhas escarpadas e agrestes erguem-se até quase 3 mil metros e, no meio delas, há inúmeros vales escondidos cheios  de riachos, trilhas de caminhada e altas campinas cobertas de  flores silvestres.	mo~'ta~.Jaz es.kaX'pa.daz i a'grEs.Tiz 'ER.ge~j~ si a'tE 'kwa.zi 'trejs 'miw 'mE.truz i, nu 'mej.u 'dE.las, 'a i~'nu~.me.rus 'va.liz es.ko~'Di.du'Sej.us Di Ri'a.Sus, 'tri.Las Di ka~.mi~'Ja.da i 'aw.tas ka~'pi~.nas ko'bEX.tas Di 'flo.ris siw'vEs.tris
O lago Wallowa é a passagem para a Área de  Recreação Nacional de Hells Canyon, onde está o maior desfiladeiro da América do Norte.	u 'la.gu 'wa.lo.wa E a pa'sa.Ze~j~ 'pa.ra a 'a.rja Di Re.kre.a'sa~w~ na.si.o~'naw Di 'REws 'ke~.njo~, 'o~.Di es'ta u maj'OR des.fi.la'dej.ru da a~'mE.ri.ka du 'nOX.Ti
Esculpido no decorrer de séculos pelo rio Snake, em alguns lugares tem mais de 3  quilômetros do topo à base, e às vezes 16 quilômetros de uma borda à outra.	es.kuw'pi.du nu de.ko'ReR Di 'sE.ku.lus 'pe.lu 'Ri.u 'snej.ki, e~j~ aw'gu~s lu'ga.ris te~j~ 'majs Di 'trejs ki'lo~.me.trus du 'to.pu a 'ba.zi, i as 've.zis de.ze'sejs ki'lo~.me.trus Di u~.ma 'bOR.da a 'ow.tra
Na Área de Recreação há mais de 1400 quilômetros de trilhas de caminhada.	na 'a.rja Di Re.kre.a'sa~w~ 'a 'majs Di 'miw i kwa.tro'se~.tus ki'lo~.me.trus Di 'tri.Las Di ka~.mi~'Ja.da
Os vestígios da presença da tribo Nez Perce, que antes dominava a região, estão espalhados por essa vastidão, junto com os dos colonos brancos que passavam a caminho do Oeste.	us ves'Ti.Zjus da pre'ze~.sa da 'tri.bu 'nEjs 'pEX.si, ki 'a~.Tis do~.mi~'na.va a Re.Zi'a~w~, es'ta~w~ es.pa'La.dus pur 'E.sa vas.Ti'da~w~, 'Zu~.tu ko~ us dus ko'lo~.nus 'bra~.kus ki pa'sa.va~w~ a ka~'mi~.Ju du o'Es.Ti
O lago Wallowa mede 8 quilômetros de comprimento e um e meio de largura e foi formado, segundo alguns, por geleiras que ali se encontravam há 9 milhões de anos.	u 'la.gu 'wa.lo.wa 'mE.Di 'oj.tu ki'lo~.me.trus Di ko~.pri~'me~.tu i 'u~ i 'mej.u Di laR'gu.ra i 'foj foR'ma.du, se'gu~.du aw'gu~s, puR Ze'lej.ras ki a'li si e~.ko~'tra.va~w~ 'a 'nO.vi mi'Lo~j~s Di 'a~.nus
A temperatura da água é de tirar o fôlego durante a maior parte do ano, mas fica agradável no fim do verão para um nado rápido perto da margem.	a te~.pe.ra'tu.ra da 'a.gwa E Di Ti'rar u 'fo.le.gu du'ra~.Ti a maj'OX 'paX.Ti du 'a~.nu, majs 'fi.ka a.gra'da.vew nu 'fi~ du ve'ra~w~ 'pa.ra u~ 'na.du 'Ra.pi.du 'pEX.tu da 'maR.Ze~j~
Mack e as crianças preencheram os três dias seguintes com diversão e lazer.	'mE.ki i as kri'a~.sas pre.e~'Se.ra~w~ us 'trejs 'Di.as se'gi~.Tis ko~ Di.veX'sa~w~ i la'zeX
Missy, aparentemente satisfeita com as respostas do pai, não voltou ao assunto da princesa, mesmo quando uma caminhada diurna os levou perto de penhascos altíssimos.	'mi.si, a.pa.re~.Ti~'me~.Ti sa.Tis'fej.ta ko~ as Res'pOs.tas du 'paj, 'na~w~ vow'tow aw a'su~.tu da pri~'se.za, 'mez.mu 'kwa~.du u~.ma ka~.mi~'Ja.da Di'uR.na us le'vow 'pEX.tu Di pe~'Jas.kuz aw'Ti.si~.mus
Passaram algumas horas andando de pedalinho junto à margem do lago, esforçaram-se ao máximo para ganhar um prêmio no minigolfe, cavalgaram nas trilhas e visitaram as lojinhas da cidade de Joseph.	pa'sa.ra~w~ aw'gu~.maz 'O.raz a~'da~.du Di pe.da'li~.Ju 'Zu~.tu a 'maR.Ze~j~ du 'la.gu, es.foX'sa.ra~w~ si aw 'ma.si~.mu 'pa.ra ga~'Jar u~ 'pre~.mju nu mi~.ni'gow.fi, ka.vaw'ga.ra~w~ nas 'tri.Laz i vi.zi'ta.ra~w~ as lo'Zi~.Jas da si'da.Di Di 'Zo.zef
Ao longo do fim de semana, duas outras famílias juntaram-se magicamente ao mundo dos Phillips.	aw 'lo~.gu du 'fi~ Di se~'ma~.na, 'du.az 'ow.tras fa~'mi.lja.Zu~'ta.ra~w~ si ma.Zi.ka~'me~.Ti aw 'mu~.du dus 'fi.lips
Como acontece frequentemente, as crianças deram início à amizade.	'ko~.mu a.ko~'tE.si fre.kwe~.Ti~'me~.Ti, as kri'a~.sas 'dE.ra~w~ i~'ni.sju a a~.mi'za.Di
Josh gostou especialmente de conhecer os Ducette, pois a filha mais velha, Amber, era uma linda mocinha mais ou menos da sua idade.	'ZOS gos'tow es.pe.si.aw'me~.Ti Di ko~.Je'ser us du'sE.Ti, 'pojz a 'fi.La 'majs 'vE.La, 'a~.beX, 'E.ra u~.ma 'li~.da mo'si~.Ja 'majz ow 'me~.nus da 'su.a i'da.Di
Kate adorou implicar com o irmão mais velho por causa disso, e ele reagiu indo irritado para a carreta-barraca, vociferando e resmungando.	'kej.Ti a.do'row i~.pli'kaX ko~ u iR'ma~w~ 'majs 'vE.Lu puX 'kaw.za 'Di.su, i 'e.li Re.a'Ziw 'i~.du i.Ri'ta.du 'pa.ra a ka'Re.ta ba'Ra.ka, vo.si.fe'ra~.du i Rez.mu~'ga~.du
Amber tinha uma irmã, Emmy, apenas um ano mais nova do que Kate, e as duas passaram a brincar juntas.	'a~.beX 'Ti~.Ja u~.ma iR'ma~, 'e~.mi, a'pe~.naz 'u~ 'a~.nu 'majs 'nO.va du ki 'kej.Ti, i as 'du.as pa'sa.ra~w~ a bri~'kaR 'Zu~.tas
Os Ducette apresentaram Mack e os filhos a um casal canadense que haviam conhecido antes, Jesse e Sarah Madison.	us du'sE.Ti a.pre.ze~'ta.ra~w~ 'mE.ki i us 'fi.Luz a u~ ka'zaw ka~.na'de~.si ki a'vi.a~w~ ko~.Je'si.du 'a~.Tis, 'ZE.si i 'sa.ra 'ma.Di.so~
Pareciam tranquilos, despretensiosos, e Mack gostou deles à primeira vista.	pa.re'si.a~w~ tra~'kwi.lus, des.pre.te~.si'O.zus, i 'mE.ki gos'tow 'de.liz a pri~'mej.ra 'vis.ta
Os dois trabalhavam como consultores independentes, Jesse na área de recursos humanos e Sarah na de administração.	us 'dojs tra.ba'La.va~w~ 'ko~.mu ko~.suw'to.riz i~.de.pe~'de~.Tis, 'ZE.si na 'a.rja Di Re'kuX.suz u~'ma~.nuz i 'sa.ra na Di a.Di~.mi~.nis.tra'sa~w~
Armados de máquinas fotográficas, óculos escuros, garrafas dágua e protetor solar, partiram no meio da manhã.	aR'ma.dus Di 'ma.ki~.nas fo.to'gra.fi.kas, 'O.ku.luz es'ku.rus, ga'Ra.fas 'da.gwa i pro.te'toX so'laX, paX'Ti.ra~w~ nu 'mej.u da ma~'Ja~
Como já imaginavam, fizeram uma verdadeira festa com hambúrgueres, batatas fritas e milk-shakes no restaurante.	'ko~.mu 'Za i~.ma.Zi~'na.va~w~, fi'zE.ra~w~ u~.ma veR.da'dej.ra 'fEs.ta ko~ a~'buR.ge.ris, ba'ta.tas 'fri.taz i 'miw.ki 'Sej.kis nu Res.taw'ra~.Ti
A altitude estimulou o apetite, até Missy conseguiu devorar um hambúrguer inteiro e a maior parte das outras guloseimas.	a aw.Ti'tu.Di es.Ti~.mu'low u a.pe'Ti.Ti, a'tE 'mi.si ko~.se'giw de.vo'rar u~ a~'buR.ger i~'tej.ru i a maj'OX 'paX.Ti daz 'ow.tras gu.lo'zej.mas
Este é um daqueles momentos raros e preciosos, pensou Mack, que pegam a gente de surpresa e quase tiram o fôlego. Se Nan estivesse aqui, seria realmente perfeito.	'es.Ti E 'u~ da'ke.lis mo~'me~.tus 'Ra.ruz i pre.si'O.zus, pe~'sow 'mE.ki, ki 'pE.ga~w~ a 'Ze~.Ti Di suX'pre.za i 'kwa.zi 'Ti.ra~w~ u 'fo.le.gu, si 'na~ es.Ti'vE.si a'ki, se'ri.a Re.aw'me~.Ti peX'fej.tu
Ajeitou o peso de Missy numa posição mais confortável para ela e tirou o cabelo do rosto da menina para olhá-la.	a.Zej'tow u 'pe.zu Di 'mi.si 'nu~.ma po.zi'sa~w~ 'majs ko~.foX'ta.vew 'pa.ra 'E.la i Ti'row u ka'be.lu du 'Ros.tu da me~'ni~.na 'pa.ra o'La la
A sujeira e o suor do dia só faziam, estranhamente, aumentar seu ar de inocência e sua beleza.	a su'Zej.ra i u su'OR du 'Di.a 'sO fa'zi.a~w~, es.tra~.Ja~'me~.Ti, aw~.me~'taX 'sew 'aR Di i~.no'se~.sja i 'su.a be'le.za
Por que eles têm de crescer? pensou ao dar um beijo na testa da filha.	puX 'ke 'e.lis 'te~j~ Di kre'seX, pe~'sow aw 'dar u~ 'bej.Zu na 'tEs.ta da 'fi.La
Naquela noite, as três famílias se reuniram para um último jantar juntos.	na'kE.la 'noj.Ti, as 'trejs fa~'mi.ljas si Re.u~'ni.ra~w~ 'pa.ra u~ 'uw.Ti~.mu Za~'taR 'Zu~.tus
Mais tarde, os adultos sentaram-se bebericando café ao redor de uma fogueira, enquanto Emil contava suas aventuras em operações contra quadrilhas de contrabando de animais em extinção.	'majs 'taR.Di, uz a'duw.tus se~'ta.ra~w~ si be.be.ri'ka~.du ka'fE aw Re'dOR Di u~.ma fo'gej.ra, e~'kwa~.tu e~'miw ko~'ta.va 'su.az a.ve~'tu.raz e~j~ o.pe.ra'so~j~s 'ko~.tra kwa'dri.Las Di ko~.tra'ba~.du Di a~.ni~'majz e~j~ es.Ti~'sa~w~
Era um narrador hábil e sua profissão oferecia um enorme elenco de histórias hilariantes.	'E.ra u~ na.Ra'dor 'a.biw i 'su.a pro.fi'sa~w~ o.fe.re'si.a u~ e~'nOR.mi e'le~.ku Di is'tO.rjaz i.la.ri'a~.Tis
Tudo era fascínio e Mack voltou a ser inundado por um intenso bem-estar.	'tu.du 'E.ra fa'si~.nju i 'mE.ki vow'tow a 'ser i~.nu~'da.du pur u~ i~'te~.su 'be~j~ es'taX
Como acontece frequentemente quando uma fogueira de acampamento arde por muito tempo, a conversa passou do  humorístico para o mais pessoal.	'ko~.mu a.ko~'tE.si fre.kwe~.Ti~'me~.Ti 'kwa~.du u~.ma fo'gej.ra Di a.ka~.pa~'me~.tu 'aR.Di puR 'mu~j~.tu 'te~.pu, a ko~'vEX.sa pa'sow du u~.mo'ris.Ti.ku 'pa.ra u 'majs pe.so'aw
Sarah parecia ansiosa para conhecer melhor o resto da família de Mack, especialmente Nan.	'sa.ra pa.re'si.a a~.si'O.za 'pa.ra ko~.Je'seR me'LOr u 'REs.tu da fa~'mi.lja Di 'mE.ki, es.pe.si.aw'me~.Ti 'na~
Como ela é, Mackenzie?	'ko~.mu 'E.la E, ma'ke~.zi
Mack adorava exaltar as maravilhas de sua Nan.	'mE.ki a.do'ra.va e.zaw'tar as ma.ra'vi.Las Di 'su.a 'na~
Modéstia à parte, Nan é linda por dentro e por fora. Sorriu encabulado e viu os dois olhando afetuosamente para ele.	mo'dEs.Tja 'a 'paX.Ti, 'na~ E 'li~.da puR 'de~.tru i puX 'fO.ra, so'Riw e~.ka.bu'la.du i 'viw us 'dojz o'La~.du a.fe.tu.O.za~'me~.Ti 'pa.ra 'e.li
Estava realmente com saudade de sua mulher.	es'ta.va Re.aw'me~.Ti ko~ saw'da.Di Di 'su.a mu'LEX
Tem uma tremenda reputação na comunidade médica, pelo menos no Noroeste.	te~j~ u~.ma tre~'me~.da Re.pu.ta'sa~w~ na ko~.mu~.ni'da.Di 'mE.Di.ka, 'pe.lu 'me~.nus nu no.ro'Es.Ti
É enfermeira e trabalha com pacientes terminais de câncer.	E e~.feR'mej.ra i tra'ba.La ko~ pa.si'e~.Tis teR.mi~'najs Di 'ka~.seX
É um trabalho duro, mas ela adora.	E u~ tra'ba.Lu 'du.ru, majz 'E.la a'dO.ra
Bom, Nan escreveu alguns textos e tem feito palestras em congressos.	'bo~, 'na~ es.kre'vew aw'gu~s 'tes.tuz i te~j~ 'fej.tu pa'lEs.traz e~j~ ko~'grE.sus
Verdade? perguntou Sarah.	veR'da.Di, peR.gu~'tow 'sa.ra
Sobre o que ela fala?	'so.bri u ki 'E.la 'fa.la
Ela ajuda as pessoas que estão diante da morte a pensarem no relacionamento com Deus.	'E.la a'Zu.da as pe'so.as ki es'ta~w~ Di'a~.Ti da 'mOX.Ti a pe~'sa.re~j~ nu Re.la.si.o~.na~'me~.tu ko~ 'dews
Eu adoraria ouvir mais sobre isso, encorajou Jesse enquanto atiçava o fogo com um graveto, fazendo-o avivar-se com  vigor renovado.	ew a.do.ra'ri.a ow'viR 'majs 'so.bri 'i.su, e~.ko.ra'Zow 'ZE.si e~'kwa~.tu a.Ti'sa.va u 'fo.gu ko~ u~ gra've.tu, fa'ze~.du u a.vi'vaX si ko~ vi'go.Re~.no'va.du
Mack hesitou.	'mE.ki e.zi'tow
Por mais que se sentisse à vontade com aqueles dois, não os conhecia de fato e a forma como a conversa se aprofundara o deixava meio inquieto.	puR 'majs ki si se~'Ti.si a vo~'ta.Di ko~ a'ke.lis 'dojs, 'na~w~ us ko~.Je'si.a Di 'fa.tu i a 'fOR.ma 'ko~.mu a ko~'vEX.sa si a.pro.fu~'da.ra u dej'Sa.va 'mej.u i~.ki'E.tu
Procurou responder de maneira sucinta.	pro.ku'row Res.po~'deR Di ma~'nej.ra su'si~.ta
Nan é muito melhor nisso do que eu.	'na~ E 'mu~j~.tu me'LOR 'ni.su du ki ew
Claro que faz, exclamou Sarah, enquanto Jesse confirmava com a cabeça.	'kla.ru ki 'fajs, es.kla~'mow 'sa.ra, e~'kwa~.tu 'ZE.si ko~.fiR'ma.va ko~ a ka'be.sa
Não, respondeu Mack rindo.	'na~w~, Res.po~'dew 'mE.ki 'Ri~.du
As crianças às vezes chamam, mas eu não me sinto confortável com isso.	as kri'a~.saz as 've.zi'Sa~.ma~w~, majz ew 'na~w~ mi 'si~.tu ko~.foX'ta.vew ko~ 'i.su
Parece um pouco familiar demais para mim.	pa'rE.si u~ 'pow.ku fa~.mi.li'aR de~'majs 'pa.ra 'mi~
De qualquer modo, Nan tem um pai maravilhoso e, por isso, acho que é mais fácil para ela.	Di kwaw'kER 'mO.du, 'na~ te~j~ u~ 'paj ma.ra.vi'Lo.zu i, pur 'i.su, 'a.Su ki E 'majs 'fa.siw 'pa.ra 'E.la
A coisa havia escapado e Mack estremeceu por dentro esperando que ninguém tivesse percebido; mas Jesse o olhava com  interesse.	a 'koj.za a'vi.a es.ka'pa.du i 'mE.ki es.tre~.me'sew puR 'de~.tru es.pe'ra~.du ki ni~'ge~j~ Ti'vE.si peX.se'bi.du, ma'ZE.si u o'La.va ko~ i~.te're.si
Seu pai não era maravilhoso? perguntou com gentileza.	'sew 'paj 'na~w~ 'E.ra ma.ra.vi'Lo.zu, peR.gu~'tow ko~ Ze~.Ti'le.za
É. Mack fez uma pausa.	E, 'mE.ki 'fejz u~.ma 'paw.za
Acho que se pode dizer que ele não era maravilhoso.	'a.Su ki si 'pO.Di Di'zeX ki 'e.li 'na~w~ 'E.ra ma.ra.vi'Lo.zu
Morreu quando eu era criança, de causas naturais.	mo'Rew 'kwa~.du ew 'E.ra kri'a~.sa, Di 'kaw.zas na.tu'rajs
Riu, mas o som foi oco.	'Riw, majz u 'so~ 'foj 'o.ku
Olhou para os dois.	o'Low 'pa.ra us 'dojs
Bebeu até morrer.	be'bew a'tE mo'ReX
Bom, ele observou, forçando outro riso, às vezes a vida é dura, mas eu tenho muita coisa para agradecer.	'bo~, 'e.li ob.seR'vow, foX'sa~.du 'ow.tru 'Ri.zu, as 've.ziz a 'vi.da E 'du.ra, majz ew 'te~.Ju 'mu~j~.ta 'koj.za 'pa.ra a.gra.de'seX
Seguiu-se um silêncio incômodo e Mack se perguntou por que estava falando sobre essas coisas com aqueles dois.	se'giw si u~ si'le~.sju i~'ko~.mo.du i 'mE.ki si peR.gu~'tow puX 'ke es'ta.va fa'la~.du 'so.bri 'E.sas 'koj.zas ko~ a'ke.lis 'dojs
Segundos depois foi resgatado por um jorro de crianças que se derramaram do trailer para o meio deles.	se'gu~.dus de'pojs 'foj Rez.ga'ta.du pur u~ 'Zo.Ru Di kri'a~.sas ki si de.Ra~'ma.ra~w~ du traj'leX 'pa.ra u 'mej.u 'de.lis
Josh estava tão fascinado que nem chegou a protestar.	'ZOS es'ta.va 'ta~w~ fa.si~'na.du ki ne~j~ Se'gow a pro.tes'taX
Quando os Madison se despediram de Mack e de seus filhos, Sarah bateu carinhosamente no ombro do novo amigo.	'kwa~.du us 'ma.Di.so~ si des.pe'Di.ra~w~ Di 'mE.ki i Di 'sews 'fi.Lus, 'sa.ra ba'tew ka.ri~.JO.za~'me~.Ti nu 'o~.bru du 'no.vu a~'mi.gu
Sorriu e virou-se para arrebanhar sua turma na direção dos sacos de dormir.	so'Riw i vi'row si 'pa.ra a.Re.ba~'JaX 'su.a 'tuR.ma na Di.re'sa~w~ dus 'sa.kus Di doR'miX
As orações foram feitas, seguidas por beijos de boa noite e risinhos de Kate conversando baixo com o irmão mais velho.	az o.ra'so~j~s 'fo.ra~w~ 'fej.tas, se'gi.das puR 'bej.Zus Di 'bo.a 'noj.Ti i Ri'zi~.Jus Di 'kej.Ti ko~.veX'sa~.du 'baj.Su ko~ u iR'ma~w~ 'majs 'vE.Lu
E, finalmente, silêncio.	i, fi~.naw'me~.Ti, si'le~.sju
Mack arrumou o que pôde usando a luz das lanternas e decidiu deixar o resto para o dia seguinte.	'mE.ki a.Ru~'mow u ki 'po.Di u'za~.du a 'lujz das la~'tER.naz i de.si'Diw dej'Sar u 'REs.tu 'pa.ra u 'Di.a se'gi~.Ti
De qualquer modo, só planejavam partir no início da tarde.	Di kwaw'kER 'mO.du, 'sO pla~.ne'Za.va~w~ paX'TiR nu i~'ni.sju da 'taR.Di
Estava sozinho, mas não solitário.	es'ta.va sO'zi~.Ju, majs 'na~w~ so.li'ta.rju
Esse não era o verso de uma música conhecida?	'e.si 'na~w~ 'E.ra u 'vEX.su Di u~.ma 'mu.zi.ka ko~.Je'si.da
Não tinha certeza, mas, se conseguisse lembrar, procuraria o CD quando chegasse em casa.	'na~w~ 'Ti~.Ja seX'te.za, majs, si ko~.se'gi.si le~'braX, pro.ku.ra'ri.a u 'se 'de 'kwa~.du Se'ga.si e~j~ 'ka.za
Hipnotizado pelo fogo e envolvido por seu calor, orou, principalmente orações de agradecimento.	ip.no.Ti'za.du 'pe.lu 'fo.gu i e~.vow'vi.du puX 'sew ka'loX, o'row, pri~.si.paw'me~.Ti o.ra'so~j~s Di a.gra.de.si~'me~.tu
Tinha consciência dos privilégios que recebera.	'Ti~.Ja ko~.si'e~.sja dus pri.vi'lE.Zjus ki Re.se'bE.ra
Bênçãos provavelmente era a palavra certa.	'be~.sa~w~s pro.va.vew'me~.Ti 'E.ra a pa'la.vra 'sEX.ta
Estava contente, descansado e em paz.	es'ta.va ko~'te~.Ti, des.ka~'sa.du i e~j~ 'pajs
Mack não sabia, mas em menos de 24 horas suas orações mudariam.	'mE.ki 'na~w~ sa'bi.a, majz e~j~ 'me~.nus Di 'vi~.Ti i 'kwa.tru 'O.ras 'su.az o.ra'so~j~s mu.da'ri.a~w~
A manhã seguinte, apesar de ensolarada e quente, não começou tão bem.	a ma~'Ja~ se'gi~.Ti, a.pe'zaR Di e~.so.la'ra.da i 'ke~.Ti, 'na~w~ ko~.me'sow 'ta~w~ 'be~j~
Mack acordou cedo para surpreender as crianças com um café da manhã especial, mas queimou dois dedos quando tentava soltar as panquecas que haviam grudado na frigideira.	'mE.ki a.koR'dow 'se.du 'pa.ra suX.pre.e~'der as kri'a~.sas ko~ u~ ka'fE da ma~'Ja~ es.pe.si'aw, majs kej~'mow 'dojs 'de.dus 'kwa~.du te~'ta.va sow'tar as pa~'kE.kas ki a'vi.a~w~ gru'da.du na fri.Zi'dej.ra
Reagindo à dor lancinante, derrubou o fogão, a frigideira e a tigela de massa no chão arenoso.	Re.a'Zi~.du a 'doR la~.si~'na~.Ti, de.Ru'bow u fo'ga~w~, a fri.Zi'dej.ra i a Ti'ZE.la Di 'ma.sa nu 'Sa~w~ a.re~'no.zu
Começaram a rir quando descobriram o que era, mas bastou um Ei, isso não é engraçado! de Mack para voltarem para dentro da barraca, rindo escondidas enquanto olhavam pelas janelas de tela.	ko~.me'sa.ra~w~ a 'RiX 'kwa~.du des.ko'bri.ra~w~ u ki 'E.ra, majs bas'tow u~ 'ej, 'i.su 'na~w~ E e~.gra'sa.du, Di 'mE.ki 'pa.ra vow'ta.re~j~ 'pa.ra 'de~.tru da ba'Ra.ka, 'Ri~.du es.ko~'Di.daz e~'kwa~.tu o'La.va~w~ 'pe.la.Za~'nE.las Di 'tE.la
Assim, em vez do planejado, o café da manhã se resumiu a cereal frio com creme de leite diluído, já que o resto do leite fora usado na massa de panqueca.	a'si~, e~j~ 'vejz du pla~.ne'Za.du, u ka'fE da ma~'Ja~ si Re.zu~'miw a se.re'aw 'fri.u ko~ 'kre~.mi Di 'lej.Ti Di.lu'i.du, 'Za ki u 'REs.tu du 'lej.Ti 'fo.ra u'za.du na 'ma.sa Di pa~'kE.ka
Mack passou a hora seguinte tentando arrumar o acampamento com dois dedos enfiados num copo de água gelada.	'mE.ki pa'sow a 'O.ra se'gi~.Ti te~'ta~.du a.Ru~'mar u a.ka~.pa~'me~.tu ko~ 'dojs 'de.duz e~.fi'a.dus nu~ 'kO.pu Di 'a.gwa Ze'la.da
A notícia devia ter se espalhado, porque Sarah Madison apareceu com material de primeiros socorros para queimaduras.	a no'Ti.sja de'vi.a 'teX si es.pa'La.du, puX'ke 'sa.ra 'ma.Di.so~ a.pa.re'sew ko~ ma.te.ri'aw Di pri~'mej.rus so'kO.Rus 'pa.ra kej~.ma'du.ras
Minutos depois de ter seus dedos cobertos por um líquido esbranquiçado, Mack sentiu a ardência diminuir.	mi~'nu.tus de'pojs Di 'teX 'sews 'de.dus ko'bEX.tus pur u~ 'li.ki.du ez.bra~.ki'sa.du, 'mE.ki se~'Tiw a aR'de~.sja Di~.mi~.nu'iX
Mais ou menos nessa hora, tendo terminado suas tarefas, Josh e Kate vieram perguntar se poderiam dar um último passeio na canoa dos Ducette, prometendo usar coletes salva-vidas.	'majz ow 'me~.nus 'nE.sa 'O.ra, 'te~.du teR.mi~'na.du 'su.as ta'rE.fas, 'ZOS i 'kej.Ti vi'E.ra~w~ peR.gu~'taX si po.de'ri.a~w~ 'dar u~ 'uw.Ti~.mu pa'sej.u na ka~'no.a dus du'sE.Ti, pro~.me'te~.du u'zaX ko'le.Tis 'saw.va 'vi.das
Depois do inevitável não inicial e da insistência dos filhos, Mack finalmente cedeu.	de'pojs du i~.ne.vi'ta.vew 'na~w~ i~.ni.si'aw i da i~.sis'te~.sja dus 'fi.Lus, 'mE.ki fi~.naw'me~.Ti se'dew
Não estava muito preocupado.	'na~w~ es'ta.va 'mu~j~.tu prew.ku'pa.du
O acampamento ficava pertinho do lago e eles prometeram não se afastar da margem.	u a.ka~.pa~'me~.tu fi'ka.va peX'Ti~.Ju du 'la.gu i 'e.lis pro~.me'te.ra~w~ 'na~w~ si a.fas'taR da 'maR.Ze~j~
Mack poderia vigiá-los enquanto continuava a guardar as coisas.	'mE.ki po.de'ri.a vi.Zi'a lus e~'kwa~.tu ko~.Ti~.nu'a.va a gwaR'dar as 'koj.zas
Missy estava ocupada colorindo o livro da cachoeira Multnomah.	'mi.si es'ta.va o.ku'pa.da ko.lo'ri~.du u 'li.vru da ka.So'ej.ra muw.Ti~.no~'ma
Ela é linda demais, pensou Mack, olhando embevecido a filha enquanto limpava a sujeira.	'E.la E 'li~.da de~'majs, pe~'sow 'mE.ki, o'La~.du e~.be.ve'si.du a 'fi.La e~'kwa~.tu li~'pa.va a su'Zej.ra
Cerca de 15 minutos depois, Mack levantou os olhos ao ouvir uma voz familiar chamando do lago: Papai!	'seX.ka Di 'ki~.zi mi~'nu.tus de'pojs, 'mE.ki le.va~'tow uz 'O.Luz aw ow'vir u~.ma 'vOjs fa~.mi.li'aX Sa~'ma~.du du 'la.gu, pa'paj
Era Kate.	'E.ra 'kej.Ti
Ela e o irmão acenaram do bote.	'E.la i u iR'ma~w~ a.se~'na.ra~w~ du 'bO.Ti
Ambos usavam os coletes salva-vidas e Mack acenou de volta.	'a~.buz u'za.va~w~ us ko'le.Tis 'saw.va 'vi.daz i 'mE.ki a.se~'now Di 'vOw.ta
É estranho como um ato ou acontecimento aparentemente insignificante pode mudar vidas inteiras.	E es'tra~.Ju 'ko~.mu u~ 'a.tu ow a.ko~.te.si~'me~.tu a.pa.re~.Ti~'me~.Ti i~.si.gi~.ni.fi'ka~.Ti 'pO.Di mu'daR 'vi.daz i~'tej.ras
Levantando o remo para acenar, Kate perdeu o equilíbrio e emborcou a canoa.	le.va~'ta~.du u 'Re~.mu 'pa.ra a.se~'naX, 'kej.Ti peR'dew u e.ki'li.brju i e~.boX'kow a ka~'no.a
Surgiu uma expressão congelada de terror em seu rosto enquanto, quase em silêncio e em câmara lenta, o barco virava.	suR'Ziw u~.ma es.pre'sa~w~ ko~.Ze'la.da Di te'Ror e~j~ 'sew 'Ros.tu e~'kwa~.tu, 'kwa.zi e~j~ si'le~.sju i e~j~ 'ka~.ma.ra 'le~.ta, u 'baX.ku vi'ra.va
Josh se inclinou freneticamente para tentar equilibrá-lo, mas era tarde demais e ele desapareceu na água.	'ZOS si i~.kli~'now fre~.nE.Ti.ka~'me~.Ti 'pa.ra te~'tar e.ki.li'bra lu, majz 'E.ra 'taR.Di de~'majz i 'e.li de.za.pa.re'sew na 'a.gwa
Mack já corria para a beira do lago, não pretendendo entrar, mas para estar perto quando eles saíssem.	'mE.ki 'Za ko'Ri.a 'pa.ra a 'bej.ra du 'la.gu, 'na~w~ pre.te~'de~.du e~'traX, majs 'pa.ra es'taX 'pEX.tu 'kwa~.du 'e.lis sa'i.se~j~
Kate emergiu primeiro, tossindo e gritando, porém não havia sinal de Josh.	'kej.Ti e~.meR'Ziw pri~'mej.ru, to'si~.du i gri'ta~.du, po're~j~ 'na~w~ a'vi.a si~'naw Di 'ZOS
E de repente Mack viu uma erupção de água e pernas e soube naquele momento que algo estava terrivelmente errado.	i Di Re'pe~.Ti 'mE.ki 'viw u~.ma e.rup'sa~w~ Di 'a.gwa i 'pER.naz i 'sow.bi na'ke.li mo~'me~.tu ki 'aw.gu es'ta.va te.Ri.vew'me~.Ti e'Ra.du
Para seu espanto, todos os instintos que havia desenvolvido como salva-vidas na adolescência voltaram instantaneamente.	'pa.ra 'sew es'pa~.tu, 'to.duz uz i~s'Ti~.tus ki a'vi.a de.ze~.vow'vi.du 'ko~.mu 'saw.va 'vi.das na a.do.le'se~.sja vow'ta.ra~w~ i~s.ta~.ta~.ne.a~'me~.Ti
Em questão de segundos ele caiu na água, tirando os sapatos e a camisa.	e~j~ kes'ta~w~ Di se'gu~.duz 'e.li ka'iw na 'a.gwa, Ti'ra~.du us sa'pa.tuz i a ka~'mi.za
Nem se deu conta do choque gelado ao disparar na direção da canoa virada, ignorando os soluços aterrorizados da filha.	ne~j~ si 'dew 'ko~.ta du 'SO.ki Ze'la.du aw Dis.pa'raR na Di.re'sa~w~ da ka~'no.a vi'ra.da, i.gi~.no'ra~.du us so'lu.suz a.te.Ro.ri'za.dus da 'fi.La
Ela estava em segurança.	'E.la es'ta.va e~j~ se.gu'ra~.sa
Seu foco principal era Josh.	'sew 'fO.ku pri~.si'paw 'E.ra 'ZOS
Respirando fundo, mergulhou.	Res.pi'ra~.du 'fu~.du, meR.gu'Low
Encontrou Josh rapidamente e logo descobriu a razão de seu problema.	e~.ko~'trow 'ZOS Ra.pi.da~'me~.Ti i 'lO.gu des.ko'briw a Ra'za~w~ Di 'sew pro'ble~.ma
Uma das tiras do colete salva-vidas se prendera na amarra da canoa.	u~.ma das 'Ti.ras du ko'le.Ti 'saw.va 'vi.das si pre~'de.ra na a~'ma.Ra da ka~'no.a
Por mais que tentasse, Mack não conseguiu soltá-la e por isso fez sinal para Josh entrar mais fundo sob a canoa, onde havia um bolsão de ar.	puR 'majs ki te~'ta.si, 'mE.ki 'na~w~ ko~.se'giw sow'ta la i pur 'i.su 'fejs si~'naw 'pa.ra 'ZOS e~'traR 'majs 'fu~.du sob a ka~'no.a, 'o~.Di a'vi.a u~ bow'sa~w~ Di 'aX
Mas o pobre garoto estava em pânico, tentando livrar-se da tira que o prendia embaixo dágua sob a borda da canoa.	majz u 'pO.bri ga'ro.tu es'ta.va e~j~ 'pa~.ni.ku, te~'ta~.du li'vraX si da 'Ti.ra ki u pre~'Di.a e~'baj.Su 'da.gwa sob a 'bOR.da da ka~'no.a
No terceiro mergulho, sabendo que o tempo estava acabando, percebeu que tinha duas alternativas: tentar livrar Josh do colete ou virar a canoa.	nu teX'sej.ru meR'gu.Lu, sa'be~.du ki u 'te~.pu es'ta.va a.ka'ba~.du, peX.se'bew ki 'Ti~.Ja 'du.az aw.teR.na'Ti.vas, te~'taR li'vraR 'ZOS du ko'le.Ti ow vi'rar a ka~'no.a
Escolheu a segunda opção.	es.ko'Lew a se'gu~.da op'sa~w~
Se foram Deus e os anjos, ou Deus e a adrenalina, ele jamais teve certeza, mas na segunda tentativa conseguiu virar a canoa, libertando Josh da amarra.	si 'fo.ra~w~ 'dewz i uz 'a~.Zus, ow 'dewz i a a.dre~.na'li~.na, 'e.li Za~'majs 'te.vi seX'te.za, majs na se'gu~.da te~.ta'Ti.va ko~.se'giw vi'rar a ka~'no.a, li.beX'ta~.du 'ZOS da a~'ma.Ra
O colete manteve o rosto do garoto acima da água.	u ko'le.Ti ma~'te.vi u 'Ros.tu du ga'ro.tu a'si~.ma da 'a.gwa
Mack emergiu atrás de Josh, agora frouxo e inconsciente, com sangue escorrendo de um talho na cabeça, que a canoa acertara quando Mack a virara de volta.	'mE.ki e~.meR'Ziw a'trajs Di 'ZOS, a'gO.ra 'frow.Su i i~.ko~.si'e~.Ti, ko~ 'sa~.gi es.ko'Re~.du Di u~ 'ta.Lu na ka'be.sa, ki a ka~'no.a a.seX'ta.ra 'kwa~.du 'mE.ki a vi'ra.ra Di 'vOw.ta
Começou imediatamente a fazer respiração boca a boca no filho, do melhor modo que podia, enquanto outras pessoas o ajudavam a puxá-lo em direção à parte rasa.	ko~.me'sow i~.me.Di.a.ta~'me~.Ti a fa'ze.Res.pi.ra'sa~w~ 'bo.ka a 'bo.ka nu 'fi.Lu, du me'LOR 'mO.du ki po'Di.a, e~'kwa~.tu 'ow.tras pe'so.az u a.Zu'da.va~w~ a pu'Sa lu e~j~ Di.re'sa~w~ a 'paX.Ti 'Ra.za
Sem perceber os gritos ao redor, Mack se concentrou na tarefa, com o pânico borbulhando no peito.	se~j~ peX.se'ber us 'gri.tuz aw Re'dOX, 'mE.ki si ko~.se~'trow na ta'rE.fa, ko~ u 'pa~.ni.ku boR.bu'La~.du nu 'pej.tu
Quando os pés de Josh tocaram terreno firme, o garoto começou a tossir e a vomitar água e o café da manhã.	'kwa~.du us 'pEjs Di 'ZOS to'ka.ra~w~ te'Re~.nu 'fiR.mi, u ga'ro.tu ko~.me'sow a to'sir i a vo~.mi'tar 'a.gwa i u ka'fE da ma~'Ja~
Aplausos empolgados irromperam ao redor, porém Mack não deu a mínima.	a'plaw.zuz e~.pow'ga.duz i.Ro~'pe.ra~w~ aw Re'dOX, po're~j~ 'mE.ki 'na~w~ 'dew a 'mi~.ni~.ma
Dentre os que haviam sido atraídos pelo barulho estavam Jesse Madison e Emil Ducette.	'de~.tri us ki a'vi.a~w~ 'si.du a.tra'i.dus 'pe.lu ba'ru.Lu es'ta.va~w~ 'ZE.si 'ma.Di.so~ i e~'miw du'sE.Ti
Emil começou a soluçar, com as emoções subitamente liberadas de uma represa de culpa e medo contidos.	e~'miw ko~.me'sow a so.lu'saX, ko~ az e~.mo'so~j~s su.bi.ta~'me~.Ti li.be'ra.das Di u~.ma Re'pre.za Di 'kuw.pa i 'me.du ko~'Ti.dus
Uma tragédia fora evitada.	u~.ma tra'ZE.Dja 'fo.ra e.vi'ta.da
Pelo menos era o que Mack pensava.	'pe.lu 'me~.nuz 'E.ra u ki 'mE.ki pe~'sa.va
A tristeza é um muro entre dois jardins.	a tris'te.za E u~ 'mu.ru 'e~.tri 'doj.ZaR'Di~s
Mack continuava parado junto à margem, ainda tentando recuperar o fôlego.	'mE.ki ko~.Ti~.nu'a.va pa'ra.du 'Zu~.tu a 'maR.Ze~j~, a'i~.da te~'ta~.du Re.ku.pe'rar u 'fo.le.gu
Demorou alguns minutos antes de pensar em Missy.	de~.mo'row aw'gu~s mi~'nu.tuz 'a~.Tis Di pe~'sar e~j~ 'mi.si
Lembrando-se que ela ficara colorindo o livro, subiu pela margem até onde podia ver seu acampamento, mas não havia sinal da menina.	le~'bra~.du si ki 'E.la fi'ka.ra ko.lo'ri~.du u 'li.vru, su'biw 'pe.la 'maR.Ze~j~ a'tE 'o~.Di po'Di.a 'veX 'sew a.ka~.pa~'me~.tu, majs 'na~w~ a'vi.a si~'naw da me~'ni~.na
Não houve resposta.	'na~w~ 'ow.vi Res'pOs.ta
Ela não estava ali.	'E.la 'na~w~ es'ta.va a'li
Mesmo com o coração disparado, ele racionalizou, pensando que na confusão alguém havia cuidado dela, provavelmente Sarah Madison ou Vicky Ducette.	'mez.mu ko~ u ko.ra'sa~w~ Dis.pa'ra.du, 'e.li Ra.si.o~.na.li'zow, pe~'sa~.du ki na ko~.fu'za~w~ aw'ge~j~ a'vi.a kuj'da.du 'dE.la, pro.va.vew'me~.Ti 'sa.ra 'ma.Di.so~ ow 'vi.ki du'sE.Ti
Procurando controlar a ansiedade e o pânico, foi ao encontro dos novos amigos e perguntou se podiam ajudá-lo a procurar Missy.	pro.ku'ra~.du ko~.tro'lar a a~.si.e'da.Di i u 'pa~.ni.ku, 'foj aw e~'ko~.tru dus 'nO.vuz a~'mi.guz i peR.gu~'tow si po'Di.a~w~ a.Zu'da lu a pro.ku'raR 'mi.si
Os dois dirigiram-se rapidamente para seus acampamentos.	us 'dojs Di.ri'Zi.ra~w~ si Ra.pi.da~'me~.Ti 'pa.ra 'sewz a.ka~.pa~'me~.tus
Jesse retornou primeiro, anunciando que Sarah não tinha visto Missy naquela manhã.	'ZE.si Re.toR'now pri~'mej.ru, a~.nu~.si'a~.du ki 'sa.ra 'na~w~ 'Ti~.Ja 'vis.tu 'mi.si na'kE.la ma~'Ja~
Acompanhou Mack ao acampamento dos Ducette, mas, antes de chegarem lá, Emil veio correndo em sua direção com uma expressão claramente apreensiva no rosto.	a.ko~.pa~'Jow 'mE.ki aw a.ka~.pa~'me~.tu dus du'sE.Ti, majs, 'a~.Tis Di Se'ga.re~j~ 'la, e~'miw 'vej.u ko'Re~.du e~j~ 'su.a Di.re'sa~w~ ko~ u~.ma es.pre'sa~w~ kla.ra~'me~.Ti a.pre.e~'si.va nu 'Ros.tu
Ninguém viu Missy hoje e também não encontramos Amber.	ni~'ge~j~ 'viw 'mi.si 'o.Zi i ta~'be~j~ 'na~w~ e~.ko~'tra~.muz 'a~.beX
Será que estão juntas?	se'ra ki es'ta~w~ 'Zu~.tas
Havia uma sugestão de pânico na pergunta de Emil.	a'vi.a u~.ma su.Zes'ta~w~ Di 'pa~.ni.ku na peR'gu~.ta Di e~'miw
Tenho certeza de que é isso, disse Mack, tentando se tranquilizar e acalmar Emil ao mesmo tempo.	'te~.Ju seX'te.za Di ki E 'i.su, 'Di.si 'mE.ki, te~'ta~.du si tra~.kwi.li'zar i a.kaw'mar e~'miw aw 'mez.mu 'te~.pu
Aonde você acha que elas podem ter ido?	a'o~.Di vo'se 'a.Sa ki 'E.las 'pO.de~j~ 'ter 'i.du
Por que não verificamos os banheiros e chuveiros? sugeriu Jesse.	puX 'ke 'na~w~ ve.ri.fi'ka~.muz us ba~'Jej.ruz i Su'vej.rus, su.Ze'riw 'ZE.si
Boa idéia, falou Mack.	'bo.a i'dEj.a, fa'low 'mE.ki
Vou olhar no que fica mais próximo da nossa área, o que meus filhos usam.	'vow o'LaR nu ki 'fi.ka 'majs 'prO.si~.mu da 'nO.sa 'a.rja, u ki 'mews 'fi.Luz 'u.za~w~
Por que você e Emil não verificam o que fica entre as duas áreas?	puX 'ke vo'se i e~'miw 'na~w~ ve.ri'fi.ka~w~ u ki 'fi.ka 'e~.tri as 'du.az 'a.rjas
Eles concordaram e Mack foi numa corrida lenta para os chuveiros mais próximos, notando pela primeira vez que estava descalço e sem camisa.	'e.lis ko~.koR'da.ra~w~ i 'mE.ki 'foj 'nu~.ma ko'Ri.da 'le~.ta 'pa.ra us Su'vej.rus 'majs 'prO.si~.mus, no'ta~.du 'pe.la pri~'mej.ra 'vejs ki es'ta.va des'kaw.su i se~j~ ka~'mi.za
Que figura devo estar, pensou, e provavelmente teria achado graça se sua mente não estivesse tão concentrada em Missy.	ki fi'gu.ra 'de.vu es'taX, pe~'sow, i pro.va.vew'me~.Ti te'ri.a a'Sa.du 'gra.sa si 'su.a 'me~.Ti 'na~w~ es.Ti'vE.si 'ta~w~ ko~.se~'tra.da e~j~ 'mi.si
Quando chegou aos banheiros, perguntou a uma adolescente que saía da parte feminina se tinha visto uma garotinha de vestido vermelho lá dentro, ou talvez duas garotas.	'kwa~.du Se'gow aws ba~'Jej.rus, peR.gu~'tow a u~.ma a.do.le'se~.Ti ki sa'i.a da 'paX.Ti fe~.mi~'ni~.na si 'Ti~.Ja 'vis.tu u~.ma ga.ro'Ti~.Ja Di ves'Ti.du veR'me.Lu 'la 'de~.tru, ow taw'vejz 'du.as ga'ro.tas
Ela disse que não havia notado, mas que olharia de novo.	'E.la 'Di.si ki 'na~w~ a'vi.a no'ta.du, majs ki o.La'ri.a Di 'no.vu
Em menos de um minuto estava de volta balançando a cabeça.	e~j~ 'me~.nus Di 'u~ mi~'nu.tu es'ta.va Di 'vOw.ta ba.la~'sa~.du a ka'be.sa
Obrigado mesmo assim, disse Mack, e foi para a parte de trás da construção, onde ficavam os chuveiros.	o.bri'ga.du 'mez.mu a'si~, 'Di.si 'mE.ki, i 'foj 'pa.ra a 'paX.Ti Di 'trajs da ko~s.tru'sa~w~, 'o~.Di fi'ka.va~w~ us Su'vej.rus
Enquanto virava a esquina, começou a chamar Missy em voz alta.	e~'kwa~.tu vi'ra.va a es'ki~.na, ko~.me'sow a Sa~'maR 'mi.si e~j~ 'vOjz 'aw.ta
Mack podia ouvir a água correndo, mas ninguém respondeu.	'mE.ki po'Di.a ow'vir a 'a.gwa ko'Re~.du, majs ni~'ge~j~ Res.po~'dew
Seis cubículos de chuveiro e nada de Missy.	'sejs ku'bi.ku.lus Di Su'vej.ru i 'na.da Di 'mi.si
Verificou os do banheiro masculino, mas ela não se encontrava em lugar nenhum.	ve.ri.fi'kow us du ba~'Jej.ru mas.ku'li~.nu, majz 'E.la 'na~w~ si e~.ko~'tra.va e~j~ lu'gaR ne~'Ju~
Correu de volta na direção do acampamento de Emil, incapaz de orar qualquer coisa, a não ser repetir Ah, meu Deus, me ajude a achá-la... Ah, meu Deus, por favor, me ajude a achá-la.	ko'Rew Di 'vOw.ta na Di.re'sa~w~ du a.ka~.pa~'me~.tu Di e~'miw, i~.ka'pajz Di o'raX kwaw'kEX 'koj.za, a 'na~w~ 'se.Re.pe'Tir 'a, 'mew 'dews, mi a'Zu.Di a a'Sa la, 'a, 'mew 'dews, puX fa'voX, mi a'Zu.Di a a'Sa la
Quando o viu, Vicky correu ao seu encontro.	'kwa~.du u 'viw, 'vi.ki ko'Rew aw 'sew e~'ko~.tru
Estivera tentando conter o choro, mas não conseguiu quando se abraçaram.	es.Ti'vE.ra te~'ta~.du ko~'ter u 'So.ru, majs 'na~w~ ko~.se'giw 'kwa~.du si a.bra'sa.ra~w~
De repente, Mack desejou desesperadamente que Nan estivesse ali.	Di Re'pe~.Ti, 'mE.ki de.ze'Zow de.zes.pe.ra.da~'me~.Ti ki 'na~ es.Ti'vE.si a'li
Ela saberia o que fazer, pelo menos qual seria a coisa certa.	'E.la sa.be'ri.a u ki fa'zeX, 'pe.lu 'me~.nus 'kwaw se'ri.a a 'koj.za 'sEX.ta
Ele se sentia totalmente perdido.	'e.li si se~'Ti.a to.taw'me~.Ti peR'Di.du
Sarah levou Josh e Kate para o seu acampamento, portanto não se preocupe com eles, disse Vicky em meio aos soluços.	'sa.ra le'vow 'ZOS i 'kej.Ti 'pa.ra u 'sew a.ka~.pa~'me~.tu, poX'ta~.tu 'na~w~ si prew'ku.pi ko~ 'e.lis, 'Di.si 'vi.ki e~j~ 'mej.u aws so'lu.sus
Ah, meu Deus, pensou Mack, percebendo que tinha esquecido completamente de seus outros dois filhos.	'a, 'mew 'dews, pe~'sow 'mE.ki, peX.se'be~.du ki 'Ti~.Ja es.ke'si.du ko~.plE.ta~'me~.Ti Di 'sewz 'ow.trus 'dojs 'fi.Lus
Que tipo de pai eu sou?	ki 'Ti.pu Di 'paj ew 'sow
Mesmo sentindo-se aliviado porque Sarah estava cuidando deles, desejou ainda mais intensamente que Nan estivesse ali.	'mez.mu se~'Ti~.du si a.li.vi'a.du puX'ke 'sa.ra es'ta.va kuj'da~.du 'de.lis, de.ze'Zow a'i~.da 'majz i~.te~.sa~'me~.Ti ki 'na~ es.Ti'vE.si a'li
Nesse momento, Emil e Jesse apareceram, Emil aparentando alívio e Jesse parecendo tenso como uma corda esticada.	'ne.si mo~'me~.tu, e~'miw i 'ZE.si a.pa.re'se.ra~w~, e~'miw a.pa.re~'ta~.du a'li.vju i 'ZE.si pa.re'se~.du 'te~.su 'ko~.mu u~.ma 'kOR.da es.Ti'ka.da
Nós a encontramos, exclamou Emil, o rosto se iluminando e depois ficando sombrio ao perceber o que estava dizendo.	'nOjz a e~.ko~'tra~.mus, es.kla~'mow e~'miw, u 'Ros.tu si i.lu~.mi~'na~.du i de'pojs fi'ka~.du so~'bri.u aw peX.se'ber u ki es'ta.va Di'ze~.du
Quero dizer, encontramos Amber.	'kE.ru Di'zeX, e~.ko~'tra~.muz 'a~.beX
Ela voltou do banho que foi tomar em outro lugar, onde havia água quente.	'E.la vow'tow du 'ba~.Ju ki 'foj to~'mar e~j~ 'ow.tru lu'gaX, 'o~.Di a'vi.a 'a.gwa 'ke~.Ti
Disse que tinha falado com a mãe, mas Vicky provavelmente não escutou... Sua voz parou no ar.	'Di.si ki 'Ti~.Ja fa'la.du ko~ a 'ma~j~, majs 'vi.ki pro.va.vew'me~.Ti 'na~w~ es.ku'tow, 'su.a 'vOjs pa'row nu 'aX
Mas não encontramos Missy, acrescentou Jesse rapidamente, respondendo à pergunta mais importante.	majs 'na~w~ e~.ko~'tra~.mus 'mi.si, a.kre.se~'tow 'ZE.si Ra.pi.da~'me~.Ti, Res.po~'de~.du a peR'gu~.ta 'majz i~.poX'ta~.Ti
Amber também não a viu hoje.	'a~.beX ta~'be~j~ 'na~w~ a 'viw 'o.Zi
Emil, no auge da eficiência, assumiu o controle.	e~'miw, nu 'aw.Zi da e.fi.si'e~.sja, a.su~'miw u ko~'tro.li
Mack, temos de contatar as autoridades do camping imediatamente e botar todo mundo procurando Missy.	'mE.ki, 'te~.mus Di ko~.ta'tar az aw.to.ri'da.Dis du 'ka~.pi~ i~.me.Di.a.ta~'me~.Ti i bo'taX 'to.du 'mu~.du pro.ku'ra~.du 'mi.si
Talvez, no meio da agitação, ela tenha se assustado e se confundido e simplesmente saiu andando e se perdeu, ou talvez estivesse tentando nos encontrar e caminhou na direção errada.	taw'vejs, nu 'mej.u da a.Zi.ta'sa~w~, 'E.la 'te~.Ja si a.sus'ta.du i si ko~.fu~'Di.du i si~.pliz'me~.Ti sa'iw a~'da~.du i si peR'dew, ow taw'vejz es.Ti'vE.si te~'ta~.du nuz e~.ko~'trar i ka~.mi~'Jow na Di.re'sa~w~ e'Ra.da
Você tem uma foto dela?	vo'se te~j~ u~.ma 'fO.tu 'dE.la
Talvez haja uma copiadora no escritório e poderíamos fazer algumas cópias para economizar tempo.	taw'vejz 'a.Za u~.ma ko.pi.a'do.ra nu es.kri'tO.rju i po.de'ri.a~.mus fa'zer aw'gu~.mas 'kO.pjas 'pa.ra e.ko~.no~.mi'zaX 'te~.pu
É, tenho uma foto na carteira. Mack enfiou a mão no bolso de trás e por um segundo entrou em pânico ao não encontrar nada ali.	E, 'te~.Ju u~.ma 'fO.tu na kaX'tej.ra, 'mE.ki e~.fi'ow a 'ma~w~ nu 'bow.su Di 'trajz i pur u~ se'gu~.du e~'trow e~j~ 'pa~.ni.ku aw 'na~w~ e~.ko~'traR 'na.da a'li
Achou que poderia estar no fundo do lago Wallowa, mas então lembrou que a deixara no carro depois da viagem de teleférico no dia anterior.	a'Sow ki po.de'ri.a es'taR nu 'fu~.du du 'la.gu 'wa.lo.wa, majz e~'ta~w~ le~'brow ki a dej'Sa.ra nu 'ka.Ru de'pojs da vi'a.Ze~j~ Di te.le'fE.ri.ku nu 'Di.a a~.te.ri'oX
Os três voltaram ao acampamento de Mack.	us 'trejs vow'ta.ra~w~ aw a.ka~.pa~'me~.tu Di 'mE.ki
Jesse correu na frente para avisar Sarah que Amber estava em segurança, mas que Missy não fora encontrada.	'ZE.si ko'Rew na 'fre~.Ti 'pa.ra a.vi'zaX 'sa.ra ki 'a~.ber es'ta.va e~j~ se.gu'ra~.sa, majs ki 'mi.si 'na~w~ 'fo.ra e~.ko~'tra.da
Chegando ao acampamento, Mack abraçou Josh e Kate, tentando parecer calmo.	Se'ga~.du aw a.ka~.pa~'me~.tu, 'mE.ki a.bra'sow 'ZOS i 'kej.Ti, te~'ta~.du pa.re'seX 'kaw.mu
Tirando a roupa molhada, vestiu uma camiseta e jeans, meias secas e um par de tênis.	Ti'ra~.du a 'Row.pa mo'La.da, ves'Tiw u~.ma ka~.mi'ze.ta i 'Di~s, 'mej.as 'se.kaz i u~ 'paR Di 'te~.nis
Sarah prometeu que ela e Vicky ficariam com seus filhos mais velhos e sussurrou que estava orando por ele e Missy.	'sa.ra pro~.me'tew ki 'E.la i 'vi.ki fi.ka'ri.a~w~ ko~ 'sews 'fi.Lus 'majs 'vE.Luz i su.su'Row ki es'ta.va o'ra~.du pur 'e.li i 'mi.si
Mack agradeceu dando-lhe um abraço rápido e depois de beijar os filhos, juntou-se aos outros dois homens que corriam para o escritório do camping.	'mE.ki a.gra.de'sew 'da~.du Li u~ a'bra.su 'Ra.pi.du i de'pojs Di bej'Zar us 'fi.Lus, Zu~'tow si awz 'ow.trus 'dojz 'o~.me~s ki ko'Ri.a~w~ 'pa.ra u es.kri'tO.rju du 'ka~.pi~
O clima mudou rapidamente quando souberam do desaparecimento de Missy.	u 'kli~.ma mu'dow Ra.pi.da~'me~.Ti 'kwa~.du sow'bE.ra~w~ du de.za.pa.re.si~'me~.tu Di 'mi.si
No escritório havia uma copiadora e Mack, depois de tirar várias cópias do retrato da filha, as distribuiu.	nu es.kri'tO.rju a'vi.a u~.ma ko.pi.a'do.ra i 'mE.ki, de'pojs Di Ti'raR 'va.rjas 'kO.pjas du Re'tra.tu da 'fi.La, as Dis.tri.bu'iw
O jovem subgerente, Jeremy Bellamy, ofereceu-se para ajudar na busca.	u 'ZO.ve~j~ sub.Ze're~.Ti, 'ZE.re~.mi 'bE.la~.mi, o.fe.re'sew si 'pa.ra a.Zu'daR na 'bus.ka
Então eles dividiram o camping em quatro áreas e cada um saiu levando um mapa, a foto de Missy e um walkie-talkie.	e~'ta~w~ 'e.lis Di.vi'Di.ra~w~ u 'ka~.pi~ e~j~ 'kwa.tru 'a.rjaz i 'ka.da u~ sa'iw le'va~.du u~ 'ma.pa, a 'fO.tu Di 'mi.si i u~ 'waw.ki 'taw.ki
Era um trabalho lento e metódico, lento demais para Mack, mas ele sabia que esse era o modo mais lógico de encontrá-la se... se ainda estivesse no camping.	'E.ra u~ tra'ba.Lu 'le~.tu i me'tO.Di.ku, 'le~.tu de~'majs 'pa.ra 'mE.ki, majz 'e.li sa'bi.a ki 'e.si 'E.ra u 'mO.du 'majs 'lO.Zi.ku Di e~.ko~'tra la si, si a'i~.da es.Ti'vE.si nu 'ka~.pi~
Enquanto andava entre barracas e trailers, orava e fazia promessas.	e~'kwa~.tu a~'da.va 'e~.tri ba'Ra.kaz i 'traj.leXs, o'ra.va i fa'zi.a pro~'mE.sas
Tinha consciência de que prometer coisas a Deus era idiota e irracional, mas não conseguia evitar.	'Ti~.Ja ko~.si'e~.sja Di ki pro~.me'teX 'koj.zaz a 'dewz 'E.ra i.Di'O.ta i i.Ra.si.o~'naw, majs 'na~w~ ko~.se'gi.a e.vi'taX
Estava desesperado para ter Missy de volta e sem dúvida Deus sabia onde ela se encontrava.	es'ta.va de.zes.pe'ra.du 'pa.ra 'teR 'mi.si Di 'vOw.ta i se~j~ 'du.vi.da 'dews sa'bi.a 'o~.Di 'E.la si e~.ko~'tra.va
Muitos campistas estavam acabando de arrumar suas bagagens para irem embora.	'mu~j~.tus ka~'pis.taz es'ta.va~w~ a.ka'ba~.du Di a.Ru~'maX 'su.as ba'ga.Ze~s 'pa.ra 'i.re~j~ e~'bO.ra
Ninguém tinha visto Missy ou uma menina parecida com ela.	ni~'ge~j~ 'Ti~.Ja 'vis.tu 'mi.si ow u~.ma me~'ni~.na pa.re'si.da ko~ 'E.la
A pequenos intervalos, cada grupo de busca entrava em contato com o escritório para saber se havia alguma novidade.	a pe'ke~.nuz i~.teR'va.lus, 'ka.da 'gru.pu Di 'bus.ka e~'tra.va e~j~ ko~'ta.tu ko~ u es.kri'tO.rju 'pa.ra sa'beX si a'vi.a aw'gu~.ma no.vi'da.Di
Mas não houve qualquer notícia até quase duas da tarde.	majs 'na~w~ 'ow.vi kwaw'kER no'Ti.sja a'tE 'kwa.zi 'du.as da 'taR.Di
Mack estava terminando de vasculhar sua área quando veio o chamado pelo walkie-talkie.	'mE.ki es'ta.va teR.mi~'na~.du Di vas.ku'LaX 'su.a 'a.rja 'kwa~.du 'vej.u u Sa~'ma.du 'pe.lu 'waw.ki 'taw.ki
Jeremy, que cobria a área mais perto da entrada, achou que encontrara algum indício.	'ZE.re~.mi, ki ko'bri.a a 'a.rja 'majs 'pEX.tu da e~'tra.da, a'Sow ki e~.ko~'tra.ra aw'gu~ i~'Di.sju
Foram todos ao seu encontro.	'fo.ra~w~ 'to.duz aw 'sew e~'ko~.tru
Mack chegou por último e viu Emil e Jeremy ouvindo atentamente um rapaz desconhecido.	'mE.ki Se'gow pur 'uw.Ti~.mu i 'viw e~'miw i 'ZE.re~.mi ow'vi~.du a.te~.ta~'me~.Ti u~ Ra'pajz des.ko~.Je'si.du
Emil disse a Mack rapidamente o que ouvira e o apresentou ao rapaz.	e~'miw 'Di.si a 'mE.ki Ra.pi.da~'me~.Ti u ki ow'vi.ra i u a.pre.ze~'tow aw Ra'pajs
Seu nome era Virgil Thomas e ele estava acampado na área com alguns colegas desde o início do verão.	'sew 'no~.mi 'E.ra viR'Ziw 'to~.maz i 'e.li es'ta.va a.ka~'pa.du na 'a.rja ko~ aw'gu~s ko'lE.gas 'dez.Di u i~'ni.sju du ve'ra~w~
Os outros dormiam pesadamente quando Virgil viu uma velha picape verde-oliva saindo do camping e descendo na direção de Joseph.	uz 'ow.trus doR'mi.a~w~ pe.za.da~'me~.Ti 'kwa~.du viR'Ziw 'viw u~.ma 'vE.La pi'ka.pi 'veR.Di o'li.va sa'i~.du du 'ka~.pi~ i de'se~.du na Di.re'sa~w~ Di 'Zo.zef
Mais ou menos a que horas? perguntou Mack.	'majz ow 'me~.nuz a ki 'O.ras, peR.gu~'tow 'mE.ki
Foi antes do meio-dia, mas não tenho certeza, porque estava de ressaca.	'foj 'a~.Tis du 'mej.u 'Di.a, majs 'na~w~ 'te~.Ju seX'te.za, puX'ke es'ta.va Di Re'sa.ka
Mostrando a foto de Missy para o rapaz, Mack perguntou de modo áspero: Você acha que viu essa menina?	mos'tra~.du a 'fO.tu Di 'mi.si 'pa.ra u Ra'pajs, 'mE.ki peR.gu~'tow Di 'mO.du 'as.pe.ru, vo'se 'a.Sa ki 'viw 'E.sa me~'ni~.na
Quando o outro cara me mostrou essa foto antes, ela não me pareceu familiar, respondeu Virgil, olhando de novo.	'kwa~.du u 'ow.tru 'ka.ra mi mos'trow 'E.sa 'fO.tu 'a~.Tis, 'E.la 'na~w~ mi pa.re'sew fa~.mi.li'aX, Res.po~'dew viR'Ziw, o'La~.du Di 'no.vu
Mas então, quando ele disse que ela estava usando um vestido vermelho-vivo, lembrei que a menininha na picape verde estava com um vestido dessa cor.	majz e~'ta~w~, 'kwa~.du 'e.li 'Di.si ki 'E.la es'ta.va u'za~.du u~ ves'Ti.du veR'me.Lu 'vi.vu, le~'brej ki a me~.ni~'ni~.Ja na pi'ka.pi 'veR.Di es'ta.va ko~ u~ ves'Ti.du 'dE.sa 'koX
Vi que ela estava rindo ou berrando, não dava para saber.	'vi ki 'E.la es'ta.va 'Ri~.du ow be'Ra~.du, 'na~w~ 'da.va 'pa.ra sa'beX
E então tive a impressão de que o motorista lhe deu um tapa ou a empurrou para baixo, mas acho que ele também podia estar só brincando.	i e~'ta~w~ 'Ti.vi a i~.pre'sa~w~ Di ki u mo.to'ris.ta Li 'dew u~ 'ta.pa ow a e~.pu'Row 'pa.ra 'baj.Su, majz 'a.Su ki 'e.li ta~'be~j~ po'Di.a es'taX 'sO bri~'ka~.du
Mack ficou paralisado.	'mE.ki fi'kow pa.ra.li'za.du
Apesar de assustadora, infelizmente essa informação era a única que até então fazia sentido.	a.pe'zaR Di a.sus.ta'do.ra, i~.fe.liz'me~.Ti 'E.sa i~.foR.ma'sa~w~ 'E.ra a 'u~.ni.ka ki a'tE e~'ta~w~ fa'zi.a se~'Ti.du
Explicava por que não haviam encontrado nenhum traço de Missy.	es.pli'ka.va puX 'ke 'na~w~ a'vi.a~w~ e~.ko~'tra.du ne~'Ju~ 'tra.su Di 'mi.si
Mas tudo dentro dele não queria que fosse verdade.	majs 'tu.du 'de~.tru 'de.li 'na~w~ ke'ri.a ki 'fo.si veR'da.Di
Virou-se e começou a correr para o escritório, mas foi contido pela voz de Emil.	vi'row si i ko~.me'sow a ko'ReX 'pa.ra u es.kri'tO.rju, majs 'foj ko~'Ti.du 'pe.la 'vOjz Di e~'miw
Mack, pára!	'mE.ki, 'pa.ra
Nós já falamos com o escritório pelo rádio e avisamos o xerife de Joseph.	'nOj'Za fa'la~.mus ko~ u es.kri'tO.rju 'pe.lu 'Ra.Dju i a.vi'za~.muz u Se'ri.fi Di 'Zo.zef
Eles vão mandar alguém para cá agora mesmo e estão emitindo um boletim de busca para a picape.	'e.lis 'va~w~ ma~'dar aw'ge~j~ 'pa.ra 'ka a'gO.ra 'mez.mu i es'ta~w~ e~.mi'Ti~.du u~ bo.le'Ti~ Di 'bus.ka 'pa.ra a pi'ka.pi
Nesse momento duas radiopatrulhas entraram no camping.	'ne.si mo~'me~.tu 'du.as Ra.Di.o.pa'tru.Laz e~'tra.ra~w~ nu 'ka~.pi~
A primeira foi direto para o escritório e a outra para a área onde os homens se encontravam.	a pri~'mej.ra 'foj Di'rE.tu 'pa.ra u es.kri'tO.rju i a 'ow.tra 'pa.ra a 'a.rja 'o~.Di uz 'o~.me~s si e~.ko~'tra.va~w~
Mack correu ao encontro do policial, um rapaz de cerca de 30 anos, que se apresentou como Dalton e começou a ouvir as pessoas.	'mE.ki ko'Rew aw e~'ko~.tru du po.li.si'aw, u~ Ra'pajz Di 'seX.ka Di 'tri~.ta 'a~.nus, ki si a.pre.ze~'tow 'ko~.mu 'daw.to~ i ko~.me'sow a ow'vir as pe'so.as
Nas horas seguintes houve um movimento crescente de reação ao desaparecimento de Missy.	naz 'O.ras se'gi~.Tiz 'ow.vi u~ mo.vi~'me~.tu kre'se~.Ti Di Re.a'sa~w~ aw de.za.pa.re.si~'me~.tu Di 'mi.si
Expediram uma ordem de busca, bloquearam a auto-estrada e os guardas florestais da área foram avisados para ficarem atentos.	es.pe'Di.ra~w~ u~.ma 'OR.de~j~ Di 'bus.ka, blo.ke'a.ra~w~ a 'aw.tu es'tra.da i us 'gwaR.das flo.res'tajs da 'a.rja 'fo.ra~w~ a.vi'za.dus 'pa.ra fi'ka.re~j~ a'te~.tus
Virgil forneceu o máximo de detalhes que pôde sobre a picape e os ocupantes e a descrição foi enviada a todos os órgãos policiais mais importantes.	viR'Ziw foR.ne'sew u 'ma.si~.mu Di de'ta.Lis ki 'po.Di 'so.bri a pi'ka.pi i uz o.ku'pa~.Tiz i a des.kri'sa~w~ 'foj e~.vi'a.da a 'to.duz uz 'OR.ga~w~s po.li.si'ajs 'majz i~.poX'ta~.Tis
Os oficiais de campo do FBI em Portland, Seattle e Denver foram alertados.	uz o.fi.si'ajs Di 'ka~.pu du 'E.fi 'be 'i e~j~ 'pOX.Ti.la~.Di, se'a.tow i de~'veX 'fo.ra~w~ a.leX'ta.dus
Nan estava a caminho, trazida de carro por sua melhor amiga, Maryanne.	'na~ es'ta.va a ka~'mi~.Ju, tra'zi.da Di 'ka.Ru puX 'su.a me'LOr a~'mi.ga, ma.ri'a~.ni
Trouxeram cães rastreadores, mas as pistas de Missy terminavam no estacionamento próximo, aumentando a probabilidade de que a história de Virgil fosse verdadeira.	trow'sE.ra~w~ 'ka~j~s Ras.tre.a'do.ris, majz as 'pis.tas Di 'mi.si teR.mi~'na.va~w~ nu es.ta.si.o~.na~'me~.tu 'prO.si~.mu, aw~.me~'ta~.du a pro.ba.bi.li'da.Di Di ki a is'tO.rja Di viR'Ziw 'fo.si veR.da'dej.ra
Depois que os peritos examinaram minuciosamente o acampamento o policial Dalton pediu que Mack entrasse de novo na área e observasse tudo com cuidado, em busca de algo diferente.	de'pojs ki us pe'ri.tuz e.za~.mi~'na.ra~w~ mi~.nu.si.O.za~'me~.Ti u a.ka~.pa~'me~.tu u po.li.si'aw 'daw.to~ pe'Diw ki 'mE.ki e~'tra.si Di 'no.vu na 'a.rja i ob.seR'va.si 'tu.du ko~ kuj'da.du, e~j~ 'bus.ka Di 'aw.gu Di.fe're~.Ti
Mack sentia-se tão desesperado para ajudar de alguma forma que, mesmo exausto, concentrou a mente na tentativa de lembrar-se de qualquer detalhe.	'mE.ki se~'Ti.a si 'ta~w~ de.zes.pe'ra.du 'pa.ra a.Zu'daR Di aw'gu~.ma 'fOR.ma ki, 'mez.mu e'zaws.tu, ko~.se~'trow a 'me~.Ti na te~.ta'Ti.va Di le~'braX si Di kwaw'kER de'ta.Li
Com cautela, refez seus passos.	ko~ kaw'tE.la, Re'fejs 'sews 'pa.sus
O que não daria em troca para ter a chance de recomeçar o dia desde o início!	u ki 'na~w~ da'ri.a e~j~ 'trO.ka 'pa.ra 'ter a 'Sa~.si Di Re.ko~.me'sar u 'Di.a 'dez.Di u i~'ni.sju
Mesmo queimando os dedos e derrubando de novo a massa de panqueca!	'mez.mu kej~'ma~.du us 'de.duz i de.Ru'ba~.du Di 'no.vu a 'ma.sa Di pa~'kE.ka
Voltou-se novamente para a tarefa designada, mas nada parecia diferente do que recordava.	vow'tow si nO.va~'me~.Ti 'pa.ra a ta'rE.fa de.zi.gi~'na.da, majs 'na.da pa.re'si.a Di.fe're~.Ti du ki Re.koR'da.va
Nada havia mudado.	'na.da a'vi.a mu'da.du
Chegou à mesa onde Missy estivera ocupada colorindo.	Se'gow a 'me.za 'o~.Di 'mi.si es.Ti'vE.ra o.ku'pa.da ko.lo'ri~.du
O livro estava aberto na mesma página, com uma imagem inacabada da princesa índia da tribo Multnomah.	u 'li.vru es'ta.va a'bEX.tu na 'mez.ma 'pa.Zi~.na, ko~ u~.ma i~'ma.Ze~j~ i~.na.ka'ba.da da pri~'se.za 'i~.Dja da 'tri.bu muw.Ti~.no~'ma
Os lápis de cera também se encontravam lá, se bem que o vermelho, a cor predileta de Missy, estivesse faltando.	us 'la.pis Di 'se.ra ta~'be~j~ si e~.ko~'tra.va~w~ 'la, si 'be~j~ ki u veR'me.Lu, a 'koX pre.Di'lE.ta Di 'mi.si, es.Ti'vE.si faw'ta~.du
Mack começou a procurar no chão, onde ele poderia ter caído.	'mE.ki ko~.me'sow a pro.ku'raR nu 'Sa~w~, 'o~.Di 'e.li po.de'ri.a 'teX ka'i.du
Se está procurando o lápis de cera vermelho, nós o encontramos ali, perto da árvore, disse Dalton, apontando para o estacionamento.	si es'ta pro.ku'ra~.du u 'la.pis Di 'se.ra veR'me.Lu, 'nOjz u e~.ko~'tra~.muz a'li, 'pEX.tu da 'aR.vo.ri, 'Di.si 'daw.to~, a.po~'ta~.du 'pa.ra u es.ta.si.o~.na~'me~.tu
Como você sabe que ela estava lutando?	'ko~.mu vo'se 'sa.bi ki 'E.la es'ta.va lu'ta~.du
O policial hesitou, mas depois falou, relutante: Encontramos um dos sapatos dela nos arbustos, para onde provavelmente foi chutado.	u po.li.si'aw e.zi'tow, majs de'pojs fa'low, Re.lu'ta~.Ti, e~.ko~'tra~.muz 'u~ dus sa'pa.tus 'dE.la nuz aR'bus.tus, 'pa.ra 'o~.Di pro.va.vew'me~.Ti 'foj Su'ta.du
Você não estava aqui na hora, por isso pedimos ao seu filho para identificá-lo.	vo'se 'na~w~ es'ta.va a'ki na 'O.ra, pur 'i.su pe'Di~.muz aw 'sew 'fi.Lu 'pa.ra i.de~.Ti.fi'ka lu
Quase sucumbindo ao negrume súbito que ameaçava esmagá-lo, Mack se apoiou na mesa para não desmaiar ou vomitar.	'kwa.zi su.ku~'bi~.du aw ne'gru~.mi 'su.bi.tu ki a~.me.a'sa.va es.ma'ga lu, 'mE.ki si a.poj'ow na 'me.za 'pa.ra 'na~w~ dez.maj'ar ow vo~.mi'taX
Foi então que notou um broche de joaninha cravado no livro de colorir.	'foj e~'ta~w~ ki no'tow u~ 'brO.Si Di Zo.a~'ni~.Ja kra'va.du nu 'li.vru Di ko.lo'riX
Retornou à consciência como se alguém tivesse aberto um vidro de sais sob seu nariz.	Re.toR'now a ko~.si'e~.sja 'ko~.mu si aw'ge~j~ Ti'vE.si a'bEX.tu u~ 'vi.dru Di 'sajs sob 'sew na'ris
De quem é isso? perguntou a Dalton, apontando para o broche.	Di 'ke~j~ E 'i.su, peR.gu~'tow a 'daw.to~, a.po~'ta~.du 'pa.ra u 'brO.Si
De quem é o quê?	Di 'ke~j~ E u 'ke
Esse broche de joaninha!	'e.si 'brO.Si Di Zo.a~'ni~.Ja
Quem pôs isso aí?	'ke~j~ 'pojz 'i.su a'i
Tenho certeza, afirmou Mack, enfático.	'te~.Ju seX'te.za, a.fiR'mow 'mE.ki, e~'fa.Ti.ku
Ela não tem nada assim.	'E.la 'na~w~ te~j~ 'na.da a'si~
O policial se comunicou pelo rádio e em minutos os peritos retornaram e levaram o broche.	u po.li.si'aw si ko~.mu~.ni'kow 'pe.lu 'Ra.Dju i e~j~ mi~'nu.tuz us pe'ri.tus Re.toR'na.ra~w~ i le'va.ra~w~ u 'brO.Si
Não entendo.	'na~w~ e~'te~.du
O policial hesitou, tentando decidir se deveria contar a Mack o que estava pensando.	u po.li.si'aw e.zi'tow, te~'ta~.du de.si'DiX si de.ve'ri.a ko~'tar a 'mE.ki u ki es'ta.va pe~'sa~.du
Procurou as palavras certas.	pro.ku'row as pa'la.vras 'sEX.tas
É a única prova que temos até agora de que havia alguém aqui.	E a 'u~.ni.ka 'prO.va ki 'te~.muz a'tE a'gO.ra Di ki a'vi.a aw'ge~j~ a'ki
E a má notícia? Mack prendeu o fôlego.	i a 'ma no'Ti.sja, 'mE.ki pre~'dew u 'fo.le.gu
Bom, a má notícia, e não estou dizendo que este seja o caso, é que quem deixa algo assim geralmente tem um objetivo, e isso pode significar que já fez a mesma coisa antes.	'bo~, a 'ma no'Ti.sja, i 'na~w~ es'tow Di'ze~.du ki 'es.Ti 'se.Za u 'ka.zu, E ki 'ke~j~ 'dej.Sa 'aw.gu a'si~ Ze.raw'me~.Ti te~j~ u~ ob.Ze'Ti.vu, i 'i.su 'pO.Di si.gi~.ni.fi'kaX ki 'Za 'fejz a 'mez.ma 'koj.za 'a~.Tis
O quê? reagiu Mack bruscamente.	u 'ke, Re.a'Ziw 'mE.ki brus.ka~'me~.Ti
Isso significa que esse cara é uma espécie de maníaco?	'i.su si.gi~.ni'fi.ka ki 'e.si 'ka.ra E u~.ma es'pE.si Di ma~'ni.a.ku
Esse é algum tipo de sinal que ele deixa para se identificar, como se estivesse marcando o território ou algo assim?	'e.si E aw'gu~ 'Ti.pu Di si~'naw ki 'e.li 'dej.Sa 'pa.ra si i.de~.Ti.fi'kaX, 'ko~.mu si es.Ti'vE.si maX'ka~.du u te.Ri'tO.rju ow 'aw.gu a'si~
A raiva de Mack foi crescendo, mas, antes que explodisse, o rádio de Dalton tocou, conectando-o ao escritório de campo do FBI em Portland...	a 'Raj.va Di 'mE.ki 'foj kre'se~.du, majs, 'a~.Tis ki es.plo'Di.si, u 'Ra.Dju Di 'daw.to~ to'kow, ko~.nek'ta~.du u aw es.kri'tO.rju Di 'ka~.pu du 'E.fi 'be 'i e~j~ 'pOX.Ti.la~.Di
Ela pediu que Dalton descrevesse o broche em detalhes.	'E.la pe'Diw ki 'daw.to~ des.kre've.si u 'brO.Si e~j~ de'ta.Lis
O broche estava dentro de um saco transparente, e de pé, atrás do grupo, ele ficou observando Dalton descrevê-lo.	u 'brO.Si es'ta.va 'de~.tru Di u~ 'sa.ku tra~s.pa're~.Ti, i Di 'pE, a'trajs du 'gru.pu, 'e.li fi'kow ob.seR'va~.du 'daw.to~ des.kre've lu
É um alfinete com uma joaninha que foi cravado atravessando algumas páginas de um livro de colorir.	E u~ aw.fi~'ne.Ti ko~ u~.ma Zo.a~'ni~.Ja ki 'foj kra'va.du a.tra.ve'sa~.du aw'gu~.mas 'pa.Zi~.nas Di u~ 'li.vru Di ko.lo'riX
Por favor, descreva as cores e o número de pontos na joaninha, orientou a voz pelo rádio.	puX fa'voX, des'kre.va as 'ko.riz i u 'nu~.me.ru Di 'po~.tus na Zo.a~'ni~.Ja, o.ri.e~'tow a 'vOjs 'pe.lu 'Ra.Dju
Vejamos, disse Dalton, com os olhos quase grudados no saco.	ve'Za~.mus, 'Di.si 'daw.to~, ko~ uz 'O.Lus 'kwa.zi gru'da.dus nu 'sa.ku
A joaninha tem uma cabeça preta.	a Zo.a~'ni~.Ja te~j~ u~.ma ka'be.sa 'pre.ta
E o corpo é vermelho, com bordas e divisões pretas.	i u 'koX.pu E veR'me.Lu, ko~ 'bOR.daz i Di.vi'zo~j~s 'pre.tas
Há dois pontos pretos no lado esquerdo do corpo. Faz sentido?	'a 'dojs 'po~.tus 'pre.tus nu 'la.du es'keR.du du 'koX.pu, 'fajs se~'Ti.du
Perfeitamente. Por favor, continue, disse a voz com paciência.	peX.fej.ta~'me~.Ti, puX fa'voX, ko~.Ti~'nuj, 'Di.si a 'vOjs ko~ pa.si'e~.sja
Do lado direito da joaninha há três pontos, de modo que são cinco ao todo.	du 'la.du Di'rej.tu da Zo.a~'ni~.Ja 'a 'trejs 'po~.tus, Di 'mO.du ki 'sa~w~ 'si~.ku aw 'to.du
Tem certeza de que são cinco pontos?	te~j~ seX'te.za Di ki 'sa~w~ 'si~.ku 'po~.tus
Sim, senhora, são cinco pontos.	'si~, se~'JO.ra, 'sa~w~ 'si~.ku 'po~.tus
Certo. Agora, policial Dalton, poderia virar o broche e dizer o que há na parte de baixo da joaninha?	'sEX.tu, a'gO.ra, po.li.si'aw 'daw.to~, po.de'ri.a vi'rar u 'brO.Si i Di'zer u ki 'a na 'paX.Ti Di 'baj.Su da Zo.a~'ni~.Ja
Dalton virou o saco plástico e olhou com cuidado.	'daw.to~ vi'row u 'sa.ku 'plas.Ti.ku i o'Low ko~ kuj'da.du
Há algo gravado embaixo, agente. Deixe-me ver.	'a 'aw.gu gra'va.du e~'baj.Su, a'Ze~.Ti, 'dej.Si mi 'veX
Parece uma espécie de número de modelo.	pa'rE.si u~.ma es'pE.si Di 'nu~.me.ru Di mo'de.lu
É difícil ver através do saquinho.	E Di'fi.siw 'ver a.tra'vEjs du sa'ki~.Ju
Houve silêncio do outro lado.	'ow.vi si'le~.sju du 'ow.tru 'la.du
Mack sussurrou para Dalton: Pergunte a ela o que isso significa.	'mE.ki su.su'Row 'pa.ra 'daw.to~, peR'gu~.Ti a 'E.la u ki 'i.su si.gi~.ni'fi.ka
O policial hesitou e depois obedeceu.	u po.li.si'aw e.zi'tow i de'pojz o.be.de'sew
Você está aí?	vo'se es'ta a'i
Sim, estou.	'si~, es'tow
De repente a voz pareceu cansada e oca.	Di Re'pe~.Ti a 'vOjs pa.re'sew ka~'sa.da i 'O.ka
Ei, Dalton, há algum lugar isolado onde você e eu possamos conversar?	ej, 'daw.to~, 'a aw'gu~ lu'gar i.zo'la.du 'o~.Di vo'se i ew po'sa~.mus ko~.veX'saX
Mack assentiu com ênfase e Dalton captou a mensagem.	'mE.ki a.se~'Tiw ko~ 'e~.fa.zi i 'daw.to~ kap'tow a me~'sa.Ze~j~
Espere um segundo.	es'pE.ri u~ se'gu~.du
Pousou o saco com o broche e saiu da área, permitindo que Mack o seguisse.	pow'zow u 'sa.ku ko~ u 'brO.Si i sa'iw da 'a.rja, peR.mi'Ti~.du ki 'mE.ki u se'gi.si
Pronto, agora estou sozinho. Pode me dizer o que é.	'pro~.tu, a'gO.ra es'tow sO'zi~.Ju, 'pO.Di mi Di'zer u ki E
Estamos tentando pegar esse cara há quase quatro anos, perseguindo-o em mais de nove estados.	es'ta~.mus te~'ta~.du pe'gar 'e.si 'ka.ra 'a 'kwa.zi 'kwa.tru 'a~.nus, peX.se'gi~.du u e~j~ 'majs Di 'nO.vi es'ta.dus
Recebeu o apelido de Matador de Meninas, mas nunca repassamos o detalhe da joaninha para ninguém, portanto mantenha isso em segredo.	Re.se'bew u a.pe'li.du Di ma.ta'doR Di me~'ni~.nas, majs 'nu~.ka Re.pa'sa~.muz u de'ta.Li da Zo.a~'ni~.Ja 'pa.ra ni~'ge~j~, poX'ta~.tu ma~'te~.Ja 'i.su e~j~ se'gre.du
A cada vez ele acrescenta um ponto à joaninha, de modo que esta seria a de número cinco.	a 'ka.da 'vejz 'e.li a.kre'se~.ta u~ 'po~.tu a Zo.a~'ni~.Ja, Di 'mO.du ki 'Es.ta se'ri.a a Di 'nu~.me.ru 'si~.ku
Todos os crimes aconteceram em campings ou próximo de campings, perto de um parque estadual ou uma reserva.	'to.duz us 'kri~.miz a.ko~.te'se.ra~w~ e~j~ 'ka~.pi~z ow 'prO.si~.mu Di 'ka~.pi~s, 'pEX.tu Di u~ 'paX.ki es.ta.du'aw ow u~.ma Re'zER.va
O criminoso parece se mover com habilidade em florestas e montanhas.	u kri~.mi~'no.zu pa'rE.si si mo'veX ko~ a.bi.li'da.Di e~j~ flo'rEs.taz i mo~'ta~.Jas
Não nos deixou, em todos os casos, absolutamente nada além do broche.	'na~w~ nus dej'Sow, e~j~ 'to.duz us 'ka.zus, ab.so.lu.ta~'me~.Ti 'na.da a'le~j~ du 'brO.Si
E o carro?	i u 'ka.Ru
Temos uma descrição bastante boa da picape verde em que ele fugiu.	'te~.muz u~.ma des.kri'sa~w~ bas'ta~.Ti 'bo.a da pi'ka.pi 'veR.Di e~j~ ki 'e.li fu'Ziw
Ah, vocês provavelmente vão encontrá-la. Se for o nosso cara, ele deve tê-la roubado há um ou dois dias, repintado, enchido de equipamento para caminhadas, e ela vai estar totalmente limpa.	a, vo'sejs pro.va.vew'me~.Ti 'va~w~ e~.ko~'tra la, si 'for u 'nO.su 'ka.ra, 'e.li 'dE.vi 'te la Row'ba.du 'a 'u~ ow 'dojs 'Di.as, Re.pi~'ta.du, e~'Si.du Di e.ki.pa~'me~.tu 'pa.ra ka~.mi~'Ja.das, i 'E.la 'vaj es'taX to.taw'me~.Ti 'li~.pa
Enquanto ouvia a conversa de Dalton com a agente especial, Mack sentiu o resto de esperança se esvair.	e~'kwa~.tu ow'vi.a a ko~'vEX.sa Di 'daw.to~ ko~ a a'Ze~.Ti es.pe.si'aw, 'mE.ki se~'Tiw u 'REs.tu Di es.pe'ra~.sa si ez.va'iX
Sentou-se frouxo no chão e enterrou o rosto nas mãos.	se~'tow si 'frow.Su nu 'Sa~w~ i e~.te'Row u 'Ros.tu nas 'ma~w~s
Pela primeira vez desde o desaparecimento de Missy permitiu-se considerar o alcance das possibilidades mais horrendas e assim que isso começou, não parou mais: imagens de coisas boas e coisas terríveis misturadas num desfile apavorante.	'pe.la pri~'mej.ra 'vejz 'dez.Di u de.za.pa.re.si~'me~.tu Di 'mi.si peR.mi'Tiw si ko~.si.de'rar u aw'ka~.si das po.si.bi.li'da.Dis 'majz o'Re~.daz i a'si~ ki 'i.su ko~.me'sow, 'na~w~ pa'row 'majs, i~'ma.Ze~s Di 'koj.zas 'bo.az i 'koj.zas te'Ri.vejs mis.tu'ra.das nu~ des'fi.li a.pa.vo'ra~.Ti
Algumas eram instantâneos abomináveis de tortura e dor, de monstros e demônios da escuridão mais profunda, com dedos de arame farpado e toques de navalha, de Missy gritando pelo pai e ninguém respondendo.	aw'gu~.maz 'E.ra~w~ i~s.ta~'ta~.njuz a.bo~.mi~'na.vejs Di toX'tu.ra i 'doX, Di 'mo~s.truz i de~'mo~.njus da es.ku.ri'da~w~ 'majs pro'fu~.da, ko~ 'de.dus Di a'ra~.mi faX'pa.du i 'tO.kis Di na'va.La, Di 'mi.si gri'ta~.du 'pe.lu 'paj i ni~'ge~j~ Res.po~'de~.du
Misturados com esses horrores havia lampejos de outras lembranças: a menina aprendendo a andar, com o rosto lambuzado de bolo de chocolate, fazendo caretinhas engraçadas.	mis.tu'ra.dus ko~ 'e.siz o'Ro.riz a'vi.a la~'pe.Zus Di 'ow.tras le~'bra~.sas, a me~'ni~.na a.pre~'de~.du a a~'daX, ko~ u 'Ros.tu la~.bu'za.du Di 'bo.lu Di So.ko'la.Ti, fa'ze~.du ka.re'Ti~.Jaz e~.gra'sa.das
Imagens implacáveis.	i~'ma.Ze~z i~.pla'ka.vejs
O que ele diria a Nan?	u ki 'e.li Di'ri.a a 'na~
Como isso podia ter acontecido?	'ko~.mu 'i.su po'Di.a 'ter a.ko~.te'si.du
Deus, como isso podia ter acontecido?	'dews, 'ko~.mu 'i.su po'Di.a 'ter a.ko~.te'si.du
Algumas horas depois, Mack e seus dois filhos foram de carro para o hotel, em Joseph.	aw'gu~.maz 'O.ras de'pojs, 'mE.ki i 'sews 'dojs 'fi.Lus 'fo.ra~w~ Di 'ka.Ru 'pa.ra u o'tEw, e~j~ 'Zo.zef
Os proprietários haviam lhe oferecido um quarto e, enquanto ele arrumava sua bagagem, a exaustão e o desespero começaram a dominá-lo.	us pro.pri.e'ta.rjuz a'vi.a~w~ Li o.fe.re'si.du u~ 'kwaX.tu i, e~'kwa~.tu 'e.li a.Ru~'ma.va 'su.a ba'ga.Ze~j~, a e.zaws'ta~w~ i u de.zes'pe.ru ko~.me'sa.ra~w~ a do~.mi~'na lu
O policial Dalton levara seus filhos a uma lanchonete.	u po.li.si'aw 'daw.to~ le'va.ra 'sews 'fi.Luz a u~.ma la~.So~'nE.Ti
Agora, sentado na beira da cama, Mack dava vazão a todo o seu sofrimento.	a'gO.ra, se~'ta.du na 'bej.ra da 'ka~.ma, 'mE.ki 'da.va va'za~w~ a 'to.du u 'sew so.fri~'me~.tu
Soluços e gemidos de rasgar a alma saíam do âmago de seu ser, e foi assim que Nan o encontrou.	so'lu.suz i Ze~'mi.dus Di Raz'gar a 'aw.ma sa'i.a~w~ du 'a~.ma.gu Di 'sew 'seX, i 'foj a'si~ ki 'na~ u e~.ko~'trow
Dois seres feridos que se abraçaram e choraram desconsoladamente.	'dojs 'se.ris fe'ri.dus ki si a.bra'sa.ra~w~ i So'ra.ra~w~ des.ko~.so.la.da~'me~.Ti
Naquela noite, Mack dormiu aos sobressaltos, pois as imagens continuavam a golpeá-lo como ondas implacáveis contra um litoral rochoso.	na'kE.la 'noj.Ti, 'mE.ki doR'miw aws so.bre'saw.tus, 'pojz az i~'ma.Ze~s ko~.Ti~.nu'a.va~w~ a gow.pe'a lu 'ko~.mu 'o~.daz i~.pla'ka.vejs 'ko~.tra u~ li.to'raw Ro'So.zu
Pouco antes do nascer do sol, por fim desistiu.	'pow.ku 'a~.Tis du na'seR du 'sOw, puX 'fi~ de.zis'Tiw
Vivera em um só dia anos de emoções e agora sentia-se entorpecido, à deriva num mundo subitamente sem significado.	vi've.ra e~j~ 'u~ 'sO 'Di.a 'a~.nus Di e~.mo'so~j~z i a'gO.ra se~'Ti.a si e~.toX.pe'si.du, a de'ri.va nu~ 'mu~.du su.bi.ta~'me~.Ti se~j~ si.gi~.ni.fi'ka.du
Depois de protestos consideráveis de Nan, concordaram que seria melhor ela ir para casa com Josh e Kate.	de'pojs Di pro'tEs.tus ko~.si.de'ra.vejs Di 'na~, ko~.koR'da.ra~w~ ki se'ri.a me'LOr 'E.la 'iX 'pa.ra 'ka.za ko~ 'ZOS i 'kej.Ti
Mack ficaria para ajudar como pudesse.	'mE.ki fi.ka'ri.a 'pa.ra a.Zu'daX 'ko~.mu pu'dE.si
Simplesmente não conseguiria ir embora, pensando que Missy talvez estivesse por perto, precisando dele.	si~.pliz'me~.Ti 'na~w~ ko~.se.gi'ri.a 'ir e~'bO.ra, pe~'sa~.du ki 'mi.si taw'vejz es.Ti'vE.si puX 'pEX.tu, pre.si'za~.du 'de.li
A notícia se espalhara rapidamente e amigos começaram a chegar para ajudá-lo.	a no'Ti.sja si es.pa'La.ra Ra.pi.da~'me~.Ti i a~'mi.gus ko~.me'sa.ra~w~ a Se'gaX 'pa.ra a.Zu'da lu
Criou-se uma forte rede de solidariedade, todos os conhecidos orando para que Missy fosse encontrada.	kri'ow si u~.ma 'fOX.Ti 'Re.Di Di so.li.da.ri.e'da.Di, 'to.duz us ko~.Je'si.duz o'ra~.du 'pa.ra ki 'mi.si 'fo.si e~.ko~'tra.da
Jesse e Sarah, Emil e Vicky permaneceram o tempo todo desdobrando-se em cuidados.	'ZE.si i 'sa.ra, e~'miw i 'vi.ki peR.ma~.ne'se.ra~w~ u 'te~.pu 'to.du dez.do'bra~.du si e~j~ kuj'da.dus
Repórteres com seus fotógrafos começaram a aparecer durante a manhã.	Re'pOX.te.ris ko~ 'sews fo'tO.gra.fus ko~.me'sa.ra~w~ a a.pa.re'seR du'ra~.Ti a ma~'Ja~
Mack não queria enfrentá-los, mas acabou respondendo às perguntas na esperança de que a divulgação pudesse ajudar na busca.	'mE.ki 'na~w~ ke'ri.a e~.fre~'ta lus, majz a.ka'bow Res.po~'de~.du as peR'gu~.tas na es.pe'ra~.sa Di ki a Di.vuw.ga'sa~w~ pu'dE.si a.Zu'daR na 'bus.ka
Quando ficou evidente que a necessidade de ajuda estava diminuindo, os Madison desmontaram seu acampamento e vieram despedir-se.	'kwa~.du fi'kow e.vi'de~.Ti ki a ne.se.si'da.Di Di a'Zu.da es'ta.va Di~.mi~.nu'i~.du, us 'ma.Di.so~ dez.mo~'ta.ra~w~ 'sew a.ka~.pa~'me~.tu i vi'E.ra~w~ des.pe'DiX si
Choraram muito, abraçaram-se longamente e colocaram-se à disposição para o que fosse necessário.	So'ra.ra~w~ 'mu~j~.tu, a.bra'sa.ra~w~ si lo~.ga~'me~.Ti i ko.lo'ka.ra~w~ si a Dis.po.zi'sa~w~ 'pa.ra u ki 'fo.si ne.se'sa.rju
Vicky Ducette também partiu, mas Emil permaneceu para dar apoio a Mack.	'vi.ki du'sE.Ti ta~'be~j~ paX'Tiw, majz e~'miw peR.ma~.ne'sew 'pa.ra 'dar a'poj.u a 'mE.ki
Maryanne levou Nan e as crianças para casa, onde os parentes estariam esperando.	ma.ri'a~.ni le'vow 'na~ i as kri'a~.sas 'pa.ra 'ka.za, 'o~.Di us pa're~.Tiz es.ta'ri.a~w~ es.pe'ra~.du
Mack e Emil foram com o policial Dalton, que passaram a chamar de Tommy, para Joseph, onde se dirigiram à delegacia.	'mE.ki i e~'miw 'fo.ra~w~ ko~ u po.li.si'aw 'daw.to~, ki pa'sa.ra~w~ a Sa~'maR Di 'to~.mi, 'pa.ra 'Zo.zef, 'o~.Di si Di.ri'Zi.ra~w~ a de.le.ga'si.a
Agora vinha a parte mais difícil: a espera.	a'gO.ra 'vi~.Ja a 'paX.Ti 'majs Di'fi.siw, a es'pE.ra
Mack sentia que estava andando em câmara lenta dentro do olho de um furacão.	'mE.ki se~'Ti.a ki es'ta.va a~'da~.du e~j~ 'ka~.ma.ra 'le~.ta 'de~.tru du 'o.Lu Di u~ fu.ra'ka~w~
O grupo do FBI chegou no meio da tarde e logo ficou claro que a pessoa encarregada era a agente especial Wikowsky, uma mulher pequena e magra cheia de energia, de quem Mack gostou no mesmo instante.	u 'gru.pu du 'E.fi 'be 'i Se'gow nu 'mej.u da 'taR.Di i 'lO.gu fi'kow 'kla.ru ki a pe'so.a e~.ka.Re'ga.da 'E.ra a a'Ze~.Ti es.pe.si'aw wi'kow.ski, u~.ma mu'LEX pe'ke~.na i 'ma.gra 'Sej.a Di e~.neR'Zi.a, Di 'ke~j~ 'mE.ki gos'tow nu 'mez.mu i~s'ta~.Ti
Depois de estabelecer o centro de comando no hotel, o FBI pediu a Mack uma entrevista formal.	de'pojs Di es.ta.be.le'ser u 'se~.tru Di ko~'ma~.du nu o'tEw, u 'E.fi 'be 'i pe'Diw a 'mE.ki u~.ma e~.tre'vis.ta foR'maw
A agente Wikowsky levantou-se de trás da mesa onde estava trabalhando e estendeu a mão.	a a'Ze~.Ti wi'kow.ski le.va~'tow si Di 'trajs da 'me.za 'o~.Di es'ta.va tra.ba'La~.du i es.te~'dew a 'ma~w~
Senhor Phillips, peço desculpas por não lhe ter dado até agora a atenção que merece.	se~'JoX 'fi.lips, 'pE.su des'kuw.pas puR 'na~w~ Li 'teR 'da.du a'tE a'gO.ra a a.te~'sa~w~ ki me'rE.si
Lamento muito que tenhamos nos conhecido nessas circunstâncias.	la~'me~.tu 'mu~j~.tu ki te~'Ja~.mus nus ko~.Je'si.du 'nE.sas siX.ku~s'ta~.sjas
Mack suspirou fundo.	'mE.ki sus.pi'row 'fu~.du
Por favor, me chame de Mack.	puX fa'voX, mi 'Sa~.mi Di 'mE.ki
Bem, então me chame de Sam, que é a forma abreviada de Samantha.	'be~j~, e~'ta~w~ mi 'Sa~.mi Di 'sa~, ki E a 'fOR.ma a.bre.vi'a.da Di sa~'ma~.Ta
Mack relaxou um pouco na cadeira, vendo-a examinar rapidamente algumas pastas cheias de papéis.	'mE.ki Re.la'Sow u~ 'pow.ku na ka'dej.ra, 've~.du a e.za~.mi~'na.Ra.pi.da~'me~.Ti aw'gu~.mas 'pas.ta'Sej.as Di pa'pEjs
Mack, está disposto a responder a algumas perguntas? ela perguntou sem levantar a cabeça.	'mE.ki, es'ta Dis'pos.tu a Res.po~'der a aw'gu~.mas peR'gu~.tas, 'E.la peR.gu~'tow se~j~ le.va~'tar a ka'be.sa
Farei o máximo possível, ele afirmou, aliviado pela oportunidade de fazer alguma coisa.	fa'rej u 'ma.si~.mu po'si.vew, 'e.li a.fiR'mow, a.li.vi'a.du 'pe.la o.poX.tu~.ni'da.Di Di fa'zer aw'gu~.ma 'koj.za
Bom! Não vou obrigá-lo a repassar todos os detalhes.	'bo~, 'na~w~ 'vow o.bri'ga lu a Re.pa'saX 'to.duz us de'ta.Lis
Qualquer coisa que eu possa fazer para ajudar, concordou Mack.	kwaw'kEX 'koj.za ki ew 'pO.sa fa'zeX 'pa.ra a.Zu'daX, ko~.koR'dow 'mE.ki
No momento estou me sentindo bastante impotente.	nu mo~'me~.tu es'tow mi se~'Ti~.du bas'ta~.Ti i~.po'te~.Ti
Mack, entendo como você se sente, mas sua presença é importante.	'mE.ki, e~'te~.du 'ko~.mu vo'se si 'se~.Ti, majs 'su.a pre'ze~.sa E i~.poX'ta~.Ti
E acredite, todos aqui estão dispostos a fazer o máximo possível para resgatar Missy.	i a.kre'Di.Ti, 'to.duz a'ki es'ta~w~ Dis'pOs.tuz a fa'zer u 'ma.si~.mu po'si.vew 'pa.ra Rez.ga'taR 'mi.si
Obrigado, foi tudo que Mack conseguiu dizer, olhando para o chão.	o.bri'ga.du, 'foj 'tu.du ki 'mE.ki ko~.se'giw Di'zeX, o'La~.du 'pa.ra u 'Sa~w~
As emoções pareciam à flor da pele e qualquer gesto de gentileza abria as comportas para as lágrimas saírem.	az e~.mo'so~j~s pa.re'si.a~w~ a 'floR da 'pE.li i kwaw'kER 'ZEs.tu Di Ze~.Ti'le.za a'bri.a as ko~'pOX.tas 'pa.ra as 'la.gri~.mas sa'i.re~j~
Mack, ela continuou, você notou alguma coisa estranha ao redor de sua família nestes últimos dias?	'mE.ki, 'E.la ko~.Ti~.nu'ow, vo'se no'tow aw'gu~.ma 'koj.za es'tra~.Ja aw Re'dOR Di 'su.a fa~'mi.lja 'nes.Tiz 'uw.Ti~.mus 'Di.as
Mack ficou surpreso e se recostou na cadeira.	'mE.ki fi'kow suX'pre.zu i si Re.kos'tow na ka'dej.ra
Quer dizer que ele estava nos rondando?	'kER Di'zeX ki 'e.li es'ta.va nus Ro~'da~.du
Achamos que ele as descobre um ou dois dias antes e espera, vigiando de perto até encontrar o momento oportuno.	a'Sa~.mus ki 'e.li as des'kO.bri 'u~ ow 'dojs 'Di.az 'a~.Tiz i es'pE.ra, vi.Zi'a~.du Di 'pEX.tu a'tE e~.ko~'trar u mo~'me~.tu o.poX'tu~.nu
Você viu alguém estranho próximo do lago?	vo'se 'viw aw'ge~j~ es'tra~.Ju 'prO.si~.mu du 'la.gu
Talvez junto aos banheiros?	taw'vejz 'Zu~.tu aws ba~'Jej.rus
Mack se encolheu ao pensar que seus filhos estariam sendo vigiados.	'mE.ki si e~.ko'Lew aw pe~'saX ki 'sews 'fi.Luz es.ta'ri.a~w~ 'se~.du vi.Zi'a.dus
Esquadrinhou a mente, mas não descobriu nada.	es.kwa.dri~'Jow a 'me~.Ti, majs 'na~w~ des.ko'briw 'na.da
Desculpe, não consigo lembrar...	des'kuw.pi, 'na~w~ ko~'si.gu le~'braX
Você parou em algum lugar enquanto ia para o camping ou notou alguém estranho quando estava fazendo caminhadas?	vo'se pa'row e~j~ aw'gu~ lu'gar e~'kwa~.tu 'i.a 'pa.ra u 'ka~.pi~ ow no'tow aw'ge~j~ es'tra~.Ju 'kwa~.du es'ta.va fa'ze~.du ka~.mi~'Ja.das
Nós paramos na cachoeira Multnomah, vindo para cá, e estivemos em toda a região nos últimos três dias, mas não me lembro de ter visto ninguém que parecesse estranho.	'nOjs pa'ra~.mus na ka.So'ej.ra muw.Ti~.no~'ma, 'vi~.du 'pa.ra 'ka, i es.Ti've~.muz e~j~ 'to.da a Re.Zi'a~w~ nuz 'uw.Ti~.mus 'trejs 'Di.as, majs 'na~w~ mi 'le~.bru Di 'teR 'vis.tu ni~'ge~j~ ki pa.re'se.si es'tra~.Ju
Algo pode voltar à sua mente mais tarde.	'aw.gu 'pO.Di vow'tar a 'su.a 'me~.Ti 'majs 'taR.Di
Mesmo que pareça pequeno ou irrelevante, por favor, nos conte.	'mez.mu ki pa're.sa pe'ke~.nu ow i.Re.le'va~.Ti, puX fa'voX, nus 'ko~.Ti
Ela olhou outro papel na mesa.	'E.la o'Low 'ow.tru pa'pEw na 'me.za
Que tal uma picape verde-oliva?	ki 'taw u~.ma pi'ka.pi 'veR.Di o'li.va
Você notou algo assim enquanto estava por aqui?	vo'se no'tow 'aw.gu a'si~ e~'kwa~.tu es'ta.va pur a'ki
Mack revirou a memória.	'mE.ki Re.vi'row a me~'mO.rja
Realmente não me lembro de ter visto nada do tipo.	Re.aw'me~.Ti 'na~w~ mi 'le~.bru Di 'teR 'vis.tu 'na.da du 'Ti.pu
A agente especial Wikowsky continuou a interrogar Mack durante os 15 minutos seguintes, mas não conseguiu despertar a memória dele o suficiente para descobrir algo útil.	a a'Ze~.Ti es.pe.si'aw wi'kow.ski ko~.Ti~.nu'ow a i~.te.Ro'gaR 'mE.ki du'ra~.Ti us 'ki~.zi mi~'nu.tus se'gi~.Tis, majs 'na~w~ ko~.se'giw des.peX'tar a me~'mO.rja 'de.li u su.fi.si'e~.Ti 'pa.ra des.ko'brir 'aw.gu 'u.Tiw
Por fim, fechou o caderno e se levantou estendendo a mão.	puX 'fi~, fe'Sow u ka'dER.nu i si le.va~'tow es.te~'de~.du a 'ma~w~
Mack, mais uma vez, lamento o que aconteceu com Missy.	'mE.ki, 'majz u~.ma 'vejs, la~'me~.tu u ki a.ko~.te'sew ko~ 'mi.si
Se descobrirmos alguma coisa, eu o informarei imediatamente.	si des.ko'briR.muz aw'gu~.ma 'koj.za, ew u i~.foR.ma'rej i~.me.Di.a.ta~'me~.Ti
Às cinco da tarde finalmente chegou o primeiro informe promissor e a agente Wikowsky colocou Mack imediatamente a par.	as 'si~.ku da 'taR.Di fi~.naw'me~.Ti Se'gow u pri~'mej.ru i~'fOR.mi pro~.mi'sor i a a'Ze~.Ti wi'kow.ski ko.lo'kow 'mE.ki i~.me.Di.a.ta~'me~.Ti a 'paX
Dois casais haviam passado por uma picape verde-oliva que correspondia à descrição do veículo que estavam procurando.	'dojs ka'zajz a'vi.a~w~ pa'sa.du pur u~.ma pi'ka.pi 'veR.Di o'li.va ki ko.Res.po~'Di.a a des.kri'sa~w~ du ve'i.ku.lu ki es'ta.va~w~ pro.ku'ra~.du
Eles estavam em um trecho estreito da estrada e tiveram que dar marcha a ré até um lugar mais largo para permitir a passagem da picape.	'e.liz es'ta.va~w~ e~j~ u~ 'tre.Su es'trej.tu da es'tra.da i Ti'vE.ra~w~ ki 'daR 'maX.Sa a 'RE a'tE u~ lu'gaR 'majs 'laR.gu 'pa.ra peR.mi'Tir a pa'sa.Ze~j~ da pi'ka.pi
Notaram que na carroceria havia várias latas de gasolina, além de uma boa quantidade de material de acampamento.	no'ta.ra~w~ ki na ka.Ro.se'ri.a a'vi.a 'va.rjas 'la.tas Di ga.zo'li~.na, a'le~j~ Di u~.ma 'bo.a kwa~.Ti'da.Di Di ma.te.ri'aw Di a.ka~.pa~'me~.tu
Estranharam que o motorista tivesse se curvado na direção do carona, como se procurasse alguma coisa no chão, e estivesse usando um casaco pesado num dia tão quente.	es.tra~'Ja.ra~w~ ki u mo.to'ris.ta Ti'vE.si si kuR'va.du na Di.re'sa~w~ du ka'ro~.na, 'ko~.mu si pro.ku'ra.si aw'gu~.ma 'koj.za nu 'Sa~w~, i es.Ti'vE.si u'za~.du u~ ka'za.ku pe'za.du nu~ 'Di.a 'ta~w~ 'ke~.Ti
Acharam graça daquilo e seguiram em frente.	a'Sa.ra~w~ 'gra.sa da'ki.lu i se'gi.ra~w~ e~j~ 'fre~.Ti
Quando essa notícia chegou, a tensão aumentou na delegacia.	'kwa~.du 'E.sa no'Ti.sja Se'gow, a te~'sa~w~ aw~.me~'tow na de.le.ga'si.a
Tudo haviam descoberto até agora se encaixava no modo de agir do Matador de Meninas, e Mack foi informado.	'tu.du a'vi.a~w~ des.ko'bEX.tu a'tE a'gO.ra si e~.kaj'Sa.va nu 'mO.du Di a'ZiR du ma.ta'doR Di me~'ni~.nas, i 'mE.ki 'foj i~.foR'ma.du
Seu desejo era chamar Tommy e ir pessoalmente atrás do assassino.	'sew de'ze.Zu 'E.ra Sa~'maX 'to~.mi i 'iX pe.so.aw'me~.Ti a'trajs du a.sa'si~.nu
Era como se cada minuto contasse.	'E.ra 'ko~.mu si 'ka.da mi~'nu.tu ko~'ta.si
Mack ligou rapidamente para falar com Nan e partiu com Tommy.	'mE.ki li'gow Ra.pi.da~'me~.Ti 'pa.ra fa'laX ko~ 'na~ i paX'Tiw ko~ 'to~.mi
Lágrimas desciam por seu rosto e molhavam a camisa.	'la.gri~.mas de'si.a~w~ puX 'sew 'Ros.tu i mo'La.va~w~ a ka~'mi.za
Por volta das 7 horas, o comboio de radiopatrulhas, utilitários do FBI, picapes com cães e alguns veículos da Guarda Florestal seguiu pela auto-estrada até entrar na Reserva.	puR 'vOw.ta das 'sE.Ti 'O.ras, u ko~'boj.u Di Ra.Di.o.pa'tru.Las, u.Ti.li'ta.rjus du 'E.fi 'be 'i, pi'ka.pis ko~ 'ka~j~z i aw'gu~s ve'i.ku.lus da 'gwaR.da flo.res'taw se'giw 'pe.la 'aw.tu es'tra.da a'tE e~'traR na Re'zER.va
Mack ficou satisfeito por viajar com alguém que conhecia a área.	'mE.ki fi'kow sa.Tis'fej.tu puR vi.a'ZaX ko~ aw'ge~j~ ki ko~.Je'si.a a 'a.rja
As estradas, com frequentes curvas estreitas beirando precipícios, ficavam ainda mais traiçoeiras na escuridão da noite.	az es'tra.das, ko~ fre'kwe~.Tis 'kuR.vaz es'trej.tas bej'ra~.du pre.si'pi.sjus, fi'ka.va~w~ a'i~.da 'majs traj.so'ej.ras na es.ku.ri'da~w~ da 'noj.Ti
A velocidade foi diminuindo até parecer que estavam se arrastando.	a ve.lo.si'da.Di 'foj Di~.mi~.nu'i~.du a'tE pa.re'seX ki es'ta.va~w~ si a.Ras'ta~.du
Por fim, passaram pelo ponto onde a picape verde tinha sido vista pela última vez e um quilômetro e meio depois chegaram a uma bifurcação.	puX 'fi~, pa'sa.ra~w~ 'pe.lu 'po~.tu 'o~.Di a pi'ka.pi 'veR.Di 'Ti~.Ja 'si.du 'vis.ta 'pe.la 'uw.Ti~.ma 'vejz i 'u~ ki'lo~.me.tru i 'mej.u de'poj.Se'ga.ra~w~ a u~.ma bi.fuX.ka'sa~w~
Ali, como fora planejado a caravana se dividiu em duas, com um pequeno grupo indo para o norte com a agente especial Wikowsky e os demais, inclusive Mack, Emil e Tommy, indo na direção sudeste.	a'li, 'ko~.mu 'fo.ra pla~.ne'Za.du a ka.ra'va~.na si Di.vi'Diw e~j~ 'du.as, ko~ u~ pe'ke~.nu 'gru.pu 'i~.du 'pa.ra u 'nOX.Ti ko~ a a'Ze~.Ti es.pe.si'aw wi'kow.ski i us de~'majs, i~.klu'zi.vi 'mE.ki, e~'miw i 'to~.mi, 'i~.du na Di.re'sa~w~ su'dEs.Ti
Alguns quilômetros difíceis mais tarde esse grupo se dividiu outra vez.	aw'gu~s ki'lo~.me.trus Di'fi.sejs 'majs 'taR.Di 'e.si 'gru.pu si Di.vi'Diw 'ow.tra 'vejs
E nesse ponto os esforços de busca ficaram ainda mais lentos.	i 'ne.si 'po~.tu uz es'fOX.sus Di 'bus.ka fi'ka.ra~w~ a'i~.da 'majs 'le~.tus
Agora os rastreadores estavam a pé, apoiados por luzes fortes, enquanto procuravam sinais de atividade recente nas estradas.	a'gO.ra us Ras.tre.a'do.riz es'ta.va~w~ a 'pE, a.poj'a.dus puR 'lu.zis 'fOX.Tis, e~'kwa~.tu pro.ku'ra.va~w~ si~'najs Di a.Ti.vi'da.Di Re'se~.Ti naz es'tra.das
Quase duas horas mais tarde, Tommy recebeu um chamado de Wikowsky.	'kwa.zi 'du.az 'O.ras 'majs 'taR.Di, 'to~.mi Re.se'bew u~ Sa~'ma.du Di wi'kow.ski
A cerca de 15 quilômetros da bifurcação onde tinham se separado, uma estrada antiga e sem nome saía da principal.	a 'seX.ka Di 'ki~.zi ki'lo~.me.trus da bi.fuX.ka'sa~w~ 'o~.Di 'Ti~.Ja~w~ si se.pa'ra.du, u~.ma es'tra.da a~'Ti.ga i se~j~ 'no~.mi sa'i.a da pri~.si'paw
Era praticamente impossível de se ver no escuro e cheia de buracos.	'E.ra pra.Ti.ka~'me~.Ti i~.po'si.vew Di si 'veR nu es'ku.ru i 'Sej.a Di bu'ra.kus
Eles a teriam ignorado se a luz de um dos rastreadores não tivesse se refletido numa calota de veículo.	'e.liz a te'ri.a~w~ i.gi~.no'ra.du si a 'lujz Di 'u~ dus Ras.tre.a'do.ris 'na~w~ Ti'vE.si si Re.fle'Ti.du 'nu~.ma ka'lO.ta Di ve'i.ku.lu
Debaixo do pó da estrada havia manchas de tinta verde.	de'baj.Su du 'pO da es'tra.da a'vi.a 'ma~.Sas Di 'Ti~.ta 'veR.Di
O grupo de Tommy voltou imediatamente.	u 'gru.pu Di 'to~.mi vow'tow i~.me.Di.a.ta~'me~.Ti
O coração de Mack batia aceleradamente com um começo de esperança.	u ko.ra'sa~w~ Di 'mE.ki ba'Ti.a a.se.le.ra.da~'me~.Ti ko~ u~ ko~'me.su Di es.pe'ra~.sa
Talvez, por algum milagre, Missy ainda estivesse viva.	taw'vejs, pur aw'gu~ mi'la.gri, 'mi.si a'i~.da es.Ti'vE.si 'vi.va
Vinte minutos depois, outra ligação de Wikowsky informava que haviam encontrado a picape debaixo de uma engenhosa armação de galhos e arbustos.	'vi~.Ti mi~'nu.tus de'pojs, 'ow.tra li.ga'sa~w~ Di wi'kow.ski i~.foR'ma.va ki a'vi.a~w~ e~.ko~'tra.du a pi'ka.pi de'baj.Su Di u~.ma e~.Ze~'JO.za aR.ma'sa~w~ Di 'ga.Luz i aR'bus.tus
A equipe de Mack levou quase três horas para alcançar a primeira equipe e, nesse ponto, tudo estava acabado.	a e'ki.pi Di 'mE.ki le'vow 'kwa.zi 'trejz 'O.ras 'pa.ra aw.ka~'sar a pri~'mej.ra e'ki.pi i, 'ne.si 'po~.tu, 'tu.du es'ta.va a.ka'ba.du
Ali encontraram uma cabana em ruínas à beira de um lago límpido alimentado por um riacho cascateante.	a'li e~.ko~'tra.ra~w~ u~.ma ka'ba~.na e~j~ Ru'i~.naz a 'bej.ra Di u~ 'la.gu 'li~.pi.du a.li~.me~'ta.du pur u~ Ri'a.Su kas.ka.te'a~.Ti
Quando Mack e seus amigos chegaram, o céu estava começando a clarear.	'kwa~.du 'mE.ki i 'sewz a~'mi.gu.Se'ga.ra~w~, u 'sEw es'ta.va ko~.me'sa~.du a kla.re'aX
Um acampamento-base fora montado a certa distância da pequena cabana para preservar a cena do crime.	u~ a.ka~.pa~'me~.tu 'ba.zi 'fo.ra mo~'ta.du a 'sEX.ta Dis'ta~.sja da pe'ke~.na ka'ba~.na 'pa.ra pre.zeR'var a 'se~.na du 'kri~.mi
A agente especial Samantha Wikowsky estava sentada diante de uma mesa dobrável examinando mapas quando Mack apareceu.	a a'Ze~.Ti es.pe.si'aw sa~'ma~.Ta wi'kow.ski es'ta.va se~'ta.da Di'a~.Ti Di u~.ma 'me.za do'bra.vew e.za~.mi~'na~.du 'ma.pas 'kwa~.du 'mE.ki a.pa.re'sew
Seus olhos expressavam tristeza e ternura, mas suas palavras foram totalmente profissionais.	'sewz 'O.Luz es.pre'sa.va~w~ tris'te.za i teR'nu.ra, majs 'su.as pa'la.vras 'fo.ra~w~ to.taw'me~.Ti pro.fi.si.o~'najs
Mack, nós encontramos uma coisa, mas não é boa.	'mE.ki, 'nOjz e~.ko~'tra~.muz u~.ma 'koj.za, majs 'na~w~ E 'bo.a
Ele procurou as palavras certas.	'e.li pro.ku'row as pa'la.vras 'sEX.tas
Encontraram Missy?	e~.ko~'tra.ra~w~ 'mi.si
Ele temia terrivelmente a resposta, mas estava desesperado para ouvi-la.	'e.li te~'mi.a te.Ri.vew'me~.Ti a Res'pOs.ta, majz es'ta.va de.zes.pe'ra.du 'pa.ra ow'vi la
Não, não encontramos.	'na~w~, 'na~w~ e~.ko~'tra~.mus
Sam parou e começou a se levantar.	'sa~ pa'row i ko~.me'sow a si le.va~'taX
Mas preciso que você identifique uma coisa que encontramos na cabana.	majs pre'si.zu ki vo'se i.de~.Ti'fi.ki u~.ma 'koj.za ki e~.ko~'tra~.mus na ka'ba~.na
Quero dizer, se é dela.	'kE.ru Di'zeX, si E 'dE.la
Mack sentiu que sua represa interna estava prestes a arrebentar.	'mE.ki se~'Tiw ki 'su.a Re'pre.za i~'tER.na es'ta.va 'prEs.Tiz a a.Re.be~'taX
Vamos ver isso agora, murmurou baixinho.	'va~.mus 'ver 'i.su a'gO.ra, muR.mu'row baj'Si~.Ju
Quero resolver logo.	'kE.ru Re.zow'veR 'lO.gu
Três homens adultos de braços dados numa solidariedade especial, andando juntos em direção ao seu pior pesadelo.	'trejz 'o~.me~z a'duw.tus Di 'bra.sus 'da.dus 'nu~.ma so.li.da.ri.e'da.Di es.pe.si'aw, a~'da~.du 'Zu~.tuz e~j~ Di.re'sa~w~ aw 'sew pi'OX pe.za'de.lu
Um membro da equipe de perícia abriu a porta da cabana para deixá-los entrar.	u~ 'me~.bru da e'ki.pi Di pe'ri.sja a'briw a 'pOX.ta da ka'ba~.na 'pa.ra dej'Sa luz e~'traX
Refletores alimentados por um gerador iluminavam cada parte da sala.	Re.fle'to.riz a.li~.me~'ta.dus pur u~ Ze.ra'dor i.lu~.mi~'na.va~w~ 'ka.da 'paX.Ti da 'sa.la
Havia prateleiras nas paredes, uma mesa velha, algumas cadeiras e um sofá.	a'vi.a pra.te'lej.ras nas pa're.Dis, u~.ma 'me.za 'vE.La, aw'gu~.mas ka'dej.raz i u~ so'fa
Mack viu imediatamente o que viera identificar.	'mE.ki 'viw i~.me.Di.a.ta~'me~.Ti u ki vi'E.ra i.de~.Ti.fi'kaX
Virando-se, desmoronou nos braços dos dois amigos e começou a chorar incontrolavelmente.	vi'ra~.du si, dez.mo.ro~'now nus 'bra.sus dus 'dojz a~'mi.guz i ko~.me'sow a So'rar i~.ko~.tro.la.vew'me~.Ti
No chão, perto da lareira, estava o vestido vermelho de Missy, rasgado e encharcado de sangue.	nu 'Sa~w~, 'pEX.tu da la'rej.ra, es'ta.va u ves'Ti.du veR'me.Lu Di 'mi.si, Raz'ga.du i e~.SaX'ka.du Di 'sa~.gi
Para Mack, os dias e semanas seguintes se tornaram um borrão de entrevistas que entorpeciam as emoções.	'pa.ra 'mE.ki, us 'Di.az i se~'ma~.nas se'gi~.Tis si toR'na.ra~w~ u~ bo'Ra~w~ Di e~.tre'vis.tas ki e~.toX.pe'si.a~w~ az e~.mo'so~j~s
Por fim, um funeral dedicado a Missy com um pequeno caixão vazio e um desfile interminável de rostos tristes, ninguém sabendo o que dizer.	puX 'fi~, u~ fu~.ne'raw de.Di'ka.du a 'mi.si ko~ u~ pe'ke~.nu kaj'Sa~w~ va'zi.u i u~ des'fi.li i~.teR.mi~'na.vew Di 'Ros.tus 'tris.Tis, ni~'ge~j~ sa'be~.du u ki Di'zeX
Em algum momento, nas semanas que se seguiram, Mack iniciou o lento e doloroso reencontro com a vida cotidiana.	e~j~ aw'gu~ mo~'me~.tu, nas se~'ma~.nas ki si se'gi.ra~w~, 'mE.ki i~.ni.si'ow u 'le~.tu i do.lo'ro.zu Re.e~'ko~.tru ko~ a 'vi.da ko.Ti.Di'a~.na
Aparentemente o Matador de Meninas recebera o crédito pela quinta vítima, Melissa Anne Phillips.	a.pa.re~.Ti~'me~.Ti u ma.ta'doR Di me~'ni~.nas Re.se'be.ra u 'krE.Di.tu 'pe.la 'ki~.ta 'vi.Ti~.ma, me'li.sa 'a~.ni 'fi.lips
Assim como nos outros quatro casos, as autoridades não encontraram o corpo da vítima, embora grupos de busca tivessem revirado a floresta durante dias.	a'si~ 'ko~.mu nuz 'ow.trus 'kwa.tru 'ka.zus, az aw.to.ri'da.Dis 'na~w~ e~.ko~'tra.ra~w~ u 'koX.pu da 'vi.Ti~.ma, e~'bO.ra 'gru.pus Di 'bus.ka Ti'vE.se~j~ Re.vi'ra.du a flo'rEs.ta du'ra~.Ti 'Di.as
Era como se estivessem lidando com um fantasma.	'E.ra 'ko~.mu si es.Ti'vE.se~j~ li'da~.du ko~ u~ fa~'taz.ma
Em algum ponto do processo, Mack procurou emergir da dor e do sofrimento, pelo menos com sua família.	e~j~ aw'gu~ 'po~.tu du pro'sE.su, 'mE.ki pro.ku'row e~.meR'ZiR da 'dor i du so.fri~'me~.tu, 'pe.lu 'me~.nus ko~ 'su.a fa~'mi.lja
Eles haviam perdido uma irmã e uma filha e seria terrível também perderem um pai e um marido.	'e.liz a'vi.a~w~ peR'Di.du u~.ma iR'ma~ i u~.ma 'fi.La i se'ri.a te'Ri.vew ta~'be~j~ peR'de.re~j~ u~ 'paj i u~ ma'ri.du
Mack e Nan preocupavam-se cada vez mais com ela, mas não conseguiam encontrar as palavras adequadas para penetrar na fortaleza que a garota estava construindo ao redor de si.	'mE.ki i 'na~ prew.ku'pa.va~w~ si 'ka.da 'vejz 'majs ko~ 'E.la, majs 'na~w~ ko~.se'gi.a~w~ e~.ko~'trar as pa'la.vraz a.de'kwa.das 'pa.ra pe~.ne'traR na foX.ta'le.za ki a ga'ro.ta es'ta.va ko~s.tru'i~.du aw Re'dOR Di si
As tentativas de conversa se transformavam em monólogos, como se algo tivesse morrido dentro dela e agora a estivesse corroendo lentamente por dentro, derramando-se às vezes em palavras amargas ou num silêncio deprimido.	as te~.ta'Ti.vas Di ko~'vEX.sa si tra~s.foR'ma.va~w~ e~j~ mo~'nO.lo.gus, 'ko~.mu si 'aw.gu Ti'vE.si mo'Ri.du 'de~.tru 'dE.la i a'gO.ra a es.Ti'vE.si ko.Ro'e~.du le~.ta~'me~.Ti puR 'de~.tru, de.Ra~'ma~.du si as 've.ziz e~j~ pa'la.vraz a~'maR.gaz ow nu~ si'le~.sju de.pri~'mi.du
Josh se comunicava frequentemente com Amber, o que o ajudava a extravasar a dor.	'ZOS si ko~.mu~.ni'ka.va fre.kwe~.Ti~'me~.Ti ko~ 'a~.beX, u ki u a.Zu'da.va a es.tra.va'zar a 'doX
Além disso, estava bastante ocupado preparando-se para a formatura no ensino médio.	a'le~j~ 'Di.su, es'ta.va bas'ta~.Ti o.ku'pa.du pre.pa'ra~.du si 'pa.ra a foR.ma'tu.ra nu e~'si~.nu 'mE.Dju
A Grande Tristeza havia baixado como uma nuvem e, em graus diferentes, cobria todos os que tinham conhecido Missy.	a 'gra~.Di tris'te.za a'vi.a baj'Sa.du 'ko~.mu u~.ma 'nu.ve~j~ i, e~j~ 'graws Di.fe're~.Tis, ko'bri.a 'to.duz us ki 'Ti~.Ja~w~ ko~.Je'si.du 'mi.si
Mack e Nan enfrentavam juntos o tormento da perda, sentindo-se mais próximos do que nunca.	'mE.ki i 'na~ e~.fre~'ta.va~w~ 'Zu~.tuz u toR'me~.tu da 'peR.da, se~'Ti~.du si 'majs 'prO.si~.mus du ki 'nu~.ka
Nan repetia seguidamente que não culpava de modo algum Mack pelo que acontecera.	'na~ Re.pe'Ti.a se.gi.da~'me~.Ti ki 'na~w~ kuw'pa.va Di 'mO.du aw'gu~ 'mE.ki 'pe.lu ki a.ko~.te'se.ra
Mack, porém, levou muito mais tempo para se livrar de todos os se que o levaram ao desespero.	'mE.ki, po're~j~, le'vow 'mu~j~.tu 'majs 'te~.pu 'pa.ra si li'vraR Di 'to.duz us si ki u le'va.ra~w~ aw de.zes'pe.ru
Se ele tivesse decidido não levar as crianças naquela viagem; se tivesse recusado quando elas pediram para usar a canoa; se tivesse ido embora na véspera; se, se, se.	si 'e.li Ti'vE.si de.si'Di.du 'na~w~ le'var as kri'a~.sas na'kE.la vi'a.Ze~j~, si Ti'vE.si Re.ku'za.du 'kwa~.du 'E.las pe'Di.ra~w~ 'pa.ra u'zar a ka~'no.a, si Ti'vE.si 'i.du e~'bO.ra na 'vEs.pe.ra, si, si, si
Não ter podido enterrar o corpo de Missy ampliava seu fracasso como pai.	'na~w~ 'teX po'Di.du e~.te'Rar u 'koX.pu Di 'mi.si a~.pli'a.va 'sew fra'ka.su 'ko~.mu 'paj
O fato de ela ainda estar em algum lugar, sozinha na floresta, assombrava-o todos os dias.	u 'fa.tu Di 'E.la a'i~.da es'tar e~j~ aw'gu~ lu'gaX, sO'zi~.Ja na flo'rEs.ta, a.so~'bra.va u 'to.duz us 'Di.as
Agora, três anos e meio depois, Missy era considerada oficialmente vítima de assassinato.	a'gO.ra, 'trejz 'a~.nuz i 'mej.u de'pojs, 'mi.si 'E.ra ko~.si.de'ra.da o.fi.si.aw'me~.Ti 'vi.Ti~.ma Di a.sa.si~'na.tu
A vida nunca mais seria a mesma.	a 'vi.da 'nu~.ka 'majs se'ri.a a 'mez.ma
A ausência de Missy criava um vazio absurdo.	a aw'ze~.sja Di 'mi.si kri'a.va u~ va'zi.u ab'suR.du
A tragédia também havia aumentado a fenda no relacionamento de Mack com Deus, mas ele não se dava conta dessa separação crescente.	a tra'ZE.Dja ta~'be~j~ a'vi.a aw~.me~'ta.du a 'fe~.da nu Re.la.si.o~.na~'me~.tu Di 'mE.ki ko~ 'dews, majz 'e.li 'na~w~ si 'da.va 'ko~.ta 'dE.sa se.pa.ra'sa~w~ kre'se~.Ti
Assim, receber o bilhete assinado Papai, dizendo para encontrá-lo na cabana, causou-lhe um profundo impacto.	a'si~, Re.se'ber u bi'Le.Ti a.si~'na.du pa'paj, Di'ze~.du 'pa.ra e~.ko~'tra lu na ka'ba~.na, kaw'zow Li u~ pro'fu~.du i~'pak.tu
Será que Deus escreve bilhetes?	se'ra ki 'dewz es'krE.vi bi'Le.Tis
E por que na cabana, o ícone de sua dor mais profunda?	i puX 'ke na ka'ba~.na, u 'i.ko~.ni Di 'su.a 'doR 'majs pro'fu~.da
Certamente Deus teria lugares melhores onde se encontrar com ele.	sEX.ta~'me~.Ti 'dews te'ri.a lu'ga.ris me'LO.riz 'o~.Di si e~.ko~'traX ko~ 'e.li
Um pensamento sombrio chegou a atravessar sua mente: o assassino o estaria provocando ou o atraindo para longe com a intenção de deixar sua família desprotegida.	u~ pe~.sa~'me~.tu so~'bri.u Se'gow a a.tra.ve'saX 'su.a 'me~.Ti, u a.sa'si~.nu u es.ta'ri.a pro.vo'ka~.du ow u a.tra'i~.du 'pa.ra 'lo~.Zi ko~ a i~.te~'sa~w~ Di dej'SaX 'su.a fa~'mi.lja des.pro.te'Zi.da
Talvez fosse somente uma brincadeira cruel.	taw'vejs 'fo.si sO~'me~.Ti u~.ma bri~.ka'dej.ra kru'Ew
Mas por que estava assinado Papai?	majs puX 'ke es'ta.va a.si~'na.du pa'paj
Por mais irracional que parecesse, Mack não conseguia deixar de pensar que talvez o bilhete viesse mesmo de Deus.	puR 'majz i.Ra.si.o~'naw ki pa.re'se.si, 'mE.ki 'na~w~ ko~.se'gi.a dej'SaR Di pe~'saX ki taw'vejz u bi'Le.Ti vi'E.si 'mez.mu Di 'dews
Quanto mais pensava, mais confuso e irritado ia ficando.	'kwa~.tu 'majs pe~'sa.va, 'majs ko~'fu.zu i i.Ri'ta.du 'i.a fi'ka~.du
Quem havia mandado a porcaria do bilhete?	'ke~j~ a'vi.a ma~'da.du a poX.ka'ri.a du bi'Le.Ti
Fosse quem fosse, Mack tinha a sensação de que estavam brincando com ele.	'fo.si 'ke~j~ 'fo.si, 'mE.ki 'Ti~.Ja a se~.sa'sa~w~ Di ki es'ta.va~w~ bri~'ka~.du ko~ 'e.li
E, de qualquer modo, de que adiantava?	i, Di kwaw'kER 'mO.du, Di ki a.Di.a~'ta.va
Mas, apesar da raiva e da depressão, Mack sabia que precisava de respostas.	majs, a.pe'zaR da 'Raj.va i da de.pre'sa~w~, 'mE.ki sa'bi.a ki pre.si'za.va Di Res'pOs.tas
Percebeu que estava travado e que as orações e os hinos dos domingos não serviam mais, se é que já haviam servido.	peX.se'bew ki es'ta.va tra'va.du i ki az o.ra'so~j~z i uz 'i~.nus dus do~'mi~.gus 'na~w~ seR'vi.a~w~ 'majs, si E ki 'Za a'vi.a~w~ seR'vi.du
A espiritualidade do claustro não parecia mudar nada na vida das pessoas que ele conhecia, a não ser, talvez, na de Nan.	a es.pi.ri.tu.a.li'da.Di du 'klaws.tru 'na~w~ pa.re'si.a mu'daR 'na.da na 'vi.da das pe'so.as ki 'e.li ko~.Je'si.a, a 'na~w~ 'seX, taw'vejs, na Di 'na~
Mas ela era especial.	majz 'E.la 'E.ra es.pe.si'aw
Mack estava farto de Deus e da religião, farto de todos os pequenos clubes sociais religiosos que não pareciam fazer nenhuma diferença expressiva nem provocar qualquer mudança real.	'mE.ki es'ta.va 'faX.tu Di 'dewz i da Re.li.Zi'a~w~, 'faX.tu Di 'to.duz us pe'ke~.nus 'klu.bis so.si'ajs Re.li.Zi'O.zus ki 'na~w~ pa.re'si.a~w~ fa'zeR ne~'Ju~.ma Di.fe're~.sa es.pre'si.va ne~j~ pro.vo'kaX kwaw'kER mu'da~.sa Re'aw
Mack certamente desejava mais.	'mE.ki sEX.ta~'me~.Ti de.ze'Za.va 'majs
Porém não sabia que estava a ponto de conseguir muito mais do que havia pedido.	po're~j~ 'na~w~ sa'bi.a ki es'ta.va a 'po~.tu Di ko~.se'giR 'mu~j~.tu 'majs du ki a'vi.a pe'Di.du
Rotineiramente desqualificamos testemunhos e exigimos comprovação.	Ro.Ti~.nej.ra~'me~.Ti des.kwa.li.fi'ka~.mus tes.te~'mu~.Juz i e.zi'Zi~.mus ko~.pro.va'sa~w~
Isto é, estamos convencidos da justeza de nosso julgamento que invalidamos provas que não se ajustem a ele.	'is.tu E, es'ta~.mus ko~.ve~'si.dus da Zus'te.za Di 'nO.su Zuw.ga~'me~.tu ki i~.va.li'da~.mus 'prO.vas ki 'na~w~ si a'Zus.te~j~ a 'e.li
Nada que mereça ser chamado de verdade pode ser alcançado por esses meios.	'na.da ki me're.sa 'seX Sa~'ma.du Di veR'da.Di 'pO.Di 'ser aw.ka~'sa.du pur 'e.sis 'mej.us
Há ocasiões em que optamos por acreditar em algo que normalmente seria considerado absolutamente irracional.	'a o.ka.zi'o~j~z e~j~ ki op'ta~.mus pur a.kre.Di'tar e~j~ 'aw.gu ki noR.maw'me~.Ti se'ri.a ko~.si.de'ra.du ab.so.lu.ta~'me~.Ti i.Ra.si.o~'naw
Isso não significa que seja mesmo irracional, mas certamente não é racional.	'i.su 'na~w~ si.gi~.ni'fi.ka ki 'se.Za 'mez.mu i.Ra.si.o~'naw, majs sEX.ta~'me~.Ti 'na~w~ E Ra.si.o~'naw
Talvez exista a supra-racionalidade: a razão além das definições normais dos fatos ou da lógica baseada em dados.	taw'vejz e'zis.ta a 'su.pra Ra.si.o~.na.li'da.Di, a Ra'za~w~ a'le~j~ das de.fi~.ni'so~j~s noR'majs dus 'fa.tuz ow da 'lO.Zi.ka ba.ze'a.da e~j~ 'da.dus
Talvez seja aí que a fé se encaixe.	taw'vejs 'se.Za a'i ki a 'fE si e~'kaj.Si
Mack não tinha certeza de um monte de coisas, mas em algum momento em seu coração e em sua mente, nos dias que se seguiram à nevasca, ele se convenceu de que havia três explicações plausíveis para o bilhete.	'mE.ki 'na~w~ 'Ti~.Ja seX'te.za Di u~ 'mo~.Ti Di 'koj.zas, majz e~j~ aw'gu~ mo~'me~.tu e~j~ 'sew ko.ra'sa~w~ i e~j~ 'su.a 'me~.Ti, nus 'Di.as ki si se'gi.ra~w~ a ne'vas.ka, 'e.li si ko~.ve~'sew Di ki a'vi.a 'trejz es.pli.ka'so~j~s plaw'zi.vejs 'pa.ra u bi'Le.Ti
Podia ser de Deus, por mais absurdo que isso parecesse, podia ser uma piada cruel ou algo mais sinistro vindo do assassino de Missy.	po'Di.a 'seR Di 'dews, puR 'majz ab'suR.du ki 'i.su pa.re'se.si, po'Di.a 'ser u~.ma pi'a.da kru'Ew ow 'aw.gu 'majs si~'nis.tru 'vi~.du du a.sa'si~.nu Di 'mi.si
Independentemente de qualquer coisa, o bilhete dominava seus pensamentos dia e noite.	i~.de.pe~.de~.Ti~'me~.Ti Di kwaw'kEX 'koj.za, u bi'Le.Ti do~.mi~'na.va 'sews pe~.sa~'me~.tus 'Di.a i 'noj.Ti
A princípio não falou com ninguém, nem mesmo com Nan, achando que uma conversa assim só traria mais dor.	a pri~'si.pju 'na~w~ fa'low ko~ ni~'ge~j~, ne~j~ 'mez.mu ko~ 'na~, a'Sa~.du ki u~.ma ko~'vEX.sa a'si~ 'sO tra'ri.a 'majs 'doX
Estou mantendo segredo por causa de Nan, dizia a si mesmo.	es'tow ma~'te~.du se'gre.du puX 'kaw.za Di 'na~, Di'zi.a a 'si 'mez.mu
Além disso, falar do bilhete seria admitir que guardara segredos.	a'le~j~ 'Di.su, fa'laR du bi'Le.Ti se'ri.a a.Di~.mi'TiX ki gwaR'da.ra se'gre.dus
Algumas vezes a honestidade pode ser incrivelmente complicada.	aw'gu~.mas 've.ziz a o~.nes.Ti'da.Di 'pO.Di 'ser i~.kri.vew'me~.Ti ko~.pli'ka.da
Decidido a empreender a viagem, Mack começou a pensar em modos de afastar a família de casa durante o fim de semana sem levantar suspeitas.	de.si'Di.du a e~.pre.e~'der a vi'a.Ze~j~, 'mE.ki ko~.me'sow a pe~'sar e~j~ 'mO.dus Di a.fas'tar a fa~'mi.lja Di 'ka.za du'ra~.Ti u 'fi~ Di se~'ma~.na se~j~ le.va~'taX sus'pej.tas
Felizmente foi a própria Nan quem ofereceu a solução.	fe.liz'me~.Ti 'foj a 'prO.prja 'na~ 'ke~j~ o.fe.re'sew a so.lu'sa~w~
Ela estivera pensando em visitar a família da irmã nas ilhas San Juan, no litoral de Washington.	'E.la es.Ti'vE.ra pe~'sa~.du e~j~ vi.zi'tar a fa~'mi.lja da iR'ma~ naz 'i.Las 'sa~ Zu'a~, nu li.to'raw Di 'wa.Si~.to~
Seu cunhado era psicólogo infantil e Nan achava que poderia ser útil conversar com ele sobre o comportamento cada vez mais fechado de Kate.	'sew ku~'Ja.du 'E.ra psi'kO.lo.gu i~.fa~'Tiw i 'na~ a'Sa.va ki po.de'ri.a 'ser 'u.Tiw ko~.veX'saX ko~ 'e.li 'so.bri u ko~.poX.ta~'me~.tu 'ka.da 'vejz 'majs fe'Sa.du Di 'kej.Ti
Quando ela levantou a possibilidade da viagem, Mack reagiu quase ansioso demais.	'kwa~.du 'E.la le.va~'tow a po.si.bi.li'da.Di da vi'a.Ze~j~, 'mE.ki Re.a'Ziw 'kwa.zi a~.si'o.zu de~'majs
Claro que vocês vão, ele afirmou imediatamente.	'kla.ru ki vo'sejs 'va~w~, 'e.li a.fiR'mow i~.me.Di.a.ta~'me~.Ti
Não era a resposta que ela havia previsto e Nan lhe lançou um olhar interrogativo.	'na~w~ 'E.ra a Res'pOs.ta ki 'E.la a'vi.a pre'vis.tu i 'na~ Li la~'sow u~ o'Lar i~.te.Ro.ga'Ti.vu
Quero dizer, consertou ele, sem jeito, é uma idéia fantástica.	'kE.ru Di'zeX, ko~.seX'tow 'e.li, se~j~ 'Zej.tu, E u~.ma i'dEj.a fa~'tas.Ti.ka
Vou sentir falta de vocês, claro, mas acho que posso sobreviver sozinho uns dois dias e, de qualquer modo, tenho um monte de coisas para fazer.	'vow se~'TiX 'faw.ta Di vo'sejs, 'kla.ru, majz 'a.Su ki 'pO.su so.bre.vi'veX sO'zi~.Ju u~s 'dojs 'Di.az i, Di kwaw'kER 'mO.du, 'te~.Ju u~ 'mo~.Ti Di 'koj.zas 'pa.ra fa'zeX
Ela deu de ombros, talvez grata porque o caminho para a viagem tivesse se aberto com tanta facilidade.	'E.la 'dew Di 'o~.brus, taw'vejz 'gra.ta puX'ke u ka~'mi~.Ju 'pa.ra a vi'a.Ze~j~ Ti'vE.si si a'bEX.tu ko~ 'ta~.ta fa.si.li'da.Di
Bastou um rápido telefonema à irmã de Nan e a viagem foi acertada.	bas'tow u~ 'Ra.pi.du te.le.fo~'ne~.ma a iR'ma~ Di 'na~ i a vi'a.Ze~j~ 'foj a.seX'ta.da
Logo a casa virou um turbilhão de atividades.	'lO.gu a 'ka.za vi'row u~ tuR.bi'La~w~ Di a.Ti.vi'da.Dis
Josh e Kate ficaram deliciados com a perspectiva de visitar os primos e compraram fácil a idéia.	'ZOS i 'kej.Ti fi'ka.ra~w~ de.li.si'a.dus ko~ a peXs.pek'Ti.va Di vi.zi'tar us 'pri~.muz i ko~'pra.ra~w~ 'fa.siw a i'dEj.a
Disfarçadamente, Mack telefonou para seu amigo Willie pedindo seu jipe emprestado.	Dis.faX.sa.da~'me~.Ti, 'mE.ki te.le.fo~'now 'pa.ra 'sew a~'mi.gu 'wi.li pe'Di~.du 'sew 'Zi.pi e~.pres'ta.du
O pedido estranho, como era de se prever, provocou um tiroteio de perguntas que Mack tentou responder do modo mais evasivo possível.	u pe'Di.du es'tra~.Ju, 'ko~.mu 'E.ra Di si pre'veX, pro.vo'kow u~ Ti.ro'tej.u Di peR'gu~.tas ki 'mE.ki te~'tow Res.po~'deR du 'mO.du 'majz e.va'zi.vu po'si.vew
Terminou dizendo que explicaria tudo quando Willie aparecesse para trocar os veículos.	teR.mi~'now Di'ze~.du ki es.pli.ka'ri.a 'tu.du 'kwa~.du 'wi.li a.pa.re'se.si 'pa.ra tro'kar us ve'i.ku.lus
No fim da tarde de quinta-feira, depois de despedir-se de Nan, Kate e Josh, Mack começou a se preparar para a longa viagem ao Nordeste do Oregon, o local de seus pesadelos.	nu 'fi~ da 'taR.Di Di 'ki~.ta 'fej.ra, de'pojs Di des.pe'DiX si Di 'na~, 'kej.Ti i 'ZOS, 'mE.ki ko~.me'sow a si pre.pa'raX 'pa.ra a 'lo~.ga vi'a.Ze~j~ aw noR'dEs.Ti du 'O.re.go~, u lo'kaw Di 'sews pe.za'de.lus
Sem dúvida havia a possibilidade de ter se transformado num idiota completo ou de estar sendo vítima de uma brincadeira de mau gosto, mas nesse caso ficaria livre para simplesmente ir embora.	se~j~ 'du.vi.da a'vi.a a po.si.bi.li'da.Di Di 'teX si tra~s.foR'ma.du nu~ i.Di'O.ta ko~'plE.tu ow Di es'taX 'se~.du 'vi.Ti~.ma Di u~.ma bri~.ka'dej.ra Di 'maw 'gos.tu, majs 'ne.si 'ka.zu fi.ka'ri.a 'li.vri 'pa.ra si~.pliz'me~.Ti 'ir e~'bO.ra
Uma batida na porta arrancou-o de sua concentração e ele viu que era Willie.	u~.ma ba'Ti.da na 'pOX.ta a.Ra~'kow u Di 'su.a ko~.se~.tra'sa~w~ i 'e.li 'viw ki 'E.ra 'wi.li
Estou aqui na cozinha! gritou.	es'tow a'ki na ko'zi~.Ja, gri'tow
Um instante depois Willie apontou a cabeça pela porta do corredor.	u~ i~s'ta~.Ti de'pojs 'wi.li a.po~'tow a ka'be.sa 'pe.la 'pOX.ta du ko.Re'doX
Mack continuou enfiando coisas em dois sacos de viagem.	'mE.ki ko~.Ti~.nu'ow e~.fi'a~.du 'koj.zaz e~j~ 'dojs 'sa.kus Di vi'a.Ze~j~
Sabia que não adiantava mentir para o amigo.	sa'bi.a ki 'na~w~ a.Di.a~'ta.va me~'TiX 'pa.ra u a~'mi.gu
Vou voltar à cabana, Willie.	'vow vow'tar a ka'ba~.na, 'wi.li
Bom, eu já tinha imaginado.	'bo~, ew 'Za 'Ti~.Ja i~.ma.Zi~'na.du
O que quero saber é por que você pretende voltar lá.	u ki 'kE.ru sa'ber E puX 'ke vo'se pre'te~.Di vow'taR 'la
Não sei se o meu velho jipe vai dar conta do recado, mas, como garantia, coloquei umas correntes atrás para o caso de precisarmos.	'na~w~ 'sej si u 'mew 'vE.Lu 'Zi.pi 'vaj 'daX 'ko~.ta du Re'ka.du, majs, 'ko~.mu ga.ra~'Ti.a, ko.lo'kej u~.mas ko'Re~.Tiz a'trajs 'pa.ra u 'ka.zu Di pre.si'zaR.mus
Voltando à cozinha, entregou-o ao amigo.	vow'ta~.du a ko'zi~.Ja, e~.tre'gow u aw a~'mi.gu
Willie desdobrou o papel e leu em silêncio.	'wi.li dez.do'brow u pa'pEw i 'lew e~j~ si'le~.sju
Nossa, que tipo de maluco escreveria uma coisa assim?	'nO.sa, ki 'Ti.pu Di ma'lu.ku es.kre.ve'ri.a u~.ma 'koj.za a'si~
E quem é esse tal de Papai?	i 'ke~j~ E 'e.si 'taw Di pa'paj
Bom, você sabe, Papai é o nome que Nan usa para Deus.	'bo~, vo'se 'sa.bi, pa'paj E u 'no~.mi ki 'na~ 'u.za 'pa.ra 'dews
Mack pegou o bilhete de volta e o enfiou no bolso da camisa.	'mE.ki pe'gow u bi'Le.Ti Di 'vOw.ta i u e~.fi'ow nu 'bow.su da ka~'mi.za
Espera, você está achando mesmo que isso veio de Deus?	es'pE.ra, vo'se es'ta a'Sa~.du 'mez.mu ki 'i.su 'vej.u Di 'dews
Willie, não sei o que pensar disso.	'wi.li, 'na~w~ 'sej u ki pe~'saR 'Di.su
Quer dizer, a princípio achei que era apenas uma brincadeira de mau gosto e fiquei com raiva.	'kER Di'zeX, a pri~'si.pju a'Sej ki 'E.ra a'pe~.naz u~.ma bri~.ka'dej.ra Di 'maw 'gos.tu i fi'kej ko~ 'Raj.va
Sei que parece loucura, mas de algum modo me sinto estranhamente tentado a descobrir.	'sej ki pa'rE.si low'ku.ra, majs Di aw'gu~ 'mO.du mi 'si~.tu es.tra~.Ja~'me~.Ti te~'ta.du a des.ko'briX
Tenho de ir, Willie, ou isso vai me deixar maluco para sempre.	'te~.Ju Di 'iX, 'wi.li, ow 'i.su 'vaj mi dej'SaR ma'lu.ku 'pa.ra 'se~.pri
Já pensou na possibilidade de ser o assassino?	'Za pe~'sow na po.si.bi.li'da.Di Di 'ser u a.sa'si~.nu
E se ele estiver atraindo você para lá por algum motivo?	i si 'e.li es.Ti'vEr a.tra'i~.du vo'se 'pa.ra 'la pur aw'gu~ mo'Ti.vu
Claro que pensei.	'kla.ru ki pe~'sej
Parte de mim não ficaria desapontada com isso.	'paX.Ti Di 'mi~ 'na~w~ fi.ka'ri.a de.za.po~'ta.da ko~ 'i.su
Tenho contas a acertar com ele, disse sério e fez uma pausa.	'te~.Ju 'ko~.taz a a.seX'taX ko~ 'e.li, 'Di.si 'sE.rju i 'fejz u~.ma 'paw.za
Mas também não faz muito sentido.	majs ta~'be~j~ 'na~w~ 'fajz 'mu~j~.tu se~'Ti.du
Não acho que o assassino saiba que Papai é um termo usado em nossa família.	'na~w~ 'a.Su ki u a.sa'si~.nu 'saj.ba ki pa'paj E u~ 'teR.mu u'za.du e~j~ 'nO.sa fa~'mi.lja
Willie ficou perplexo e Mack prosseguiu: E nenhum amigo nosso mandaria um bilhete desses.	'wi.li fi'kow peX'plEk.su i 'mE.ki pro.se'giw, i ne~'Ju~ a~'mi.gu 'nO.su ma~.da'ri.a u~ bi'Le.Ti 'de.sis
Mas Deus não faz coisas assim.	majs 'dews 'na~w~ 'fajs 'koj.zaz a'si~
Pelo menos nunca ouvi falar que ele tivesse mandado um bilhete a alguém.	'pe.lu 'me~.nus 'nu~.ka ow'vi fa'laX ki 'e.li Ti'vE.si ma~'da.du u~ bi'Le.Ti a aw'ge~j~
E por que ele desejaria que você retornasse à cabana?	i puX 'ke 'e.li de.ze.Za'ri.a ki vo'se Re.toR'na.si a ka'ba~.na
Não consigo pensar num lugar pior...	'na~w~ ko~'si.gu pe~'saR nu~ lu'gaX pi'OX
Pairou um silêncio incômodo entre os dois.	paj'row u~ si'le~.sju i~'ko~.mo.du 'e~.tri us 'dojs
Mack falou: Não sei, Willie.	'mE.ki fa'low, 'na~w~ 'sej, 'wi.li
Acho que parte de mim gostaria de acreditar que Deus se importa o suficiente comigo pra me mandar um bilhete.	'a.Su ki 'paX.Ti Di 'mi~ gos.ta'ri.a Di a.kre.Di'taX ki 'dews si i~'pOX.ta u su.fi.si'e~.Ti ko~'mi.gu pra mi ma~'dar u~ bi'Le.Ti
Continuo muito confuso, mesmo depois de tanto tempo.	ko~.Ti~'nu.u 'mu~j~.tu ko~'fu.zu, 'mez.mu de'pojs Di 'ta~.tu 'te~.pu
Simplesmente não sei o que pensar, e a coisa não melhora.	si~.pliz'me~.Ti 'na~w~ 'sej u ki pe~'saX, i a 'koj.za 'na~w~ me'LO.ra
Sinto que estou perdendo Kate e isso me mata.	'si~.tu ki es'tow peR'de~.du 'kej.Ti i 'i.su mi 'ma.ta
Talvez o que aconteceu com Missy seja uma espécie de castigo de Deus pelo que fiz com meu pai.	taw'vejz u ki a.ko~.te'sew ko~ 'mi.si 'se.Za u~.ma es'pE.si Di kas'Ti.gu Di 'dews 'pe.lu ki 'fis ko~ 'mew 'paj
Realmente não sei.	Re.aw'me~.Ti 'na~w~ 'sej
Mack olhou o rosto de seu melhor amigo, considerado mais do que um irmão.	'mE.ki o'Low u 'Ros.tu Di 'sew me'LOr a~'mi.gu, ko~.si.de'ra.du 'majs du ki u~ iR'ma~w~
Então, quando partimos?	e~'ta~w~, 'kwa~.du paX'Ti~.mus
Mack ficou tocado com a disposição do amigo.	'mE.ki fi'kow to'ka.du ko~ a Dis.po.zi'sa~w~ du a~'mi.gu
Obrigado, meu chapa, mas realmente preciso fazer isso sozinho.	o.bri'ga.du, 'mew 'Sa.pa, majs Re.aw'me~.Ti pre'si.zu fa'zer 'i.su sO'zi~.Ju
Imaginei que você diria isso, respondeu Willie, virando-se e saindo do cômodo.	i~.ma.Zi~'nej ki vo'se Di'ri.a 'i.su, Res.po~'dew 'wi.li, vi'ra~.du si i sa'i~.du du 'ko~.mo.du
Retornou alguns instantes depois com uma pistola e uma caixa de balas.	Re.toR'now aw'gu~z i~s'ta~.Tis de'pojs ko~ u~.ma pis'tO.la i u~.ma 'kaj.Sa Di 'ba.las
Achei que não conseguiria convencê-lo a deixar de ir e pensei que poderia precisar disso.	a'Sej ki 'na~w~ ko~.se.gi'ri.a ko~.ve~'se lu a dej'SaR Di 'ir i pe~'sej ki po.de'ri.a pre.si'zaR 'Di.su
Acho que você sabe usar.	'a.Su ki vo'se 'sa.bi u'zaX
Mack olhou a arma.	'mE.ki o'Low a 'aR.ma
Sabia que Willie estava tentando ajudá-lo.	sa'bi.a ki 'wi.li es'ta.va te~'ta~.du a.Zu'da lu
Willie, não posso.	'wi.li, 'na~w~ 'pO.su
Faz 30 anos que toquei pela última vez numa arma e não pretendo fazer isso agora.	'fajs 'tri~.ta 'a~.nus ki to'kej 'pe.la 'uw.Ti~.ma 'vejz 'nu~.ma 'aR.ma i 'na~w~ pre'te~.du fa'zer 'i.su a'gO.ra
Se aprendi uma coisa na vida, foi que usar a violência para resolver um problema sempre cria um problema ainda maior.	si a.pre~'Di u~.ma 'koj.za na 'vi.da, 'foj ki u'zar a vi.o'le~.sja 'pa.ra Re.zow'ver u~ pro'ble~.ma 'se~.pri 'kri.a u~ pro'ble~.ma a'i~.da maj'OX
Mas e se for o assassino de Missy?	majz i si 'for u a.sa'si~.nu Di 'mi.si
E se ele estiver esperando lá em cima? O que você vai fazer?	i si 'e.li es.Ti'vEr es.pe'ra~.du 'la e~j~ 'si~.ma, u ki vo'se 'vaj fa'zeX
Mack deu de ombros.	'mE.ki 'dew Di 'o~.brus
Honestamente não sei, Willie.	o~.nEs.ta~'me~.Ti 'na~w~ 'sej, 'wi.li
Vou correr o risco, acho.	'vow ko'Rer u 'Ris.ku, 'a.Su
Mas você vai estar indefeso.	majs vo'se 'vaj es'tar i~.de'fe.zu
Não dá para saber o que ele tem em mente.	'na~w~ 'da 'pa.ra sa'ber u ki 'e.li te~j~ e~j~ 'me~.Ti
Leve, Mack.	'lE.vi, 'mE.ki
Willie empurrou a pistola e as balas na direção dele.	'wi.li e~.pu'Row a pis'tO.la i as 'ba.las na Di.re'sa~w~ 'de.li
Você não precisa usar.	vo'se 'na~w~ pre'si.za u'zaX
Mack olhou a arma e depois de pensar um pouco estendeu lentamente a mão para ela e as balas, colocando-as com cuidado no bolso.	'mE.ki o'Low a 'aR.ma i de'pojs Di pe~'sar u~ 'pow.ku es.te~'dew le~.ta~'me~.Ti a 'ma~w~ 'pa.ra 'E.la i as 'ba.las, ko.lo'ka~.du as ko~ kuj'da.du nu 'bow.su
Certo, só para garantir.	'sEX.tu, 'sO 'pa.ra ga.ra~'TiX
Em seguida pegou parte do equipamento e, com os braços carregados, saiu na direção do jipe.	e~j~ se'gi.da pe'gow 'paX.Ti du e.ki.pa~'me~.tu i, ko~ us 'bra.sus ka.Re'ga.dus, sa'iw na Di.re'sa~w~ du 'Zi.pi
Willie levou a grande sacola de lona que restava.	'wi.li le'vow a 'gra~.Di sa'kO.la Di 'lo~.na ki Res'ta.va
Nossa, Mack, se você acha que Deus vai estar lá em cima, para quê tudo isso?	'nO.sa, 'mE.ki, si vo'se 'a.Sa ki 'dews 'vaj es'taR 'la e~j~ 'si~.ma, 'pa.ra 'ke 'tu.du 'i.su
Mack lhe deu um sorriso carregado de tristeza.	'mE.ki Li 'dew u~ so'Ri.zu ka.Re'ga.du Di tris'te.za
Só pensei em cobrir as várias opções.	'sO pe~'sej e~j~ ko'brir as 'va.rjaz op'so~j~s
Você sabe, estar preparado para o que acontecer...	vo'se 'sa.bi, es'taX pre.pa'ra.du 'pa.ra u ki a.ko~.te'seX
Quando chegaram no jipe, Willie entregou as chaves a Mack.	'kwa~.du Se'ga.ra~w~ nu 'Zi.pi, 'wi.li e~.tre'gow as 'Sa.viz a 'mE.ki
E o que é que Nan acha disso? perguntou.	i u ki E ki 'na~ 'a.Sa 'Di.su, peR.gu~'tow
Nan e as crianças foram visitar a irmã dela e, eu não contei, confessou Mack.	'na~ i as kri'a~.sas 'fo.ra~w~ vi.zi'tar a iR'ma~ 'dE.la i, ew 'na~w~ ko~'tej, ko~.fe'sow 'mE.ki
Willie ficou obviamente surpreso.	'wi.li fi'kow Ob.vi.a~'me~.Ti suX'pre.zu
O quê!?	u 'ke
Você nunca guarda segredos de sua mulher.	vo'se 'nu~.ka 'gwaR.da se'gre.dus Di 'su.a mu'LEX
Não acredito que tenha mentido para ela!	'na~w~ a.kre'Di.tu ki 'te~.Ja me~'Ti.du 'pa.ra 'E.la
Mack ignorou a explosão do amigo, voltou à casa e entrou no escritório.	'mE.ki i.gi~.no'row a es.plo'za~w~ du a~'mi.gu, vow'tow a 'ka.za i e~'trow nu es.kri'tO.rju
Ali encontrou as chaves de reserva de seu carro e da casa e, hesitando apenas um instante, pegou a pequena lata.	a'li e~.ko~'trow as 'Sa.vis Di Re'zER.va Di 'sew 'ka.Ru i da 'ka.za i, e.zi'ta~.du a'pe~.naz u~ i~s'ta~.Ti, pe'gow a pe'ke~.na 'la.ta
Willie foi atrás dele.	'wi.li 'foj a'trajs 'de.li
Como você acha que ele é? perguntou rindo.	'ko~.mu vo'se 'a.Sa ki 'e.li E, peR.gu~'tow 'Ri~.du
Deus, claro.	'dews, 'kla.ru
Como você acha que ele é?	'ko~.mu vo'se 'a.Sa ki 'e.li E
Mack pensou um instante.	'mE.ki pe~'sow u~ i~s'ta~.Ti
Não sei.	'na~w~ 'sej
Talvez ele tenha uma luz muito forte ou apareça no meio de uma sarça ardente.	taw'vejz 'e.li 'te~.Ja u~.ma 'lujz 'mu~j~.tu 'fOX.Ti ow a.pa're.sa nu 'mej.u Di u~.ma 'saX.sa aR'de~.Ti
Sempre o visualizei assim como um avô, com uma barba longa flutuando.	'se~.pri u vi.zu.a.li'zej a'si~ 'ko~.mu u~ a'vo, ko~ u~.ma 'baR.ba 'lo~.ga flu.tu'a~.du
Deu de ombros, entregou as chaves de seu carro a Willie e os dois trocaram um abraço rápido.	'dew Di 'o~.brus, e~.tre'gow as 'Sa.vis Di 'sew 'ka.Ru a 'wi.li i us 'dojs tro'ka.ra~w~ u~ a'bra.su 'Ra.pi.du
Bom, se ele aparecer, dê lembranças minhas, disse Willie com um sorriso afetuoso.	'bo~, si 'e.li a.pa.re'seX, 'de le~'bra~.sas 'mi~.Jas, 'Di.si 'wi.li ko~ u~ so'Ri.zu a.fe.tu'o.zu
Estou preocupado com você, meu chapa.	es'tow prew.ku'pa.du ko~ vo'se, 'mew 'Sa.pa
Gostaria de ir junto.	gos.ta'ri.a Di 'iR 'Zu~.tu
Vou fazer uma ou duas orações por você.	'vow fa'zer u~.ma ow 'du.az o.ra'so~j~s puR vo'se
Obrigado, Willie.	o.bri'ga.du, 'wi.li
Você é um amigo e tanto.	vo'se E u~ a~'mi.gu i 'ta~.tu
Acenou enquanto Willie dava marcha a ré pela entrada de veículos.	a.se~'now e~'kwa~.tu 'wi.li 'da.va 'maX.Sa a 'RE 'pe.la e~'tra.da Di ve'i.ku.lus
Mack sabia que ele manteria a promessa.	'mE.ki sa'bi.a ki 'e.li ma~.te'ri.a a pro~'mE.sa
Ficou olhando até Willie virar a esquina e sumir, depois tirou o bilhete do bolso da camisa, leu mais uma vez e colocou-o na lata, que depositou no banco do carona em meio a outros equipamentos.	fi'kow o'La~.du a'tE 'wi.li vi'rar a es'ki~.na i su~'miX, de'pojs Ti'row u bi'Le.Ti du 'bow.su da ka~'mi.za, 'lew 'majz u~.ma 'vejz i ko.lo'kow u na 'la.ta, ki de.po.zi'tow nu 'ba~.ku du ka'ro~.na e~j~ 'mej.u a 'ow.truz e.ki.pa~'me~.tus
Trancando as portas do jipe, voltou para casa e para uma noite sem sonhos.	tra~'ka~.du as 'pOX.tas du 'Zi.pi, vow'tow 'pa.ra 'ka.za i 'pa.ra u~.ma 'noj.Ti se~j~ 'so~.Jus
Nan havia telefonado na noite anterior dizendo que chegaram em segurança e que voltaria a ligar no domingo.	'na~ a'vi.a te.le.fo~'na.du na 'noj.Ti a~.te.ri'oR Di'ze~.du ki Se'ga.ra~w~ e~j~ se.gu'ra~.sa i ki vow.ta'ri.a a li'gaR nu do~'mi~.gu
Refez o mesmo caminho que haviam tomado três anos e meio antes, mas passou pela cachoeira Multnomah sem olhar.	Re'fejz u 'mez.mu ka~'mi~.Ju ki a'vi.a~w~ to~'ma.du 'trejz 'a~.nuz i 'mej.u 'a~.Tis, majs pa'sow 'pe.la ka.So'ej.ra muw.Ti~.no~'ma se~j~ o'LaX
No longo trecho subindo o desfiladeiro sentiu o pânico se esgueirando e invadindo sua consciência.	nu 'lo~.gu 'tre.Su su'bi~.du u des.fi.la'dej.ru se~'Tiw u 'pa~.ni.ku si ez.gej'ra~.du i i~.va'Di~.du 'su.a ko~.si'e~.sja
Tentara não pensar no que estava fazendo e simplesmente ir colocando um pé na frente do outro, mas os sentimentos e temores represados começaram a surgir.	te~'ta.ra 'na~w~ pe~'saR nu ki es'ta.va fa'ze~.du i si~.pliz'me~.Ti 'iX ko.lo'ka~.du 'u~ 'pE na 'fre~.Ti du 'ow.tru, majz us se~.Ti~'me~.tuz i te~'mo.ris Re.pre'za.dus ko~.me'sa.ra~w~ a suR'ZiX
Seus olhos ficaram sombrios e as mãos apertavam com força o volante enquanto ele lutava contra a tentação de voltar para casa.	'sewz 'O.Lus fi'ka.ra~w~ so~'bri.uz i as 'ma~w~z a.peX'ta.va~w~ ko~ 'foX.sa u vo'la~.Ti e~'kwa~.tu 'e.li lu'ta.va 'ko~.tra a te~.ta'sa~w~ Di vow'taX 'pa.ra 'ka.za
Sabia que estava indo direto para o centro de sua dor, o vórtice da Grande Tristeza que havia minado sua alegria de viver.	sa'bi.a ki es'ta.va 'i~.du Di'rE.tu 'pa.ra u 'se~.tru Di 'su.a 'doX, u 'vOX.Ti.si da 'gra~.Di tris'te.za ki a'vi.a mi~'na.du 'su.a a.le'gri.a Di vi'veX
Finalmente pegou a auto-estrada para Joseph.	fi~.naw'me~.Ti pe'gow a 'aw.tu es'tra.da 'pa.ra 'Zo.zef
Pensou em procurar Tommy, mas decidiu não fazer isso.	pe~'sow e~j~ pro.ku'raX 'to~.mi, majs de.si'Diw 'na~w~ fa'zer 'i.su
Quanto menos pessoas pensassem que ele era um lunático desvairado, melhor.	'kwa~.tu 'me~.nus pe'so.as pe~'sa.se~j~ ki 'e.li 'E.ra u~ lu~'na.Ti.ku dez.vaj'ra.du, me'LOX
O trânsito era tranquilo e as estradas estavam notavelmente limpas e secas para essa época do ano, mas parecia que quanto mais avançava mais lentamente viajava, como se de algum modo a cabana repelisse sua aproximação.	u 'tra~.zi.tu 'E.ra tra~'kwi.lu i az es'tra.daz es'ta.va~w~ no.ta.vew'me~.Ti 'li~.paz i 'se.kas 'pa.ra 'E.sa 'E.po.ka du 'a~.nu, majs pa.re'si.a ki 'kwa~.tu 'majz a.va~'sa.va 'majs le~.ta~'me~.Ti vi.a'Za.va, 'ko~.mu si Di aw'gu~ 'mO.du a ka'ba~.na Re.pe'li.si 'su.a a.pro.si~.ma'sa~w~
Era apenas o início da tarde quando Mack finalmente parou e estacionou no começo da trilha praticamente invisível.	'E.ra a'pe~.naz u i~'ni.sju da 'taR.Di 'kwa~.du 'mE.ki fi~.naw'me~.Ti pa'row i es.ta.si.o~'now nu ko~'me.su da 'tri.La pra.Ti.ka~'me~.Ti i~.vi'zi.vew
Ficou ali sentado por cerca de cinco minutos, repreendendo-se por ser tão idiota.	fi'kow a'li se~'ta.du puX 'seX.ka Di 'si~.ku mi~'nu.tus, Re.pre.e~'de~.du si puX 'seX 'ta~w~ i.Di'O.ta
Mas a compulsão interna de prosseguir era irresistível.	majz a ko~.puw'sa~w~ i~'tER.na Di pro.se'gir 'E.ra i.Re.zis'Ti.vew
Levantou-se, olhou o caminho e decidiu deixar tudo no carro e descer a pé o trecho de cerca de um quilômetro e meio até o lago.	le.va~'tow si, o'Low u ka~'mi~.Ju i de.si'Diw dej'SaX 'tu.du nu 'ka.Ru i de'ser a 'pE u 'tre.Su Di 'seX.ka Di 'u~ ki'lo~.me.tru i 'mej.u a'tE u 'la.gu
Pelo menos não teria de carregar nada morro acima quando retornasse para ir embora, o que esperava que acontecesse logo.	'pe.lu 'me~.nus 'na~w~ te'ri.a Di ka.Re'gaR 'na.da 'mo.Ru a'si~.ma 'kwa~.du Re.toR'na.si 'pa.ra 'ir e~'bO.ra, u ki es.pe'ra.va ki a.ko~.te'se.si 'lO.gu
Estava suficientemente frio para sua respiração pairar no ar em volta dele, e parecia que ia nevar.	es'ta.va su.fi.si.e~.Ti~'me~.Ti 'fri.u 'pa.ra 'su.a Res.pi.ra'sa~w~ paj'raR nu 'ar e~j~ 'vOw.ta 'de.li, i pa.re'si.a ki 'i.a ne'vaX
A dor que estivera crescendo no estômago finalmente o empurrou para o pânico.	a 'doX ki es.Ti'vE.ra kre'se~.du nu es'to~.ma.gu fi~.naw'me~.Ti u e~.pu'Row 'pa.ra u 'pa~.ni.ku
Depois de apenas cinco passos ele parou e teve ânsias de vômito tão fortes que o deixaram de joelhos.	de'pojs Di a'pe~.nas 'si~.ku 'pa.suz 'e.li pa'row i 'te.vi 'a~.sjas Di 'vo~.mi.tu 'ta~w~ 'fOX.Tis ki u dej'Sa.ra~w~ Di Zu'e.Lus
Por favor, me ajude! gemeu.	puX fa'voX, mi a'Zu.Di, Ze~'mew
Em seguida levantou-se com as pernas trêmulas e virou-se.	e~j~ se'gi.da le.va~'tow si ko~ as 'pER.nas 'tre~.mu.laz i vi'row si
Abriu a porta do carona e enfiou a mão, remexendo até sentir a pequena lata.	a'briw a 'pOX.ta du ka'ro~.na i e~.fi'ow a 'ma~w~, Re~.me'Se~.du a'tE se~'Tir a pe'ke~.na 'la.ta
Abriu a tampa e encontrou o que estava procurando: sua foto predileta de Missy, que tirou junto com o bilhete.	a'briw a 'ta~.pa i e~.ko~'trow u ki es'ta.va pro.ku'ra~.du, 'su.a 'fO.tu pre.Di'lE.ta Di 'mi.si, ki Ti'row 'Zu~.tu ko~ u bi'Le.Ti
Recolocou a tampa e deixou a lata no banco.	Re.ko.lo'kow a 'ta~.pa i dej'Sow a 'la.ta nu 'ba~.ku
Parou um momento olhando o porta-luvas.	pa'row u~ mo~'me~.tu o'La~.du u 'pOX.ta 'lu.vas
Por fim abriu-o e pegou a arma de Willie, verificando que estava carregada e com a trava de segurança acionada.	puX 'fi~ a'briw u i pe'gow a 'aR.ma Di 'wi.li, ve.ri.fi'ka~.du ki es'ta.va ka.Re'ga.da i ko~ a 'tra.va Di se.gu'ra~.sa a.si.o~'na.da
De pé, fechou a porta, enfiou a mão embaixo do casaco e pôs a arma no cinto, às costas.	Di 'pE, fe'Sow a 'pOX.ta, e~.fi'ow a 'ma~w~ e~'baj.Su du ka'za.ku i 'pojz a 'aR.ma nu 'si~.tu, as 'kOs.tas
Virou-se e encarou o caminho de novo, olhando uma última vez a foto de Missy antes de enfiá-la no bolso da camisa junto com o bilhete.	vi'row si i e~.ka'row u ka~'mi~.Ju Di 'no.vu, o'La~.du u~.ma 'uw.Ti~.ma 'vejz a 'fO.tu Di 'mi.si 'a~.Tis Di e~.fi'a la nu 'bow.su da ka~'mi.za 'Zu~.tu ko~ u bi'Le.Ti
Se o encontrassem morto, pelo menos saberiam qual tinha sido seu último pensamento.	si u e~.ko~'tra.se~j~ 'moX.tu, 'pe.lu 'me~.nus sa.be'ri.a~w~ 'kwaw 'Ti~.Ja 'si.du 'sew 'uw.Ti~.mu pe~.sa~'me~.tu
A trilha era traiçoeira; as pedras, geladas e escorregadias.	a 'tri.La 'E.ra traj.so'ej.ra, as 'pE.dras, Ze'la.daz i es.ko.Re.ga'Di.as
Cada passo exigia concentração enquanto ele descia para a floresta cada vez mais densa.	'ka.da 'pa.su e.zi'Zi.a ko~.se~.tra'sa~w~ e~'kwa~.tu 'e.li de'si.a 'pa.ra a flo'rEs.ta 'ka.da 'vejz 'majs 'de~.sa
O silêncio era fantasmagórico.	u si'le~.sju 'E.ra fa~.taz.ma'gO.ri.ku
Os únicos sons que podia ouvir eram os de seus passos esmagando a neve e o da sua respiração pesada.	uz 'u~.ni.kus 'so~s ki po'Di.a ow'vir 'E.ra~w~ us Di 'sews 'pa.suz ez.ma'ga~.du a 'nE.vi i u da 'su.a Res.pi.ra'sa~w~ pe'za.da
Mack começou a sentir que estava sendo observado e uma vez chegou a girar rapidamente para ver se havia alguém ali.	'mE.ki ko~.me'sow a se~'TiX ki es'ta.va 'se~.du ob.seR'va.du i u~.ma 'vej.Se'gow a Zi'ra.Ra.pi.da~'me~.Ti 'pa.ra 'veX si a'vi.a aw'ge~j~ a'li
Por mais que quisesse dar a volta e correr para o jipe, seus pés pareciam ter vontade própria, determinados a continuar pelo caminho e entrar mais fundo na floresta mal iluminada e cada vez mais fechada.	puR 'majs ki ki'zE.si 'dar a 'vOw.ta i ko'ReX 'pa.ra u 'Zi.pi, 'sews 'pEjs pa.re'si.a~w~ 'teR vo~'ta.Di 'prO.prja, de.teR.mi~'na.duz a ko~.Ti~.nu'aX 'pe.lu ka~'mi~.Ju i e~'traR 'majs 'fu~.du na flo'rEs.ta 'maw i.lu~.mi~'na.da i 'ka.da 'vejz 'majs fe'Sa.da
De repente algo se mexeu ali perto.	Di Re'pe~.Ti 'aw.gu si me'Sew a'li 'pEX.tu
Assustado, ele se imobilizou em silêncio e alerta.	a.sus'ta.du, 'e.li si i~.mo.bi.li'zow e~j~ si'le~.sju i a'lEX.ta
Com o coração martelando nos ouvidos e a boca subitamente seca, levou devagar a mão às costas e tirou a pistola do cinto.	ko~ u ko.ra'sa~w~ maX.te'la~.du nuz ow'vi.duz i a 'bo.ka su.bi.ta~'me~.Ti 'se.ka, le'vow de.va'gar a 'ma~w~ as 'kOs.taz i Ti'row a pis'tO.la du 'si~.tu
Depois de soltar a trava, olhou fixamente para o mato baixo e escuro, tentando ver ou ouvir algo que pudesse explicar o barulho e diminuir o jorro de adrenalina.	de'pojs Di sow'tar a 'tra.va, o'Low fik.sa~'me~.Ti 'pa.ra u 'ma.tu 'baj.Su i es'ku.ru, te~'ta~.du 'ver ow ow'vir 'aw.gu ki pu'dE.si es.pli'kar u ba'ru.Lu i Di~.mi~.nu'ir u 'Zo.Ru Di a.dre~.na'li~.na
Mas o que quer que tivesse se mexido havia parado agora.	majz u ki 'kEX ki Ti'vE.si si me'Si.du a'vi.a pa'ra.du a'gO.ra
Estaria esperando por ele?	es.ta'ri.a es.pe'ra~.du pur 'e.li
Só para garantir, ficou imóvel por alguns minutos antes de começar de novo a descer lentamente a trilha, tentando ser o mais silencioso possível.	'sO 'pa.ra ga.ra~'TiX, fi'kow i~'mO.vew pur aw'gu~s mi~'nu.tuz 'a~.Tis Di ko~.me'saR Di 'no.vu a de'seR le~.ta~'me~.Ti a 'tri.La, te~'ta~.du 'ser u 'majs si.le~.si'o.zu po'si.vew
A floresta parecia se fechar ao seu redor e ele começou a se perguntar seriamente se havia tomado o caminho errado.	a flo'rEs.ta pa.re'si.a si fe'Sar aw 'sew Re'dOr i 'e.li ko~.me'sow a si peR.gu~'taX sE.ri.a~'me~.Ti si a'vi.a to~'ma.du u ka~'mi~.Ju e'Ra.du
Com o canto do olho viu o movimento outra vez e se agachou instantaneamente, espiando entre os galhos baixos de uma árvore próxima.	ko~ u 'ka~.tu du 'o.Lu 'viw u mo.vi~'me~.tu 'ow.tra 'vejz i si a.ga'Sow i~s.ta~.ta~.ne.a~'me~.Ti, es.pi'a~.du 'e~.tri us 'ga.Lus 'baj.Sus Di u~.ma 'aR.vo.ri 'prO.si~.ma
Algo fantasmagórico, como uma sombra, entrou nos arbustos.	'aw.gu fa~.taz.ma'gO.ri.ku, 'ko~.mu u~.ma 'so~.bra, e~'trow nuz aR'bus.tus
Ou seria imaginação?	ow se'ri.a i~.ma.Zi~.na'sa~w~
Esperou de novo, sem mexer um músculo.	es.pe'row Di 'no.vu, se~j~ me'Ser u~ 'mus.ku.lu
Seria Deus?	se'ri.a 'dews
Talvez um animal.	taw'vejz u~ a~.ni~'maw
Então o pensamento que estivera evitando: E se for algo pior? E se ele tivesse sido atraído aqui para cima? Mas para quê?	e~'ta~w~ u pe~.sa~'me~.tu ki es.Ti'vE.ra e.vi'ta~.du, i si 'for 'aw.gu pi'OX, i si 'e.li Ti'vE.si 'si.du a.tra'i.du a'ki 'pa.ra 'si~.ma, majs 'pa.ra 'ke
Levantando-se devagar do esconderijo, com a arma ainda na mão, deu um passo adiante, e foi quando de repente o arbusto atrás dele pareceu explodir.	le.va~'ta~.du si de.va'gaR du es.ko~.de'ri.Zu, ko~ a 'aR.ma a'i~.da na 'ma~w~, 'dew u~ 'pa.su a.Di'a~.Ti, i 'foj 'kwa~.du Di Re'pe~.Ti u aR'bus.tu a'trajs 'de.li pa.re'sew es.plo'DiX
Mack girou, apavorado e pronto para lutar pela vida, mas, antes que pudesse apertar o gatilho, reconheceu um texugo correndo de volta pela trilha.	'mE.ki Zi'row, a.pa.vo'ra.du i 'pro~.tu 'pa.ra lu'taX 'pe.la 'vi.da, majs, 'a~.Tis ki pu'dE.si a.peX'tar u ga'Ti.Lu, Re.ko~.Je'sew u~ te'Su.gu ko'Re~.du Di 'vOw.ta 'pe.la 'tri.La
Exalou aos poucos o ar que estivera prendendo, baixou a arma e balançou a cabeça.	e.za'low aws 'pow.kuz u 'aX ki es.Ti'vE.ra pre~'de~.du, baj'Sow a 'aR.ma i ba.la~'sow a ka'be.sa
Mack, o corajoso, parecia um menino apavorado na floresta.	'mE.ki, u ko.ra'Zo.zu, pa.re'si.a u~ me~'ni~.nu a.pa.vo'ra.du na flo'rEs.ta
Depois de travar a arma de novo, guardou-a.	de'pojs Di tra'var a 'aR.ma Di 'no.vu, gwaR'dow a
Alguém poderia se machucar, pensou com um suspiro de alívio.	aw'ge~j~ po.de'ri.a si ma.Su'kaX, pe~'sow ko~ u~ sus'pi.ru Di a'li.vju
Respirando fundo outra vez e soltando o ar lentamente, acalmou-se.	Res.pi'ra~.du 'fu~.du 'ow.tra 'vejz i sow'ta~.du u 'aR le~.ta~'me~.Ti, a.kaw'mow si
Decidiu que estava farto de sentir medo e continuou a descer o caminho, tentando parecer mais confiante do que se sentia.	de.si'Diw ki es'ta.va 'faX.tu Di se~'TiR 'me.du i ko~.Ti~.nu'ow a de'ser u ka~'mi~.Ju, te~'ta~.du pa.re'seR 'majs ko~.fi'a~.Ti du ki si se~'Ti.a
Esperava não ter vindo tão longe à toa.	es.pe'ra.va 'na~w~ 'teR 'vi~.du 'ta~w~ 'lo~.Zi a 'to.a
Se Deus realmente aparecesse, Mack estava mais do que pronto para dizer-lhe umas tantas verdades.	si 'dews Re.aw'me~.Ti a.pa.re'se.si, 'mE.ki es'ta.va 'majs du ki 'pro~.tu 'pa.ra Di'zeX Li u~.mas 'ta~.tas veR'da.Dis
Algumas voltas depois, saiu da floresta para uma clareira.	aw'gu~.mas 'vOw.tas de'pojs, sa'iw da flo'rEs.ta 'pa.ra u~.ma kla'rej.ra
Do outro lado, abaixo da encosta, viu-a de novo: a cabana.	du 'ow.tru 'la.du, a'baj.Su da e~'kOs.ta, 'viw a Di 'no.vu, a ka'ba~.na
Ficou parado olhando-a, com o estômago transformado numa bola em movimento e tumulto.	fi'kow pa'ra.du o'La~.du a, ko~ u es'to~.ma.gu tra~s.foR'ma.du 'nu~.ma 'bO.la e~j~ mo.vi~'me~.tu i tu~'muw.tu
Na superfície nada parecia ter mudado, afora o inverno ter despido as árvores e o manto branco de neve que cobria o lugar.	na su.peX'fi.si 'na.da pa.re'si.a 'teR mu'da.du, a'fO.ra u i~'vER.nu 'teR des'pi.du az 'aR.vo.riz i u 'ma~.tu 'bra~.ku Di 'nE.vi ki ko'bri.a u lu'gaX
A cabana parecia morta e vazia, mas de repente transformou-se num monstro de rosto maligno, retorcido numa careta demoníaca, olhando-o diretamente e desafiando-o a se aproximar.	a ka'ba~.na pa.re'si.a 'mOX.ta i va'zi.a, majs Di Re'pe~.Ti tra~s.foR'mow si nu~ 'mo~s.tru Di 'Ros.tu ma'li.gi~.nu, Re.toX'si.du 'nu~.ma ka're.ta de~.mo~'ni.a.ka, o'La~.du u Di.rE.ta~'me~.Ti i de.za.fi'a~.du u a si a.pro.si~'maX
Ignorando o pânico crescente, Mack desceu com decisão os últimos 100 metros e subiu os degraus da varanda.	i.gi~.no'ra~.du u 'pa~.ni.ku kre'se.Ti, 'mE.ki de'sew ko~ de.si'za~w~ uz 'uw.Ti~.mus se~j~ 'mE.truz i su'biw us de'graws da va'ra~.da
As lembranças e o horror da última vez em que estivera ali voltaram num rompante e ele hesitou antes de empurrar a porta.	as le~'bra~.saz i u o'RoR da 'uw.Ti~.ma 'vejz e~j~ ki es.Ti'vE.ra a'li vow'ta.ra~w~ nu~ Ro~'pa~.Ti i 'e.li e.zi'tow 'a~.Tis Di e~.pu'Rar a 'pOX.ta
Olá? chamou, não muito alto.	o'la, Sa~'mow, 'na~w~ 'mu~j~.tu 'aw.tu
Pigarreando, chamou de novo, dessa vez mais alto.	pi.ga.Re'a~.du, Sa~'mow Di 'no.vu, 'dE.sa 'vejz 'majz 'aw.tu
Tem alguém aí? Sua voz ecoou no vazio.	te~j~ aw'ge~j~ a'i, 'su.a 'vOjz e.ko'ow nu va'zi.u
Sentindo-se mais seguro, entrou na sala e parou.	se~'Ti~.du si 'majs se'gu.ru, e~'trow na 'sa.la i pa'row
Enquanto seus olhos se ajustavam à semi-escuridão, começou a perceber os detalhes da sala com a luz da tarde se filtrando pelas janelas quebradas.	e~'kwa~.tu 'sewz 'O.Lus si a.Zus'ta.va~w~ a 'se~.mi es.ku.ri'da~w~, ko~.me'sow a peX.se'ber us de'ta.Lis da 'sa.la ko~ a 'lujz da 'taR.Di si fiw'tra~.du 'pe.la.Za~'nE.las ke'bra.das
Reconheceu as cadeiras velhas e a mesa.	Re.ko~.Je'sew as ka'dej.ras 'vE.Laz i a 'me.za
Não conseguiu evitar que seus olhos fossem atraídos para o único local que não suportaria olhar.	'na~w~ ko~.se'giw e.vi'taX ki 'sewz 'O.Lus 'fo.se~j~ a.tra'i.dus 'pa.ra u 'u~.ni.ku lo'kaw ki 'na~w~ su.poX.ta'ri.a o'LaX
Mesmo depois de alguns anos, a mancha de sangue desbotada ainda era claramente visível na madeira perto da lareira, onde haviam encontrado o vestido de Missy.	'mez.mu de'pojs Di aw'gu~z 'a~.nus, a 'ma~.Sa Di 'sa~.gi dez.bo'ta.da a'i~.da 'E.ra kla.ra~'me~.Ti vi'zi.vew na ma'dej.ra 'pEX.tu da la'rej.ra, 'o~.Di a'vi.a~w~ e~.ko~'tra.du u ves'Ti.du Di 'mi.si
Desculpe, querida. Lágrimas começaram a se juntar nos seus olhos.	des'kuw.pi, ke'ri.da, 'la.gri~.mas ko~.me'sa.ra~w~ a si Zu~'taR nus 'sewz 'O.Lus
E finalmente seu coração explodiu como uma tromba-dágua, soltando a raiva contida e deixando-a jorrar pelos cânions rochosos de suas emoções.	i fi~.naw'me~.Ti 'sew ko.ra'sa~w~ es.plo'Diw 'ko~.mu u~.ma 'tro~.ba 'da.gwa, sow'ta~.du a 'Raj.va ko~'Ti.da i dej'Sa~.du a Zo'RaX 'pe.lus 'ka~.ni.o~s Ro'SO.zus Di 'su.az e~.mo'so~j~s
Virando os olhos para o céu, começou a gritar suas perguntas angustiadas.	vi'ra~.du uz 'O.Lus 'pa.ra u 'sEw, ko~.me'sow a gri'taX 'su.as peR'gu~.taz a~.gus.Ti'a.das
Por quê?	puX 'ke
Por que você deixou que isso acontecesse?	puX 'ke vo'se dej'Sow ki 'i.su a.ko~.te'se.si
Por que me trouxe aqui?	puX 'ke mi 'trow.si a'ki
Por que logo aqui?	puX 'ke 'lO.gu a'ki
Não bastou matar minha filhinha?	'na~w~ bas'tow ma'taR 'mi~.Ja fi'Li~.Ja
Tinha de zombar de mim também?	'Ti~.Ja Di zo~'baR Di 'mi~ ta~'be~j~
Numa fúria cega, Mack pegou a cadeira mais próxima e jogou-a contra a janela, despedaçando-a.	'nu~.ma 'fu.rja 'sE.ga, 'mE.ki pe'gow a ka'dej.ra 'majs 'prO.si~.ma i Zo'gow a 'ko~.tra a Za~'nE.la, des.pe.da'sa~.du a
Com uma das pernas da cadeira, começou a destruir tudo que podia.	ko~ u~.ma das 'pER.nas da ka'dej.ra, ko~.me'sow a des.tru'iX 'tu.du ki po'Di.a
Grunhidos e gemidos de desespero e fúria irrompiam de seus lábios enquanto ele soltava a fúria naquele lugar terrível.	gru~'Ji.duz i Ze~'mi.dus Di de.zes'pe.ru i 'fu.rja i.Ro~'pi.a~w~ Di 'sews 'la.bjuz e~'kwa~.tu 'e.li sow'ta.va a 'fu.rja na'ke.li lu'gaX te'Ri.vew
Odeio você! Num frenesi, liberou a raiva até ficar exaurido.	o'dej.u vo'se, nu~ fre~.ne'zi, li.be'row a 'Raj.va a'tE fi'kar e.zaw'ri.du
Desesperado e derrotado, Mack se deixou cair no chão, perto da mancha de sangue.	de.zes.pe'ra.du i de.Ro'ta.du, 'mE.ki si dej'Sow ka'iR nu 'Sa~w~, 'pEX.tu da 'ma~.Sa Di 'sa~.gi
Tocou-a com cuidado.	to'kow a ko~ kuj'da.du
Era tudo o que restava de sua Missy.	'E.ra 'tu.du u ki Res'ta.va Di 'su.a 'mi.si
Deitado junto dela, os dedos acompanharam com ternura as bordas descoloridas e ele sussurrou baixinho: Missy, desculpe.	dej'ta.du 'Zu~.tu 'dE.la, us 'de.duz a.ko~.pa~'Ja.ra~w~ ko~ teR'nu.ra as 'bOR.das des.ko.lo'ri.daz i 'e.li su.su'Row baj'Si~.Ju, 'mi.si, des'kuw.pi
Desculpe se não pude proteger você.	des'kuw.pi si 'na~w~ 'pu.Di pro.te'ZeR vo'se
Desculpe se não pude encontrar você.	des'kuw.pi si 'na~w~ 'pu.Di e~.ko~'traR vo'se
Mesmo em sua exaustão, a raiva fervilhou e de novo ele apontou contra o Deus indiferente que ele imaginava encontrar-se em algum lugar acima do teto da cabana.	'mez.mu e~j~ 'su.a e.zaws'ta~w~, a 'Raj.va feR.vi'Low i Di 'no.vu 'e.li a.po~'tow 'ko~.tra u 'dewz i~.Di.fe're~.Ti ki 'e.li i~.ma.Zi~'na.va e~.ko~'traX si e~j~ aw'gu~ lu'gar a'si~.ma du 'tE.tu da ka'ba~.na
Deus, você nem deixou que a encontrássemos e a enterrássemos.	'dews, vo'se ne~j~ dej'Sow ki a e~.ko~'tra.se~.muz i a e~.te'Ra.se~.mus
Seria pedir demais?	se'ri.a pe'DiR de~'majs
Enquanto a mistura de emoções ia e vinha, com a raiva dando lugar à dor, uma nova onda de tristeza começou a se misturar com sua confusão.	e~'kwa~.tu a mis'tu.ra Di e~.mo'so~j~z 'i.a i 'vi~.Ja, ko~ a 'Raj.va 'da~.du lu'gar a 'doX, u~.ma 'nO.va 'o~.da Di tris'te.za ko~.me'sow a si mis.tu'raX ko~ 'su.a ko~.fu'za~w~
Então, onde está você?	e~'ta~w~, 'o~.Di es'ta vo'se
Achei que queria se encontrar comigo.	a'Sej ki ke'ri.a si e~.ko~'traX ko~'mi.gu
Bom, estou aqui, Deus. E você?	'bo~, es'tow a'ki, 'dews, i vo'se
Não está em lugar nenhum!	'na~w~ es'ta e~j~ lu'gaR ne~'Ju~
Nunca esteve quando precisei, nem quando eu era pequeno, nem quando perdi Missy.	'nu~.ka es'te.vi 'kwa~.du pre.si'zej, ne~j~ 'kwa~.du ew 'E.ra pe'ke~.nu, ne~j~ 'kwa~.du peR'Di 'mi.si
Nem agora!	ne~j~ a'gO.ra
Tremendo Papai você é! cuspiu as palavras.	tre~'me~.du pa'paj vo'se E, kus'piw as pa'la.vras
Mack ficou ali sentado em silêncio, com o vazio do lugar invadindo sua alma.	'mE.ki fi'kow a'li se~'ta.du e~j~ si'le~.sju, ko~ u va'zi.u du lu'gar i~.va'Di~.du 'su.a 'aw.ma
A Grande Tristeza se apertou ao redor e ele quase gostou da sensação esmagadora.	a 'gra~.Di tris'te.za si a.peX'tow aw Re'dOr i 'e.li 'kwa.zi gos'tow da se~.sa'sa~w~ ez.ma.ga'do.ra
Esta dor ele conhecia.	'Es.ta 'dor 'e.li ko~.Je'si.a
Estava familiarizado com ela, era quase uma amiga.	es'ta.va fa~.mi.li.a.ri'za.du ko~ 'E.la, 'E.ra 'kwa.zi u~.ma a~'mi.ga
Mack podia sentir a arma na cintura, um frio convidativo contra a pele.	'mE.ki po'Di.a se~'Tir a 'aR.ma na si~'tu.ra, u~ 'fri.u ko~.vi.da'Ti.vu 'ko~.tra a 'pE.li
Pegou-a, sem saber direito o que fazer.	pe'gow a, se~j~ sa'beR Di'rej.tu u ki fa'zeX
Ah, parar de se preocupar, parar de sentir a dor, nunca mais sentir nada.	'a, pa'raR Di si prew.ku'paX, pa'raR Di se~'Tir a 'doX, 'nu~.ka 'majs se~'TiR 'na.da
No momento a opção era quase atraente.	nu mo~'me~.tu a op'sa~w~ 'E.ra 'kwa.zi a.tra'e~.Ti
Seria tão fácil, pensou.	se'ri.a 'ta~w~ 'fa.siw, pe~'sow
Chega de lágrimas, chega de dor...	'Se.ga Di 'la.gri~.mas, 'Se.ga Di 'doX
Quase podia ver um abismo preto abrindo-se no chão atrás da arma para a qual estava olhando, uma escuridão que sugava os últimos vestígios de esperança do coração.	'kwa.zi po'Di.a 'ver u~ a'biz.mu 'pre.tu a'bri~.du si nu 'Sa~w~ a'trajs da 'aR.ma 'pa.ra a 'kwaw es'ta.va o'La~.du, u~.ma es.ku.ri'da~w~ ki su'ga.va uz 'uw.Ti~.mus ves'Ti.Zjus Di es.pe'ra~.sa du ko.ra'sa~w~
Encostou-se na parede e esfregou os olhos cansados.	e~.kos'tow si na pa're.Di i es.fre'gow uz 'O.Lus ka~'sa.dus
Deixou-os fecharem-se enquanto murmurava: Amo você, Missy.	dej'Sow us fe'Sa.re~j~ si e~'kwa~.tu muR.mu'ra.va, 'a~.mu vo'se, 'mi.si
Sinto muitas saudades.	'si~.tu 'mu~j~.tas saw'da.Dis
Logo penetrou sem esforço num sono pesado.	'lO.gu pe~.ne'trow se~j~ es'foX.su nu~ 'so~.nu pe'za.du
Provavelmente haviam se passado apenas alguns minutos quando Mack despertou com um solavanco.	pro.va.vew'me~.Ti a'vi.a~w~ si pa'sa.du a'pe~.naz aw'gu~s mi~'nu.tus 'kwa~.du 'mE.ki des.peX'tow ko~ u~ so.la'va~.ku
Surpreso por ter cochilado, levantou-se depressa.	suX'pre.zu puX 'teX ko.Si'la.du, le.va~'tow si de'prE.sa
Enfiando a arma de volta na cintura e a raiva na parte mais funda da alma, foi em direção à porta.	e~.fi'a~.du a 'aR.ma Di 'vOw.ta na si~'tu.ra i a 'Raj.va na 'paX.Ti 'majs 'fu~.da da 'aw.ma, 'foj e~j~ Di.re'sa~w~ a 'pOX.ta
Isso é ridículo! Sou tão idiota!	'i.su E Ri'Di.ku.lu, 'sow 'ta~w~ i.Di'O.ta
E pensar que eu esperava que Deus poderia se importar a ponto de me mandar um bilhete!	i pe~'saX ki ew es.pe'ra.va ki 'dews po.de'ri.a si i~.poX'tar a 'po~.tu Di mi ma~'dar u~ bi'Le.Ti
Olhou para o espaço aberto.	o'Low 'pa.ra u es'pa.su a'bEX.tu
Estou cheio, Deus, sussurrou.	es'tow 'Sej.u, 'dews, su.su'Row
Não posso mais.	'na~w~ 'pO.su 'majs
Estou cansado de tentar encontrá-lo em tudo isso.	es'tow ka~'sa.du Di te~'tar e~.ko~'tra lu e~j~ 'tu.du 'i.su
E saiu pela porta.	i sa'iw 'pe.la 'pOX.ta
Decidiu que esta era a última vez que procuraria Deus.	de.si'Diw ki 'Es.ta 'E.ra a 'uw.Ti~.ma 'vejs ki pro.ku.ra'ri.a 'dews
Se Deus o quisesse, teria de vir encontrá-lo.	si 'dewz u ki'zE.si, te'ri.a Di 'vir e~.ko~'tra lu
Enfiou a mão no bolso, pegou o bilhete que havia encontrado na caixa de correio e picou-o em pedacinhos, deixando-os escorrer lentamente entre os dedos para serem levados pelo vento frio que havia aumentado.	e~.fi'ow a 'ma~w~ nu 'bow.su, pe'gow u bi'Le.Ti ki a'vi.a e~.ko~'tra.du na 'kaj.Sa Di ko'Rej.u i pi'kow u e~j~ pe.da'si~.Jus, dej'Sa~.du uz es.ko'ReR le~.ta~'me~.Ti 'e~.tri us 'de.dus 'pa.ra 'se.re~j~ le'va.dus 'pe.lu 've~.tu 'fri.u ki a'vi.a aw~.me~'ta.du
Com passos pesados e o coração mais pesado ainda, começou a caminhar de volta para o jipe.	ko~ 'pa.sus pe'za.duz i u ko.ra'sa~w~ 'majs pe'za.du a'i~.da, ko~.me'sow a ka~.mi~'JaR Di 'vOw.ta 'pa.ra u 'Zi.pi
Mal havia caminhado uns 15 metros pela trilha quando sentiu um jorro súbito de ar quente alcançá-lo por trás.	'maw a'vi.a ka~.mi~'Ja.du u~s 'ki~.zi 'mE.trus 'pe.la 'tri.La 'kwa~.du se~'Tiw u~ 'Zo.Ru 'su.bi.tu Di 'aX 'ke~.Ti aw.ka~'sa lu puX 'trajs
O canto de um pássaro rompeu o silêncio gelado.	u 'ka~.tu Di u~ 'pa.sa.ru Ro~'pew u si'le~.sju Ze'la.du
O caminho diante dele perdeu rapidamente o verniz de gelo e neve, como se alguém estivesse usando um secador de cabelos.	u ka~'mi~.Ju Di'a~.Ti 'de.li peR'dew Ra.pi.da~'me~.Ti u veR'niz Di 'Ze.lu i 'nE.vi, 'ko~.mu si aw'ge~j~ es.Ti'vE.si u'za~.du u~ se.ka'doR Di ka'be.lus
Mack parou e ficou olhando, enquanto ao redor a cobertura branca se dissolvia e era substituída por uma vegetação radiante.	'mE.ki pa'row i fi'kow o'La~.du, e~'kwa~.tu aw Re'dOr a ko.beX'tu.ra 'bra~.ka si Di.sow'vi.a i 'E.ra subs.Ti.tu'i.da pur u~.ma ve.Ze.ta'sa~w~ Ra.Di'a~.Ti
Três semanas de primavera se desdobraram diante dele em 30 segundos.	'trejs se~'ma~.nas Di pri~.ma'vE.ra si dez.do'bra.ra~w~ Di'a~.Ti 'de.li e~j~ 'tri~.ta se'gu~.dus
Esfregou os olhos e firmou-se naquele redemoinho.	es.fre'gow uz 'O.Luz i fiR'mow si na'ke.li Re.de~.mo'i~.Ju
Até mesmo a neve fina que havia começado a cair se transformara em minúsculas flores descendo preguiçosamente para o chão.	a'tE 'mez.mu a 'nE.vi 'fi~.na ki a'vi.a ko~.me'sa.du a ka'iX si tra~s.foR'ma.ra e~j~ mi~'nus.ku.las 'flo.ris de'se~.du pre.gi.sO.za~'me~.Ti 'pa.ra u 'Sa~w~
O que ele estava vendo, claro, não era possível.	u ki 'e.li es'ta.va 've~.du, 'kla.ru, 'na~w~ 'E.ra po'si.vew
Os montes de neve haviam desaparecido e flores silvestres de verão começaram a colorir as bordas da trilha e a surgir na floresta até onde a vista alcançava.	us 'mo~.Tis Di 'nE.vi a'vi.a~w~ de.za.pa.re'si.du i 'flo.ris siw'vEs.tris Di ve'ra~w~ ko~.me'sa.ra~w~ a ko.lo'rir as 'bOR.das da 'tri.La i a suR'ZiR na flo'rEs.ta a'tE 'o~.Di a 'vis.ta aw.ka~'sa.va
Tordos, esquilos e tâmias atravessavam de vez em quando o caminho, alguns parando para sentar-se e olhá-lo por um momento antes de mergulhar de novo no mato baixo.	'toR.dus, es'ki.luz i 'ta~.mjaz a.tra.ve'sa.va~w~ Di 'vejz e~j~ 'kwa~.du u ka~'mi~.Ju, aw'gu~s pa'ra~.du 'pa.ra se~'taX si i o'La lu pur u~ mo~'me~.tu 'a~.Tis Di meR.gu'LaR Di 'no.vu nu 'ma.tu 'baj.Su
O terror dominou Mack, como se ele tivesse aberto a Caixa de Pandora e fosse varrido para o centro da loucura, perdendo-se para sempre.	u te'RoR do~.mi~'now 'mE.ki, 'ko~.mu si 'e.li Ti'vE.si a'bEX.tu a 'kaj.Sa Di pa~'do.ra i 'fo.si va'Ri.du 'pa.ra u 'se~.tru da low'ku.ra, peR'de~.du si 'pa.ra 'se~.pri
Inseguro, girou com cuidado, tentando se agarrar a algum sentimento de sanidade.	i~.se'gu.ru, Zi'row ko~ kuj'da.du, te~'ta~.du si a.ga'Rar a aw'gu~ se~.Ti~'me~.tu Di sa~.ni'da.Di
Ficou pasmo.	fi'kow 'paz.mu
Tudo mudara.	'tu.du mu'da.ra
A cabana dilapidada fora substituída por um chalé sólido e lindamente construído com troncos descascados à mão, cada um deles trabalhado para um encaixe perfeito.	a ka'ba~.na Di.la.pi'da.da 'fo.ra subs.Ti.tu'i.da pur u~ Sa'lE 'sO.li.du i li~.da~'me~.Ti ko~s.tru'i.du ko~ 'tro~.kus des.kas'ka.duz a 'ma~w~, 'ka.da 'u~ 'de.lis tra.ba'La.du 'pa.ra u~ e~'kaj.Si peX'fej.tu
Em vez dos arbustos escuros e agrestes de macegas, urzes e espinheiros, tudo o que Mack via agora era perfeito como num cartão-postal.	e~j~ 'vejz duz aR'bus.tuz es'ku.ruz i a'grEs.Tis Di ma'sE.gas, 'uR.ziz i es.pi~'Jej.rus, 'tu.du u ki 'mE.ki 'vi.a a'gO.ra 'E.ra peX'fej.tu 'ko~.mu nu~ kaX'ta~w~ pos'taw
A fumaça subia preguiçosa da chaminé para o céu do fim da tarde, sinal de atividade dentro da cabana.	a fu~'ma.sa su'bi.a pre.gi'sO.za da Sa~.mi~'nE 'pa.ra u 'sEw du 'fi~ da 'taR.Di, si~'naw Di a.Ti.vi'da.Di 'de~.tru da ka'ba~.na
O som de risos vinha de perto, talvez de dentro, mas não dava para ter certeza.	u 'so~ Di 'Ri.zus 'vi~.Ja Di 'pEX.tu, taw'vejz Di 'de~.tru, majs 'na~w~ 'da.va 'pa.ra 'teX seX'te.za
Talvez fosse assim a experiência de um surto psicótico total.	taw'vejs 'fo.si a'si~ a es.pe.ri'e~.sja Di u~ 'suX.tu psi'kO.Ti.ku to'taw
Estou pirando de vez, sussurrou Mack.	es'tow pi'ra~.du Di 'vejs, su.su'Row 'mE.ki
Isso não pode estar acontecendo.	'i.su 'na~w~ 'pO.Di es'tar a.ko~.te'se~.du
Não é real.	'na~w~ E Re'aw
Era um lugar que Mack só poderia ter imaginado em seus melhores sonhos, e isso tornava a coisa ainda mais suspeita.	'E.ra u~ lu'gaX ki 'mE.ki 'sO po.de'ri.a 'ter i~.ma.Zi~'na.du e~j~ 'sews me'LO.ris 'so~.Jus, i 'i.su toR'na.va a 'koj.za a'i~.da 'majs sus'pej.ta
Flores brotavam em toda parte e a mistura de fragrâncias florais provocou lembranças de infância, esquecidas havia muito.	'flo.ris bro'ta.va~w~ e~j~ 'to.da 'paX.Ti i a mis'tu.ra Di fra'gra~.sjas flo'rajs pro.vo'kow le~'bra~.sas Di i~'fa~.sja, es.ke'si.daz a'vi.a 'mu~j~.tu
Ele sempre ouvira dizer que o olfato era o melhor elo com o passado, o sentido mais forte para redescobrir histórias antigas.	'e.li 'se~.pri ow'vi.ra Di'zeX ki u ow'fa.tu 'E.ra u me'LOr 'E.lu ko~ u pa'sa.du, u se~'Ti.du 'majs 'fOX.Ti 'pa.ra Re.des.ko'brir is'tO.rjaz a~'Ti.gas
Na varanda, parou de novo.	na va'ra~.da, pa'row Di 'no.vu
Vozes vinham muito claramente de dentro.	'vO.zis 'vi~.Ja~w~ 'mu~j~.tu kla.ra~'me~.Ti Di 'de~.tru
Mack rejeitou o impulso súbito de sair correndo, como se fosse algum garoto que tivesse jogado a bola no jardim de um vizinho.	'mE.ki Re.Zej'tow u i~'puw.su 'su.bi.tu Di sa'iX ko'Re~.du, 'ko~.mu si 'fo.si aw'gu~ ga'ro.tu ki Ti'vE.si Zo'ga.du a 'bO.la nu ZaR'Di~ Di u~ vi'zi~.Ju
Quem estaria lá dentro? Fechou os olhos e balançou a cabeça para ver se conseguia apagar a alucinação e restaurar a realidade.	'ke~j~ es.ta'ri.a 'la 'de~.tru, fe'Sow uz 'O.Luz i ba.la~'sow a ka'be.sa 'pa.ra 'veX si ko~.se'gi.a a.pa'gar a a.lu.si~.na'sa~w~ i Res.taw'rar a Re.a.li'da.Di
Mas, quando os abriu, tudo continuava ali.	majs, 'kwa~.du uz a'briw, 'tu.du ko~.Ti~.nu'a.va a'li
Estendeu a mão, hesitando, e tocou o corrimão de madeira.	es.te~'dew a 'ma~w~, e.zi'ta~.du, i to'kow u ko.Ri~'ma~w~ Di ma'dej.ra
Certamente parecia real.	sEX.ta~'me~.Ti pa.re'si.a Re'aw
Agora enfrentava outro dilema.	a'gO.ra e~.fre~'ta.va 'ow.tru Di'le~.ma
O que você faz quando chega à porta de uma casa, ou de um chalé, neste caso, onde Deus pode estar?	u ki vo'se 'fajs 'kwa~.du 'Se.ga a 'pOX.ta Di u~.ma 'ka.za, ow Di u~ Sa'lE, 'nes.Ti 'ka.zu, 'o~.Di 'dews 'pO.Di es'taX
Deve bater?	'dE.vi ba'teX
Certamente Deus devia saber que Mack estava ali.	sEX.ta~'me~.Ti 'dews de'vi.a sa'beX ki 'mE.ki es'ta.va a'li
Talvez ele simplesmente devesse entrar e se apresentar, mas isso parecia igualmente absurdo.	taw'vejz 'e.li si~.pliz'me~.Ti de've.si e~'trar i si a.pre.ze~'taX, majz 'i.su pa.re'si.a i.gwaw'me~.Ti ab'suR.du
E como se dirigir a Deus?	i 'ko~.mu si Di.ri'Zir a 'dews
Deveria chamá-lo de Pai, de Todo-Poderoso ou talvez de Senhor Deus?	de.ve'ri.a Sa~'ma lu Di 'paj, Di 'to.du po.de'ro.zu ow taw'vejz Di se~'JoR 'dews
Seria melhor ajoelhar-se e cair em adoração?	se'ri.a me'LOr a.Zo.e'LaX si i ka'ir e~j~ a.do.ra'sa~w~
Enquanto tentava estabelecer algum equilíbrio interno, a raiva voltou a emergir.	e~'kwa~.tu te~'ta.va es.ta.be.le'ser aw'gu~ e.ki'li.brju i~'tER.nu, a 'Raj.va vow'tow a e~.meR'ZiX
Decidiu bater com força para ver o que acontecia, mas, no momento em que levantou o punho, a porta se escancarou e diante dele apareceu uma negra enorme e sorridente.	de.si'Diw ba'teX ko~ 'foX.sa 'pa.ra 'ver u ki a.ko~.te'si.a, majs, nu mo~'me~.tu e~j~ ki le.va~'tow u 'pu~.Ju, a 'pOX.ta si es.ka~.ka'row i Di'a~.Ti 'de.li a.pa.re'sew u~.ma 'ne.gra e~'nOR.mi i so.Ri'de~.Ti
Mack pulou para trás por instinto, mas foi lento demais.	'mE.ki pu'low 'pa.ra 'trajs pur i~s'Ti~.tu, majs 'foj 'le~.tu de~'majs
Com uma velocidade surpreendente para o seu tamanho, a mulher atravessou a distância entre os dois e o engolfou nos braços, levantando-o do chão e girando-o como se ele fosse uma criança pequena.	ko~ u~.ma ve.lo.si'da.Di suX.pre.e~'de~.Ti 'pa.ra u 'sew ta~'ma~.Ju, a mu'LEr a.tra.ve'sow a Dis'ta~.sja 'e~.tri us 'dojz i u e~.gow'fow nus 'bra.sus, le.va~'ta~.du u du 'Sa~w~ i Zi'ra~.du u 'ko~.mu si 'e.li 'fo.si u~.ma kri'a~.sa pe'ke~.na
E o tempo todo gritava o seu nome, Mackenzie Allen Phillips, com o ardor de alguém que reencontrasse um parente amado há muito perdido.	i u 'te~.pu 'to.du gri'ta.va u 'sew 'no~.mi, ma'ke~.zi 'a.le~ 'fi.lips, ko~ u aR'doR Di aw'ge~j~ ki Re.e~.ko~'tra.si u~ pa're~.Ti a~'ma.du 'a 'mu~j~.tu peR'Di.du
Por fim colocou-o de volta no chão e, com as mãos nos ombros dele, empurrou-o para trás, como se quisesse vê-lo bem.	puX 'fi~ ko.lo'kow u Di 'vOw.ta nu 'Sa~w~ i, ko~ as 'ma~w~s nuz 'o~.brus 'de.li, e~.pu'Row u 'pa.ra 'trajs, 'ko~.mu si ki'zE.si 've lu 'be~j~
Mack, olha só para você! ela praticamente explodiu.	'mE.ki, 'O.La 'sO 'pa.ra vo'se, 'E.la pra.Ti.ka~'me~.Ti es.plo'Diw
Aí está, e tão crescido!	a'i es'ta, i 'ta~w~ kre'si.du
Eu estava ansiosa para vê-lo cara a cara.	ew es'ta.va a~.si'O.za 'pa.ra 've lu 'ka.ra a 'ka.ra
É tão maravilhoso tê-lo aqui conosco!	E 'ta~w~ ma.ra.vi'Lo.zu 'te lu a'ki ko~'nos.ku
Minha nossa, como eu amo você!	'mi~.Ja 'nO.sa, 'ko~.mu ew 'a~.mu vo'se
E, ao dizer isso, o abraçou de novo.	i, aw Di'zer 'i.su, u a.bra'sow Di 'no.vu
Mack ficou sem fala.	'mE.ki fi'kow se~j~ 'fa.la
Mas algo no seu olhar e na maneira como ela dizia o seu nome o deixou deliciado, mesmo não tendo a menor idéia de quem se tratava.	majz 'aw.gu nu 'sew o'Lar i na ma~'nej.ra 'ko~.mu 'E.la Di'zi.a u 'sew 'no~.mi u dej'Sow de.li.si'a.du, 'mez.mu 'na~w~ 'te~.du a me~'nOr i'dEj.a Di 'ke~j~ si tra'ta.va
De repente foi dominado pelo perfume que exalava da mulher, e isso o sacudiu.	Di Re'pe~.Ti 'foj do~.mi~'na.du 'pe.lu peX'fu~.mi ki e.za'la.va da mu'LEX, i 'i.su u sa.ku'Diw
Era o cheiro de flores, com sugestões de gardênia e jasmim, inconfundivelmente o perfume de sua mãe que ele mantivera guardado em um vidro na latinha.	'E.ra u 'Sej.ru Di 'flo.ris, ko~ su.Zes'to~j~s Di gaR'de~.nja i Zaz'mi~, i~.ko~.fu~.Di.vew'me~.Ti u peX'fu~.mi Di 'su.a 'ma~j~ ki 'e.li ma~.Ti'vE.ra gwaR'da.du e~j~ u~ 'vi.dru na la'Ti~.Ja
O cheiro que jorrava e a lembrança que vinha junto o fizeram cambalear.	u 'Sej.ru ki Zo'Ra.va i a le~'bra~.sa ki 'vi~.Ja 'Zu~.tu u fi'zE.ra~w~ ka~.ba.le'aX
Podia sentir o calor das lágrimas em seus olhos, como se estivessem batendo à porta de seu coração.	po'Di.a se~'Tir u ka'loR das 'la.gri~.maz e~j~ 'sewz 'O.Lus, 'ko~.mu si es.Ti'vE.se~j~ ba'te~.du a 'pOX.ta Di 'sew ko.ra'sa~w~
A mulher percebeu.	a mu'LEX peX.se'bew
Tudo bem, querido, pode deixar que elas saiam...	'tu.du 'be~j~, ke'ri.du, 'pO.Di dej'SaX ki 'E.las 'saj.a~w~
Sei que você foi magoado e que está com raiva e confuso.	'sej ki vo'se 'foj ma.go'a.du i ki es'ta ko~ 'Raj.va i ko~'fu.zu
É bom para a alma deixar que as águas rolem de vez em quando, as águas que curam.	E 'bo~ 'pa.ra a 'aw.ma dej'SaX ki az 'a.gwas 'RO.le~j~ Di 'vejz e~j~ 'kwa~.du, az 'a.gwas ki 'ku.ra~w~
Mack não podia impedir que as lágrimas enchessem seus olhos, mas não estava preparado para soltá-las, ainda não, não com essa mulher.	'mE.ki 'na~w~ po'Di.a i~.pe'DiX ki as 'la.gri~.maz e~'Se.se~j~ 'sewz 'O.Lus, majs 'na~w~ es'ta.va pre.pa'ra.du 'pa.ra sow'ta las, a'i~.da 'na~w~, 'na~w~ ko~ 'E.sa mu'LEX
Enquanto isso, a mulher ficou ali com os braços estendidos, como se fossem os da sua mãe.	e~'kwa~.tu 'i.su, a mu'LEX fi'kow a'li ko~ us 'bra.suz es.te~'Di.dus, 'ko~.mu si 'fo.se~j~ us da 'su.a 'ma~j~
Ele sentiu a presença do amor.	'e.li se~'Tiw a pre'ze~.sa du a~'moX
Era quente, convidativo, derretia tudo.	'E.ra 'ke~.Ti, ko~.vi.da'Ti.vu, de.Re'Ti.a 'tu.du
Não está pronto? reagiu ela.	'na~w~ es'ta 'pro~.tu, Re.a'Ziw 'E.la
Tudo bem, vamos fazer as coisas no seu devido tempo.	'tu.du 'be~j~, 'va~.mus fa'zer as 'koj.zas nu 'sew de'vi.du 'te~.pu
Venha comigo.	've~.Ja ko~'mi.gu
Posso pegar seu casaco?	'pO.su pe'gaX 'sew ka'za.ku
E essa arma?	i 'E.sa 'aR.ma
Você não precisa mesmo dela, certo?	vo'se 'na~w~ pre'si.za 'mez.mu 'dE.la, 'sEX.tu
Não queremos que alguém se machuque, não é?	'na~w~ ke're~.mus ki aw'ge~j~ si ma'Su.ki, 'na~w~ E
Mack não sabia direito o que fazer ou dizer.	'mE.ki 'na~w~ sa'bi.a Di'rej.tu u ki fa'zer ow Di'zeX
Quem era ela?	'ke~j~ 'E.ra 'E.la
Enraizado no mesmo lugar, lenta e mecanicamente tirou o casaco.	e~.Raj'za.du nu 'mez.mu lu'gaX, 'le~.ta i me.ka~.ni.ka~'me~.Ti Ti'row u ka'za.ku
A negra enorme pegou o casaco e ele lhe entregou a arma, que ela segurou com a ponta de dois dedos, como se aquilo estivesse contaminado.	a 'ne.gra e~'nOR.mi pe'gow u ka'za.ku i 'e.li Li e~.tre'gow a 'aR.ma, ki 'E.la se.gu'row ko~ a 'po~.ta Di 'dojs 'de.dus, 'ko~.mu si a'ki.lu es.Ti'vE.si ko~.ta~.mi~'na.du
No momento em que ela se virou para entrar no chalé, uma mulher pequena, claramente asiática, emergiu de trás da negra.	nu mo~'me~.tu e~j~ ki 'E.la si vi'row 'pa.ra e~'traR nu Sa'lE, u~.ma mu'LEX pe'ke~.na, kla.ra~'me~.Ti a.zi'a.Ti.ka, e~.meR'Ziw Di 'trajs da 'ne.gra
Aqui, deixe-me pegar isso, cantarolou ela.	a'ki, 'dej.Si mi pe'gar 'i.su, ka~.ta.ro'low 'E.la
Obviamente não se referia ao casaco nem à arma e sim a outra coisa, e estava na frente dele num piscar de olhos.	Ob.vi.a~'me~.Ti 'na~w~ si Re.fe'ri.a aw ka'za.ku ne~j~ a 'aR.ma i 'si~ a 'ow.tra 'koj.za, i es'ta.va na 'fre~.Ti 'de.li nu~ pis'kaR Di 'O.Lus
Mack se enrijeceu ao sentir algo passar suavemente em sua face.	'mE.ki si e~.Ri.Ze'sew aw se~'Tir 'aw.gu pa'saX su.a.ve~'me~.Ti e~j~ 'su.a 'fa.si
Sem se mexer, olhou para baixo e viu que a mulher estava usando um frágil frasco de cristal e um pequeno pincel, como os que vira Nan e Kate usar para maquiagem, e que gentilmente removia algo de seu rosto.	se~j~ si me'SeX, o'Low 'pa.ra 'baj.Su i 'viw ki a mu'LEr es'ta.va u'za~.du u~ 'fra.Ziw 'fras.ku Di kris'taw i u~ pe'ke~.nu pi~'sEw, 'ko~.mu us ki 'vi.ra 'na~ i 'kej.Ti u'zaX 'pa.ra ma.ki'a.Ze~j~, i ki Ze~.Tiw'me~.Ti Re~.mo'vi.a 'aw.gu Di 'sew 'Ros.tu
A pequena lata relampejou na mente dele.	a pe'ke~.na 'la.ta Re.la~.pe'Zow na 'me~.Ti 'de.li
Eu coleciono lágrimas.	ew ko.le.si'o~.nu 'la.gri~.mas
Enquanto a mulher recuava, Mack se pegou franzindo os olhos na direção dela, como se isso lhe permitisse enxergar melhor.	e~'kwa~.tu a mu'LE.Re.ku'a.va, 'mE.ki si pe'gow fra~'zi~.du uz 'O.Lus na Di.re'sa~w~ 'dE.la, 'ko~.mu si 'i.su Li peR.mi'Ti.si e~.SeR'gaR me'LOX
Mas, estranhamente, ainda tinha dificuldade para focalizá-la.	majs, es.tra~.Ja~'me~.Ti, a'i~.da 'Ti~.Ja Di.fi.kuw'da.Di 'pa.ra fo.ka.li'za la
Ela parecia quase tremeluzir na luz e seu cabelo voava em todas as direções, apesar de não haver nenhuma brisa.	'E.la pa.re'si.a 'kwa.zi tre~.me.lu'ziR na 'lujz i 'sew ka'be.lu vo'a.va e~j~ 'to.daz as Di.re'so~j~s, a.pe'zaR Di 'na~w~ a'veR ne~'Ju~.ma 'bri.za
Era quase mais fácil vê-la com o canto do olho do que fixando-a diretamente.	'E.ra 'kwa.zi 'majs 'fa.siw 've la ko~ u 'ka~.tu du 'o.Lu du ki fik'sa~.du a Di.rE.ta~'me~.Ti
Então olhou para além dela e notou que uma terceira pessoa havia saído do chalé.	e~'ta~w~ o'Low 'pa.ra a'le~j~ 'dE.la i no'tow ki u~.ma teX'sej.ra pe'so.a a'vi.a sa'i.du du Sa'lE
Desta vez era um homem.	'dEs.ta 'vejz 'E.ra u~ 'o~.me~j~
Parecia ser do Oriente Médio e se vestia como um operário, com cinto de ferramentas e luvas.	pa.re'si.a 'seR du o.ri'e~.Ti 'mE.Dju i si ves'Ti.a 'ko~.mu u~ o.pe'ra.rju, ko~ 'si~.tu Di fe.Ra~'me~.taz i 'lu.vas
Estava de pé, tranquilamente encostado no portal e com os braços cruzados, usando jeans cobertos de serragem e uma camisa xadrez com mangas enroladas acima dos cotovelos, revelando antebraços musculosos.	es'ta.va Di 'pE, tra~.kwi.la~'me~.Ti e~.kos'ta.du nu poX'taw i ko~ us 'bra.sus kru'za.dus, u'za~.du 'Di~s ko'bEX.tus Di se'Ra.Ze~j~ i u~.ma ka~'mi.za Sa'drejs ko~ 'ma~.gaz e~.Ro'la.daz a'si~.ma dus ko.to've.lus, Re.ve'la~.du a~.te'bra.sus mus.ku'lO.zus
Suas feições eram bastante agradáveis, mas ele não era particularmente bonito, não se destacaria numa multidão.	'su.as fej'so~j~z 'E.ra~w~ bas'ta~.Ti a.gra'da.vejs, majz 'e.li 'na~w~ 'E.ra paX.Ti.ku.laR'me~.Ti bo~'ni.tu, 'na~w~ si des.ta.ka'ri.a 'nu~.ma muw.Ti'da~w~
Mas seus olhos e o sorriso iluminavam o rosto e Mack achou difícil desviar o olhar.	majs 'sewz 'O.Luz i u so'Ri.zu i.lu~.mi~'na.va~w~ u 'Ros.tu i 'mE.ki a'Sow Di'fi.siw dez.vi'ar u o'LaX
Mack recuou de novo, sentindo-se um tanto esmagado.	'mE.ki Re.ku'ow Di 'no.vu, se~'Ti~.du si u~ 'ta~.tu ez.ma'ga.du
Há mais de vocês? perguntou meio rouco.	'a 'majs Di vo'sejs, peR.gu~'tow 'mej.u 'Row.ku
Os três se entreolharam e riram.	us 'trejs si e~.tre.o'La.ra~w~ i 'Ri.ra~w~
Mack não conseguiu evitar um sorriso.	'mE.ki 'na~w~ ko~.se'giw e.vi'tar u~ so'Ri.zu
Não, Mackenzie, riu a negra.	'na~w~, ma'ke~.zi, 'Riw a 'ne.gra
Somos tudo que você tem e, acredite, é mais do que o bastante.	'so~.mus 'tu.du ki vo'se te~j~ i, a.kre'Di.Ti, E 'majs du ki u bas'ta~.Ti
Mack tentou olhar de novo para a mulher asiática.	'mE.ki te~'tow o'LaR Di 'no.vu 'pa.ra a mu'LEr a.zi'a.Ti.ka
Pelo que podia ver, ela talvez fosse do Norte da China, ou até mesmo de etnia mongólica.	'pe.lu ki po'Di.a 'veX, 'E.la taw'vejs 'fo.si du 'nOX.Ti da 'Si~.na, ow a'tE 'mez.mu Di e.Ti~'ni.a mo~'gO.li.ka
Era difícil dizer, porque seus olhos precisavam se esforçar para enxergá-la.	'E.ra Di'fi.siw Di'zeX, puX'ke 'sewz 'O.Lus pre.si'za.va~w~ si es.foX'saX 'pa.ra e~.SeR'ga la
Pelas roupas, Mack presumiu que fosse jardineira ou que cuidasse da horta.	'pe.las 'Row.pas, 'mE.ki pre.zu~'miw ki 'fo.si ZaR.Di~'nej.ra ow ki kuj'da.si da 'OX.ta
Tinha luvas dobradas no cinto, não como as de couro do homem, mas leves, de pano e borracha, como as que o próprio Mack usava para trabalhar no quintal de casa.	'Ti~.Ja 'lu.vas do'bra.das nu 'si~.tu, 'na~w~ 'ko~.mu as Di 'kow.ru du 'o~.me~j~, majs 'lE.vis, Di 'pa~.nu i bo'Ra.Sa, 'ko~.mu as ki u 'prO.prju 'mE.ki u'za.va 'pa.ra tra.ba'LaR nu ki~'taw Di 'ka.za
Vestia jeans simples com desenhos ornamentais nas barras, joelhos cobertos da terra onde estivera ajoelhada, e uma blusa muito colorida com manchas de amarelo, vermelho e azul.	ves'Ti.a 'Di~s 'si~.plis ko~ de'ze~.Juz oR.na~.me~'tajs nas 'ba.Ras, Zu'e.Lus ko'bEX.tus da 'tE.Ra 'o~.Di es.Ti'vE.ra a.Zo.e'La.da, i u~.ma 'blu.za 'mu~j~.tu ko.lo'ri.da ko~ 'ma~.Sas Di a~.ma'rE.lu, veR'me.Lu i a'zuw
Mack tinha uma impressão de tudo isso, porque ela parecia entrar e sair de seu campo de visão.	'mE.ki 'Ti~.Ja u~.ma i~.pre'sa~w~ Di 'tu.du 'i.su, puX'ke 'E.la pa.re'si.a e~'trar i sa'iR Di 'sew 'ka~.pu Di vi'za~w~
Então o homem se aproximou, tocou o ombro de Mack, beijou-o nas faces e o abraçou com força.	e~'ta~w~ u 'o~.me~j~ si a.pro.si~'mow, to'kow u 'o~.bru Di 'mE.ki, bej'Zow u nas 'fa.siz i u a.bra'sow ko~ 'foX.sa
Mack soube instantaneamente que gostava dele.	'mE.ki 'sow.bi i~s.ta~.ta~.ne.a~'me~.Ti ki gos'ta.va 'de.li
Depois o homem recuou e a mulher asiática aproximou-se de novo, segurando seu rosto com as duas mãos.	de'pojz u 'o~.me~j~ Re.ku'ow i a mu'LEr a.zi'a.Ti.ka a.pro.si~'mow si Di 'no.vu, se.gu'ra~.du 'sew 'Ros.tu ko~ as 'du.as 'ma~w~s
Gradual e intencionalmente, ela aproximou o seu rosto do dele e olhou no fundo de seus olhos.	gra.du'aw i i~.te~.si.o~.naw'me~.Ti, 'E.la a.pro.si~'mow u 'sew 'Ros.tu du 'de.li i o'Low nu 'fu~.du Di 'sewz 'O.Lus
Mack achou que quase podia ver através dela.	'mE.ki a'Sow ki 'kwa.zi po'Di.a 'ver a.tra'vEjs 'dE.la
Então a mulher sorriu e seu perfume pareceu envolvê-lo e tirar um peso enorme de seus ombros.	e~'ta~w~ a mu'LEX so'Riw i 'sew peX'fu~.mi pa.re'sew e~.vow've lu i Ti'rar u~ 'pe.zu e~'nOR.mi Di 'sewz 'o~.brus
De repente Mack sentiu-se mais leve do que o ar, quase como se não tocasse mais o chão.	Di Re'pe~.Ti 'mE.ki se~'Tiw si 'majs 'lE.vi du ki u 'aX, 'kwa.zi 'ko~.mu si 'na~w~ to'ka.si 'majz u 'Sa~w~
Ela estava abraçando-o sem abraçá-lo, ou sem mesmo tocá-lo.	'E.la es'ta.va a.bra'sa~.du u se~j~ a.bra'sa lu, ow se~j~ 'mez.mu to'ka lu
Ah, não se incomode, riu a negra enorme.	'a, 'na~w~ si i~.ko~'mO.Di, 'Riw a 'ne.gra e~'nOR.mi
Ela causa esse efeito em todo mundo.	'E.la 'kaw.za 'e.si e'fej.tu e~j~ 'to.du 'mu~.du
Gosto disso, ele murmurou e os três irromperam em mais risos.	'gOs.tu 'Di.su, 'e.li muR.mu'row i us 'trejz i.Ro~'pe.ra~w~ e~j~ 'majs 'Ri.zus
Agora Mack se pegou rindo com eles, sem saber exatamente por que e não se importando com isso.	a'gO.ra 'mE.ki si pe'gow 'Ri~.du ko~ 'e.lis, se~j~ sa'ber e.za.ta~'me~.Ti puX 'ke i 'na~w~ si i~.poX'ta~.du ko~ 'i.su
Quando finalmente parou de rir, a mulher enorme passou o braço por seus ombros, puxou-o e disse: Nós sabemos quem você é, mas acho que devemos nos apresentar.	'kwa~.du fi~.naw'me~.Ti pa'row Di 'RiX, a mu'LEr e~'nOR.mi pa'sow u 'bra.su puX 'sewz 'o~.brus, pu'Sow u i 'Di.si, 'nOjs sa'be~.mus 'ke~j~ vo'se E, majz 'a.Su ki de've~.mus nuz a.pre.ze~'taX
Eu, ela balançou as mãos com um floreio, sou a governanta e cozinheira.	ew, 'E.la ba.la~'sow as 'ma~w~s ko~ u~ flo'rej.u, 'sow a go.veR'na~.ta i ko.zi~'Jej.ra
Pode me chamar de Elousia.	'pO.Di mi Sa~'maR Di e.low'zi.a
Elousia? perguntou Mack, sem compreender.	e.low'zi.a, peR.gu~'tow 'mE.ki, se~j~ ko~.pre.e~'deX
Certo, você não precisa me chamar de Elousia.	'sEX.tu, vo'se 'na~w~ pre'si.za mi Sa~'maR Di e.low'zi.a
É só um nome de que eu gosto e que tem um significado particular para mim.	E 'sO u~ 'no~.mi Di ki ew 'gOs.tu i ki te~j~ u~ si.gi~.ni.fi'ka.du paX.Ti.ku'laX 'pa.ra 'mi~
Então, ela cruzou os braços e pôs a mão sob o queixo, como se pensasse com intensidade especial, pode me chamar do mesmo modo como Nan me chama.	e~'ta~w~, 'E.la kru'zow us 'bra.suz i 'pojz a 'ma~w~ sob u 'kej.Su, 'ko~.mu si pe~'sa.si ko~ i~.te~.si'da.Di es.pe.si'aw, 'pO.Di mi Sa~'maR du 'mez.mu 'mO.du 'ko~.mu 'na~ mi 'Sa~.ma
O quê?	u 'ke
Você não quer dizer...	vo'se 'na~w~ 'kER Di'zeX
Agora Mack ficou surpreso e mais confuso ainda.	a'gO.ra 'mE.ki fi'kow suX'pre.zu i 'majs ko~'fu.zu a'i~.da
Sem dúvida aquela não era o Papai que havia mandado o bilhete!	se~j~ 'du.vi.da a'kE.la 'na~w~ 'E.ra u pa'paj ki a'vi.a ma~'da.du u bi'Le.Ti
É... quer dizer, Papai?	E, 'kER Di'zeX, pa'paj
É, respondeu ela e sorriu, esperando que ele falasse, mas Mack ficou quieto.	E, Res.po~'dew 'E.la i so'Riw, es.pe'ra~.du ki 'e.li fa'la.si, majs 'mE.ki fi'kow ki'E.tu
O homem, que parecia ter trinta e poucos anos e era um pouco mais baixo do que Mack, interrompeu: Tento manter as coisas consertadas por aqui.	u 'o~.me~j~, ki pa.re'si.a 'teX 'tri~.ta i 'pow.kuz 'a~.nuz i 'E.ra u~ 'pow.ku 'majs 'baj.Su du ki 'mE.ki, i~.te.Ro~'pew, 'te~.tu ma~'ter as 'koj.zas ko~.seX'ta.das pur a'ki
Mas gosto de trabalhar com as mãos, se bem que, como essas duas vão lhe dizer, sinto prazer em cozinhar e cuidar do jardim.	majs 'gOs.tu Di tra.ba'LaX ko~ as 'ma~w~s, si 'be~j~ ki, 'ko~.mu 'E.sas 'du.as 'va~w~ Li Di'zeX, 'si~.tu pra'zer e~j~ ko.zi~'Jar i kuj'daR du ZaR'Di~
Você parece ser do Oriente Médio, talvez seja árabe? perguntou Mack.	vo'se pa'rE.si 'seR du o.ri'e~.Ti 'mE.Dju, taw'vejs 'se.Za 'a.ra.bi, peR.gu~'tow 'mE.ki
Na verdade, sou irmão de criação daquela grande família.	na veR'da.Di, 'sow iR'ma~w~ Di kri.a'sa~w~ da'kE.la 'gra~.Di fa~'mi.lja
Sou hebreu; para ser exato, da casa de Judá.	'sow e'brew, 'pa.ra 'ser e'za.tu, da 'ka.za Di Zu'da
Então. De repente Mack ficou abalado com a própria percepção.	e~'ta~w~, Di Re'pe~.Ti 'mE.ki 'fi.kow a.ba'la.du ko~ a 'prO.prja peX.sep'sa~w~
Então você é. Jesus?	e~'ta~w~ vo'se E, Ze'zujs
E pode me chamar assim, se quiser.	i 'pO.Di mi Sa~'mar a'si~, si ki'zEX
Afinal de contas, esse se tornou o meu nome comum.	a.fi~'naw Di 'ko~.tas, 'e.si si toR'now u 'mew 'no~.mi ko~'mu~
Minha mãe me chamava de Yeshua, mas também posso ser conhecido como Joshua ou até mesmo Jesse.	'mi~.Ja 'ma~j~ mi Sa~'ma.va Di i.e'Su.a, majs ta~'be~j~ 'pO.su 'seX ko~.Je'si.du 'ko~.mu 'ZO.Su.a ow a'tE 'mez.mu 'ZE.si
Mack ficou perplexo e mudo.	'mE.ki fi'kow peX'plEk.su i 'mu.du
O que ele estava vendo e ouvindo parecia completamente impossível!	u ki 'e.li es'ta.va 've~.du i ow'vi~.du pa.re'si.a ko~.plE.ta~'me~.Ti i~.po'si.vew
De repente sentiu que ia desmaiar.	Di Re'pe~.Ti se~'Tiw ki 'i.a dez.maj'aX
Nesse momento a asiática chegou mais perto e desviou sua atenção.	'ne.si mo~'me~.tu a a.zi'a.Ti.ka Se'gow 'majs 'pEX.tu i dez.vi'ow 'su.a a.te~'sa~w~
E eu sou Sarayu, disse ela inclinando a cabeça numa ligeira reverência e sorrindo.	i ew 'sow sa.ra'ju, 'Di.si 'E.la i~.kli~'na~.du a ka'be.sa 'nu~.ma li'Zej.ra Re.ve're~.sja i so'Ri~.du
Guardiã dos jardins, dentre outras coisas.	gwaR.Di'a~ du.ZaR'Di~s, 'de~.tri 'ow.tras 'koj.zas
Pensamentos se embolavam enquanto Mack lutava para ter alguma clareza.	pe~.sa~'me~.tus si e~.bo'la.va~w~ e~'kwa~.tu 'mE.ki lu'ta.va 'pa.ra 'ter aw'gu~.ma kla're.za
Será que alguma daquelas pessoas era Deus?	se'ra ki aw'gu~.ma da'kE.las pe'so.az 'E.ra 'dews
E se fossem alucinações?	i si 'fo.se~j~ a.lu.si~.na'so~j~s
Ou será que Deus viria mais tarde?	ow se'ra ki 'dews vi'ri.a 'majs 'taR.Di
Já que eram três, talvez aquilo fosse uma espécie de Trindade.	'Za ki 'E.ra~w~ 'trejs, taw'vejz a'ki.lu 'fo.si u~.ma es'pE.si Di tri~'da.Di
Mas duas mulheres e um homem?	majs 'du.as mu'LE.riz i 'u~ 'o~.me~j~
E nenhum deles era branco?	i ne~'Ju~ 'de.liz 'E.ra 'bra~.ku
Mas por que ele havia presumido que Deus seria branco?	majs puX 'ke 'e.li a'vi.a pre.zu~'mi.du ki 'dews se'ri.a 'bra~.ku
Sabia que sua mente estava divagando, por isso concentrou-se na pergunta que mais queria ver respondida.	sa'bi.a ki 'su.a 'me~.Ti es'ta.va Di.va'ga~.du, pur 'i.su ko~.se~'trow si na peR'gu~.ta ki 'majs ke'ri.a 've.Res.po~'Di.da
Então qual de vocês é Deus?	e~'ta~w~ 'kwaw Di vo'sejz E 'dews
Eu, responderam os três em uníssono.	ew, Res.po~'de.ra~w~ us 'trejz e~j~ u~'ni.so~.nu
Mack olhou de um para o outro e, mesmo sem entender nada, de algum modo acreditou.	'mE.ki o'Low Di 'u~ 'pa.ra u 'ow.tru i, 'mez.mu se~j~ e~.te~'deR 'na.da, Di aw'gu~ 'mO.du a.kre.Di'tow
Não importa qual seja o poder de Deus, o primeiro aspecto de Deus jamais é o do Senhor absoluto, do Todo-Poderoso.	'na~w~ i~'pOX.ta 'kwaw 'se.Za u po'deR Di 'dews, u pri~'mej.ru as'pEk.tu Di 'dew.Za~'majz E u du se~'Jor ab.so'lu.tu, du 'to.du po.de'ro.zu
É o do Deus que se coloca no nosso nível humano e se limita.	E u du 'dews ki si ko'lO.ka nu 'nO.su 'ni.vew u~'ma~.nu i si li~'mi.ta
Mackenzie, não fique aí parado de boca aberta, disse a negra enorme enquanto se virava e seguia pela varanda, falando o tempo todo.	ma'ke~.zi, 'na~w~ 'fi.ki a'i pa'ra.du Di 'bo.ka a'bEX.ta, 'Di.si a 'ne.gra e~'nOR.mi e~'kwa~.tu si vi'ra.va i se'gi.a 'pe.la va'ra~.da, fa'la~.du u 'te~.pu 'to.du
Venha conversar comigo enquanto preparo a janta.	've~.Ja ko~.veX'saX ko~'mi.gu e~'kwa~.tu pre'pa.ru a 'Za~.ta
Ou, se não quiser, faça o que desejar.	ow, si 'na~w~ ki'zEX, 'fa.sa u ki de.ze'ZaX
Atrás do chalé, perto do abrigo de barcos, você vai encontrar uma vara de pesca que pode usar para pegar umas trutas.	a'trajs du Sa'lE, 'pEX.tu du a'bri.gu Di 'baX.kus, vo'se 'vaj e~.ko~'trar u~.ma 'va.ra Di 'pEs.ka ki 'pO.Di u'zaX 'pa.ra pe'gar u~.mas 'tru.tas
Ela parou junto à porta para dar um beijo em Jesus.	'E.la pa'row 'Zu~.tu a 'pOX.ta 'pa.ra 'dar u~ 'bej.Zu e~j~ Ze'zujs
Lembre apenas, e virou-se para olhar Mack, que você tem de limpar o que pegar.	'le~.bri a'pe~.nas, i vi'row si 'pa.ra o'LaR 'mE.ki, ki vo'se te~j~ Di li~'par u ki pe'gaX
Depois, com um sorriso rápido, desapareceu no chalé, carregando o casaco de inverno de Mack e segurando a arma pelos dois dedos, com o braço estendido.	de'pojs, ko~ u~ so'Ri.zu 'Ra.pi.du, de.za.pa.re'sew nu Sa'lE, ka.Re'ga~.du u ka'za.ku Di i~'vER.nu Di 'mE.ki i se.gu'ra~.du a 'aR.ma 'pe.lus 'dojs 'de.dus, ko~ u 'bra.su es.te~'Di.du
Mack ficou parado, de boca aberta e com uma expressão de perplexidade grudada no rosto.	'mE.ki fi'kow pa'ra.du, Di 'bo.ka a'bEX.ta i ko~ u~.ma es.pre'sa~w~ Di peX.plek.si'da.Di gru'da.da nu 'Ros.tu
Mal notou quando Jesus passou o braço por seu ombro.	'maw no'tow 'kwa~.du Ze'zujs pa'sow u 'bra.su puX 'sew 'o~.bru
Sarayu parecia ter simplesmente evaporado.	sa.ra'ju pa.re'si.a 'teX si~.pliz'me~.Ti e.va.po'ra.du
Ela não é fantástica? exclamou Jesus, rindo para Mack.	'E.la 'na~w~ E fa~'tas.Ti.ka, es.kla~'mow Ze'zujs, 'Ri~.du 'pa.ra 'mE.ki
Mack o encarou, balançando a cabeça.	'mE.ki u e~.ka'row, ba.la~'sa~.du a ka'be.sa
Estou ficando maluco?	es'tow fi'ka~.du ma'lu.ku
