Os  trovões  reluzem  Riscando  o  firmamento, Vocações  conduzem  Ao  acerto  de  um  invento,	us tro'vo~j~s Re'lu.ze~j~ Ris'ka~.du u fiR.ma~'me~.tu, vo.ka'so~j~s ko~'du.ze~j~ aw a'seX.tu Di u~ i~'ve~.tu
O erro é pra ser cometido, mas poucos sabem que o acerto também é uma escolha.	u 'e.Ru E pra 'seX ko~.me'Ti.du, majs 'pow.kus 'sa.be~j~ ki u a'seX.tu ta~'be~j~ E u~.ma es'ko.La
Tome o erro como um ponto de partida para o acerto.	'to~.mi u 'e.Ru 'ko~.mu u~ 'po~.tu Di paX'Ti.da 'pa.ra u a'seX.tu
Com os erros, tire  o aprendizado, e com os acerto, descubra como melhorá los.	ko~ uz 'e.Rus, 'Ti.ri u a.pre~.Di'za.du, i ko~ uz a'seX.tu, des'ku.bra 'ko~.mu me.Lo'ra lus
O erro muita das vezes, é o maior aprendizado, do quê o acerto.	u 'e.Ru 'mu~j~.ta das 've.zis, E u maj'Or a.pre~.Di'za.du, du 'ke u a'seX.tu
De tantos desacertos, uma hora torna-se acerto.	Di 'ta~.tus de.za'seX.tus, u~.ma 'O.ra 'tOR.na si a'seX.tu
Torça pelo acerto do outro, nunca pelo erro do outro.	'toX.sa 'pe.lu a'seX.tu du 'ow.tru, 'nu~.ka 'pe.lu 'e.Ru du 'ow.tru
Quando acerto com ela ganho felicidade pro mês todo, garota me deixa acertar mais, me deixa chegar mais perto.	'kwa~.du a'sEX.tu ko~ 'E.la 'ga~.Ju fe.li.si'da.Di pru 'mejs 'to.du, ga'ro.ta mi 'dej.Sa a.seX'taR 'majs, mi 'dej.Sa Se'gaR 'majs 'pEX.tu
ame as noites tão bem quanto ama as manhãs. perdoe os erros tão bem quanto contempla os acertos, pois amar vai além de apreciar as qualidades; é também aceitar os defeitos.	'a~.mi as 'noj.Tis 'ta~w~ 'be~j~ 'kwa~.tu 'a~.ma as ma~'Ja~j~s, peR'do.i uz 'e.Rus 'ta~w~ 'be~j~ 'kwa~.tu ko~'te~.pla uz a'seX.tus, 'pojz a~'maR 'vaj a'le~j~ Di a.pre.si'ar as kwa.li'da.Dis, E ta~'be~j~ a.sej'tar us de'fej.tus
Os olhos do vencedor não estão no acerto dos seus oponentes e sim nos erros que cometeram.	uz 'O.Lus du ve~.se'doR 'na~w~ es'ta~w~ nu a'seX.tu dus 'sewz o.po~'ne~.Tiz i 'si~ nuz 'e.Rus ki ko~.me'te.ra~w~
Melhor simulador que existe chama se pensamento, onde podemos errar, para encontrar acerto com êxito.	me'LOX si~.mu.la'doX ki e'zis.Ti 'Sa~.ma si pe~.sa~'me~.tu, 'o~.Di po'de~.muz e'RaX, 'pa.ra e~.ko~'trar a'seX.tu ko~ 'e.zi.tu
Aja antes de falar e, portanto, fale de acordo com os seus atos.	'a.Za 'a~.Tis Di fa'lar i, poX'ta~.tu, 'fa.li Di a'koR.du ko~ us 'sewz 'a.tus
Temos o destino que merecemos. O nosso destino está de acordo com os nossos méritos.	'te~.muz u des'Ti~.nu ki me.re'se~.mus, u 'nO.su des'Ti~.nu es'ta Di a'koR.du ko~ us 'nO.sus 'mE.ri.tus
Se vives de acordo com as leis da natureza, nunca serás pobre; se vives de acordo com as opiniões alheias, nunca serás rico.	si 'vi.vis Di a'koR.du ko~ as 'lejs da na.tu're.za, 'nu~.ka se'rajs 'pO.bri, si 'vi.vis Di a'koR.du ko~ az o.pi~.ni'o~j~z a'Lej.as, 'nu~.ka se'rajs 'Ri.ku
Homem superior é aquele que começa por pôr em prática as suas palavras e em seguida fala de acordo com as suas ações.	'o~.me~j~ su.pe.ri'or E a'ke.li ki ko~'mE.sa puX 'por e~j~ 'pra.Ti.ka as 'su.as pa'la.vraz i e~j~ se'gi.da 'fa.la Di a'koR.du ko~ as 'su.az a'so~j~s
A História é um conjunto de mentiras sobre as quais se chegou a um acordo.	a is'tO.rja E u~ ko~'Zu~.tu Di me~'Ti.ras 'so.bri as 'kwajs si Se'gow a u~ a'koR.du
Não devemos moldar os filhos de acordo com os nossos sentimentos, devemos tê-los e amá-los do modo como nos foram dados por Deus.	'na~w~ de've~.mus mow'dar us 'fi.Lus Di a'koR.du ko~ us 'nO.sus se~.Ti~'me~.tus, de've~.muz 'te luz i a~'ma lus du 'mO.du 'ko~.mu nus 'fo.ra~w~ 'da.dus puR 'dews
A paz não é um estado primitivo paradisíaco, nem uma forma de convivência regulada pelo acordo. A paz é algo que não conhecemos, que apenas buscamos e imaginamos. A paz é um ideal.	a 'pajz 'na~w~ E u~ es'ta.du pri~.mi'Ti.vu pa.ra.Di'zi.a.ku, ne~j~ u~.ma 'fOR.ma Di ko~.vi've~.sja Re.gu'la.da 'pe.lu a'koR.du, a 'pajz E 'aw.gu ki 'na~w~ ko~.Je'se~.mus, ki a'pe~.nas bus'ka~.muz i i~.ma.Zi~'na~.mus, a 'pajz E u~ i.de'aw
A beleza é o acordo entre o conteúdo e a forma.	a be'le.za E u a'koR.du 'e~.tri u ko~.te'u.du i a 'fOR.ma
A tragédia e a sátira são irmãs e estão sempre de acordo; consideradas ao mesmo tempo recebem o nome de verdade.	a tra'ZE.Dja i a 'sa.Ti.ra 'sa~w~ iR'ma~j~z i es'ta~w~ 'se~.pri Di a'koR.du, ko~.si.de'ra.daz aw 'mez.mu 'te~.pu Re'sE.be~j~ u 'no~.mi Di veR'da.Di
Ninguém quer o bem público que não está de acordo com o seu.	ni~'ge~j~ 'kEr u 'be~j~ 'pu.bli.ku ki 'na~w~ es'ta Di a'koR.du ko~ u 'sew
Eu componho de acordo com as circunstâncias em que estou envolvido, seja de ácido ou na água.	ew ko~'po~.Ju Di a'koR.du ko~ as siX.ku~s'ta~.sjaz e~j~ ki es'tow e~.vow'vi.du, 'se.Za Di 'a.si.du ow na 'a.gwa
Feliz aquele que reconhece a tempo que os seus desejos não estão de acordo com as suas faculdades.	fe'liz a'ke.li ki Re.ko~'JE.si a 'te~.pu ki us 'sews de'ze.Zus 'na~w~ es'ta~w~ Di a'koR.du ko~ as 'su.as fa.kuw'da.Dis
Mesmo quando todos os especialistas estão de acordo podem muito bem estar enganados.	'mez.mu 'kwa~.du 'to.duz uz es.pe.si.a'lis.taz es'ta~w~ Di a'koR.du 'pO.de~j~ 'mu~j~.tu 'be~j~ es'tar e~.ga~'na.dus
O caráter é a soma de milhares de pequenos esforços para viver de acordo com o que de melhor há em nós.	u ka'ra.ter E a 'so~.ma Di mi'La.ris Di pe'ke~.nuz es'fOX.sus 'pa.ra vi'veR Di a'koR.du ko~ u ki Di me'LOr 'a e~j~ 'nOjs
Seja feliz do jeito que você é, não mude sua rotina pelo o que os outros exigem de você, simplesmente viva de acordo com o seu modo de viver.	'se.Za fe'liz du 'Zej.tu ki vo'se E, 'na~w~ 'mu.Di 'su.a Ro'Ti~.na 'pe.lu u ki uz 'ow.truz e'zi.Ze~j~ Di vo'se, si~.pliz'me~.Ti 'vi.va Di a'koR.du ko~ u 'sew 'mO.du Di vi'veX
Uma reunião em que todos os presentes estão absolutamente de acordo, é uma reunião perdida.	u~.ma Re.u~.ni'a~w~ e~j~ ki 'to.duz us pre'ze~.Tiz es'ta~w~ ab.so.lu.ta~'me~.Ti Di a'koR.du, E u~.ma Re.u~.ni'a~w~ peR'Di.da
Se uma planta não consegue viver de acordo com sua natureza, ela morre, assim também um homem.	si u~.ma 'pla~.ta 'na~w~ ko~'sE.gi vi'veR Di a'koR.du ko~ 'su.a na.tu're.za, 'E.la 'mO.Ri, a'si~ ta~'be~j~ u~ 'o~.me~j~
O amor é uma doença. Eu sinto náuseas, febres, dores musculares. Eu acordo assustada no meio da noite. Eu choro à toa.	u a~'mor E u~.ma do'e~.sa, ew 'si~.tu 'naw.zeas, 'fE.bris, 'do.ris mus.ku'la.ris, ew a'kOR.du a.sus'ta.da nu 'mej.u da 'noj.Ti, ew 'SO.ru a 'to.a
Todos os dias, quando acordo, vou correndo tirar a poeira da palavra amor...	'to.duz us 'Di.as, 'kwa~.du a'kOR.du, 'vow ko'Re~.du Ti'rar a po'ej.ra da pa'la.vra a~'moX
Fiz um acordo de coexistência pacífica com o tempo: Nem ele me persegue, nem eu fujo dele, um dia a gente se encontra.	'fiz u~ a'koR.du Di ko.e.zis'te~.sja pa'si.fi.ka ko~ u 'te~.pu, ne~j~ 'e.li mi peX'sE.gi, ne~j~ ew 'fu.Zu 'de.li, u~ 'Di.a a 'Ze~.Ti si e~'ko~.tra
A habilidade de alcançar a vitória mudando e adaptando-se de acordo com o inimigo é chamada de genialidade.	a a.bi.li'da.Di Di aw.ka~'sar a vi'tO.rja mu'da~.du i a.dap'ta~.du si Di a'koR.du ko~ u i~.ni~'mi.gu E Sa~'ma.da Di Ze~.ni.a.li'da.Di
Eu acordo toda manhã. Abro os olhos e penso: lá vamos nós de novo.	ew a'kOR.du 'to.da ma~'Ja~, 'a.bru uz 'O.Luz i 'pe~.su, 'la 'va~.mus 'nOjs Di 'no.vu
Quem assume sua verdade age de acordo com os valores da vida, mesmo enfrentando o preconceito e pagando o preço de ser diferente, passa credibilidade, obtém respeito e se realiza.	'ke~j~ a'su~.mi 'su.a veR'da.Di 'a.Zi Di a'koR.du ko~ us va'lo.ris da 'vi.da, 'mez.mu e~.fre~'ta~.du u pre.ko~'sej.tu i pa'ga~.du u 'pre.su Di 'seR Di.fe're~.Ti, 'pa.sa kre.Di.bi.li'da.Di, ob'te~j~ Res'pej.tu i si Re.a'li.za
Um corpo perfeito Porque era assim que a humanidade devia ser de acordo com o plano divino: como os músicos de uma única orquestra, como os órgãos de um único corpo.	u~ 'koX.pu peX'fej.tu puX'ke 'E.ra a'si~ ki a u~.ma~.ni'da.Di de'vi.a 'seR Di a'koR.du ko~ u 'pla~.nu Di'vi~.nu, 'ko~.mu us 'mu.zi.kus Di u~.ma 'u~.ni.ka oX'kEs.tra, 'ko~.mu uz 'OR.ga~w~s Di u~ 'u~.ni.ku 'koX.pu
O homem superior age antes de falar e depois fala de acordo com suas ações.	u 'o~.me~j~ su.pe.ri'or 'a.Zi 'a~.Tis Di fa'lar i de'pojs 'fa.la Di a'koR.du ko~ 'su.az a'so~j~s
Apavorado acordo, em treva. O luar É como o espectro do meu sonho em mim E sem destino, e louco, sou o mar Patético, sonâmbulo e sem fim.	a.pa.vo'ra.du a'kOR.du, e~j~ 'trE.va, u lu'ar E 'ko~.mu u es'pEk.tru du 'mew 'so~.Ju e~j~ 'mi~ i se~j~ des'Ti~.nu, i 'low.ku, 'sow u 'maX pa'tE.Ti.ku, so~'na~.bu.lu i se~j~ 'fi~
Suas atitudes são responsáveis pelo seu destino, de acordo com o ponto de vista que você escolheu.	'su.az a.Ti'tu.Dis 'sa~w~ Res.po~'sa.vejs 'pe.lu 'sew des'Ti~.nu, Di a'koR.du ko~ u 'po~.tu Di 'vis.ta ki vo'se es.ko'Lew
Todos os dias quando acordo, a primeira coisa que faço é sentir a sua falta.	'to.duz us 'Di.as 'kwa~.du a'kOR.du, a pri~'mej.ra 'koj.za ki 'fa.su E se~'Tir a 'su.a 'faw.ta
Se você tratar as pessoas como irmãos ou irmãs, eles respondem de acordo.	si vo'se tra'tar as pe'so.as 'ko~.mu iR'ma~w~z ow iR'ma~j~s, 'e.lis Res'po~.de~j~ Di a'koR.du
Tem dia que eu durmo pensando em você e tem dia que eu acordo pensando em você.	te~j~ 'Di.a ki ew 'duR.mu pe~'sa~.du e~j~ vo'se i te~j~ 'Di.a ki ew a'kOR.du pe~'sa~.du e~j~ vo'se
A marca da sabedoria é ler corretamente o presente e marchar de acordo com a ocasião.	a 'maX.ka da sa.be.do'ri.a E 'leX ko.Re.ta~'me~.Ti u pre'ze~.Ti i maX'SaR Di a'koR.du ko~ a o.ka.zi'a~w~
Acordo com a voz safada de Cazuza repetindo em minha orelha fria: quem tem um sonho não dança, meu amor.	a'kOR.du ko~ a 'vOjs sa'fa.da Di ka'zu.za Re.pe'Ti~.du e~j~ 'mi~.Ja o're.La 'fri.a, 'ke~j~ te~j~ u~ 'so~.Ju 'na~w~ 'da~.sa, 'mew a~'moX
Acima de todas as liberdades, dê-me a de saber, de me expressar, de debater com autonomia, de acordo com minha consciência.	a'si~.ma Di 'to.daz as li.beR'da.Dis, 'de mi a Di sa'beX, Di mi es.pre'saX, Di de.ba'teX ko~ aw.to~.no~'mi.a, Di a'koR.du ko~ 'mi~.Ja ko~.si'e~.sja
A vida se espande ou se encolhe de acordo com a nossa coragem.	a 'vi.da si es'pa~.Di ow si e~'kO.Li Di a'koR.du ko~ a 'nO.sa ko'ra.Ze~j~
De cada um, de acordo com suas habilidades; a cada um, de acordo com suas necessidades.	Di 'ka.da 'u~, Di a'koR.du ko~ 'su.az a.bi.li'da.Dis, a 'ka.da 'u~, Di a'koR.du ko~ 'su.as ne.se.si'da.Dis
A sua mente age de acordo com o alimento que recebe.	a 'su.a 'me~.Ti 'a.Zi Di a'koR.du ko~ u a.li~'me~.tu ki Re'sE.bi
As ações devem ser julgadas de acordo com as intenções.	az a'so~j~s 'dE.ve~j~ 'seR Zuw'ga.das Di a'koR.du ko~ az i~.te~'so~j~s
Quando a propósito de uma ideia se diz que se está em princípio de acordo, isso significa que não se tem a menor intenção de a pôr em prática.	'kwa~.du a pro'pO.zi.tu Di u~.ma i'dEj.a si 'Dis ki si es'ta e~j~ pri~'si.pju Di a'koR.du, 'i.su si.gi~.ni'fi.ka ki 'na~w~ si te~j~ a me~'nOr i~.te~'sa~w~ Di a 'por e~j~ 'pra.Ti.ka
Não pode haver senão vantagem num acordo e prejuízo num conflito.	'na~w~ 'pO.Di a'veX se~'na~w~ va~'ta.Ze~j~ nu~ a'koR.du i pre.Zu'i.zu nu~ ko~'fli.tu
Não tem crença quem não vive de acordo com a sua crença.	'na~w~ te~j~ 'kre~.sa 'ke~j~ 'na~w~ 'vi.vi Di a'koR.du ko~ a 'su.a 'kre~.sa
O gênio estabelece o acordo entre o mundo em que vive e o mundo que nele vive.	u 'Ze~.nju es.ta.be'lE.si u a'koR.du 'e~.tri u 'mu~.du e~j~ ki 'vi.vi i u 'mu~.du ki 'ne.li 'vi.vi
Faço as malas, abraço os amigos, embarco em um navio e finalmente acordo em Nápoles; e ali, a meu lado, vejo o Fato Sombrio, o Eu Triste, implacável, idêntico, do qual eu fugira.	'fa.su as 'ma.las, a'bra.su uz a~'mi.gus, e~'baX.ku e~j~ u~ na'vi.u i fi~.naw'me~.Ti a'kOR.du e~j~ 'na.po.lis, i a'li, a 'mew 'la.du, 've.Zu u 'fa.tu so~'bri.u, u ew 'tris.Ti, i~.pla'ka.vew, i'de~.Ti.ku, du 'kwaw ew fu'Zi.ra
Todos os dias quando acordo, não tenho mais o tempo que passou.	'to.duz us 'Di.as 'kwa~.du a'kOR.du, 'na~w~ 'te~.Ju 'majz u 'te~.pu ki pa'sow
Isso me apavora, o nunca mais que me persegue desde o momento em que acordo e que me dá medo e que me faz voltar a ser criança, medo de nunca mais viver o que vivi, sentir o que senti.	'i.su mi a.pa'vO.ra, u 'nu~.ka 'majs ki mi peX'sE.gi 'dez.Di u mo~'me~.tu e~j~ ki a'kOR.du i ki mi 'da 'me.du i ki mi 'fajz vow'tar a 'seX kri'a~.sa, 'me.du Di 'nu~.ka 'majs vi'ver u ki vi'vi, se~'Tir u ki se~'Ti
Todos os dias quando acordo Não tenho mais O tempo que passou Mas tenho muito tempo Temos todo o tempo do mundo...	'to.duz us 'Di.as 'kwa~.du a'kOR.du 'na~w~ 'te~.Ju 'majz u 'te~.pu ki pa'sow majs 'te~.Ju 'mu~j~.tu 'te~.pu 'te~.mus 'to.du u 'te~.pu du 'mu~.du
Quando você defende publicamente suas ideias, terá que se esforçar para viver de acordo com elas.	'kwa~.du vo'se de'fe~.Di pu.bli.ka~'me~.Ti 'su.az i'dEj.as, te'ra ki si es.foX'saX 'pa.ra vi'veR Di a'koR.du ko~ 'E.las
Se não deu certo hoje, amanhã eu acordo mais cedo, preparo meu mate e tento de novo!	si 'na~w~ 'dew 'sEX.tu 'o.Zi, a~.ma~'Ja~ ew a'kOR.du 'majs 'se.du, pre'pa.ru 'mew 'ma.Ti i 'te~.tu Di 'no.vu
Eu sei que todos os dias quando eu acordo Deus dá um sorriso e me diz: Estou te dando a chance de tentar de novo.	ew 'sej ki 'to.duz us 'Di.as 'kwa~.du ew a'kOR.du 'dews 'da u~ so'Ri.zu i mi 'Dis, es'tow Ti 'da~.du a 'Sa~.si Di te~'taR Di 'no.vu
Devemos promover a coragem onde há medo, promover o acordo onde existe conflito, e inspirar esperança onde há desespero.	de've~.mus pro~.mo'ver a ko'ra.Ze~j~ 'o~.Di 'a 'me.du, pro~.mo'ver u a'koR.du 'o~.Di e'zis.Ti ko~'fli.tu, i i~s.pi'rar es.pe'ra~.sa 'o~.Di 'a de.zes'pe.ru
Toda noite quando durmo, morro. E todo dia quando acordo, renasço.	'to.da 'noj.Ti 'kwa~.du 'duR.mu, 'mo.Ru, i 'to.du 'Di.a 'kwa~.du a'kOR.du, Re~'na.su
Deixem que o futuro diga a verdade e avalie cada um de acordo com o seu trabalho e realizações. O presente pertence a eles, mas o futuro pelo qual eu sempre trabalhei pertence a mim.	'dej.Se~j~ ki u fu'tu.ru 'Di.ga a veR'da.Di i a.va'li.i 'ka.da 'u~ Di a'koR.du ko~ u 'sew tra'ba.Lu i Re.a.li.za'so~j~s, u pre'ze~.Ti peX'te~.si a 'e.lis, majz u fu'tu.ru 'pe.lu 'kwaw ew 'se~.pri tra.ba'Lej peX'te~.si a 'mi~
Simplesmente viva de acordo com o seu modo de viver. O que os outros pensam é problema deles.	si~.pliz'me~.Ti 'vi.va Di a'koR.du ko~ u 'sew 'mO.du Di vi'veX, u ki uz 'ow.trus 'pe~.sa~w~ E pro'ble~.ma 'de.lis
A justiça de Deus, é tão divina que ensina a cada um de acordo com seus atos.	a Zus'Ti.sa Di 'dews, E 'ta~w~ Di'vi~.na ki e~'si~.na a 'ka.da 'u~ Di a'koR.du ko~ 'sewz 'a.tus
Tenho medo de que tudo seja uma mentira e de verdade sinto que é, mas ainda acordo feliz todos os dias esperando que ao menos você seja verdade.	'te~.Ju 'me.du Di ki 'tu.du 'se.Za u~.ma me~'Ti.ra i Di veR'da.Di 'si~.tu ki E, majz a'i~.da a'kOR.du fe'lis 'to.duz us 'Di.az es.pe'ra~.du ki aw 'me~.nus vo'se 'se.Za veR'da.Di
Viver de acordo com as expectativas dos outros é suicídio.	vi'veR Di a'koR.du ko~ az es.pek.ta'Ti.vas duz 'ow.truz E suj'si.Dju
A guitarra é como a mulher amada, ela responde de acordo com a intensidade que é tocada.	a gi'ta.Ra E 'ko~.mu a mu'LEr a~'ma.da, 'E.la Res'po~.Di Di a'koR.du ko~ a i~.te~.si'da.Di ki E to'ka.da
Mas de agora em diante, Do momento que eu acordo, Ao momento em que eu durmo, Estarei lá ao seu lado, É só você tentar e me parar, Estarei esperando na fila, Só para ver se você se importa.	majs Di a'gO.ra e~j~ Di'a~.Ti, du mo~'me~.tu ki ew a'kOR.du, aw mo~'me~.tu e~j~ ki ew 'duR.mu, es.ta'rej 'la aw 'sew 'la.du, E 'sO vo'se te~'tar i mi pa'raX, es.ta'rej es.pe'ra~.du na 'fi.la, 'sO 'pa.ra 'veX si vo'se si i~'pOX.ta
Não somos diplomatas mas profetas, e nossa mensagem não é um acordo mas um ultimato.	'na~w~ 'so~.mus Di.plo~'ma.tas majs pro'fE.tas, i 'nO.sa me~'sa.Ze~j~ 'na~w~ E u~ a'koR.du majz u~ uw.Ti~'ma.tu
Se não estiver de acordo, seja ao menos leal, fale lentamente mas pense com rapidez!	si 'na~w~ es.Ti'vER Di a'koR.du, 'se.Za aw 'me~.nus le'aw, 'fa.li le~.ta~'me~.Ti majs 'pe~.si ko~ Ra.pi'dejs
Desde o século XVIII que aquilo que sabemos já não está de acordo com aquilo em que acreditamos.	'dez.Di u 'sE.ku.lu de'zoj.tu ki a'ki.lu ki sa'be~.mu'Za 'na~w~ es'ta Di a'koR.du ko~ a'ki.lu e~j~ ki a.kre.Di'ta~.mus
A espécie humana, de acordo com a melhor teoria, é composta por duas raças distintas: os homens que emprestam e os homens que pedem emprestado.	a es'pE.si u~'ma~.na, Di a'koR.du ko~ a me'LOX te.o'ri.a, E ko~'pOs.ta puR 'du.as 'Ra.sas Dis'Ti~.tas, uz 'o~.me~s ki e~'prEs.ta~w~ i uz 'o~.me~s ki 'pE.de~j~ e~.pres'ta.du
Estou sempre de acordo com os eruditos, se são os primeiros a falar.	es'tow 'se~.pri Di a'koR.du ko~ uz e.ru'Di.tus, si 'sa~w~ us pri~'mej.ruz a fa'laX
Acordo molhado de suor - O sonho do banho No tanque do quintal!	a'kOR.du mo'La.du Di su'OX, u 'so~.Ju du 'ba~.Ju nu 'ta~.ki du ki~'taw
De acordo a ocasião, vendo o almoço para comprar a janta.	Di a'koR.du a o.ka.zi'a~w~, 've~.du u aw'mo.su 'pa.ra ko~'prar a 'Za~.ta
O Mundo não se fez para pensarmos nele, mas para olharmos para ele e estarmos de acordo...	u 'mu~.du 'na~w~ si 'fejs 'pa.ra pe~'saR.mus 'ne.li, majs 'pa.ra o'LaR.mus 'pa.ra 'e.li i es'taR.mus Di a'koR.du
Enquanto tu dormes, eu vigio. Mas não sei se eu te acordo à hora chegada da imensa luz, ou se eu te deixo na paz de teus sonhos para sempre...	e~'kwa~.tu 'tu 'dOR.mis, ew vi'Zi.u, majs 'na~w~ 'sej si ew Ti a'kOR.du a 'O.ra Se'ga.da da i~'me~.sa 'lujs, ow si ew Ti 'dej.Su na 'pajz Di 'tews 'so~.Jus 'pa.ra 'se~.pri
Meu primeiro pensamento será um clássico pra mim. Todos os dias quando acordo, Não tenho mais o tempo que passou Mas tenho muito tempo Temos todo o tempo do mundo.	'mew pri~'mej.ru pe~.sa~'me~.tu se'ra u~ 'kla.si.ku pra 'mi~, 'to.duz us 'Di.as 'kwa~.du a'kOR.du, 'na~w~ 'te~.Ju 'majz u 'te~.pu ki pa'sow majs 'te~.Ju 'mu~j~.tu 'te~.pu 'te~.mus 'to.du u 'te~.pu du 'mu~.du
Tem uma coisa dentro de mim que continua dormindo quando eu acordo, lá longe de mim.	te~j~ u~.ma 'koj.za 'de~.tru Di 'mi~ ki ko~.Ti~'nu.a doR'mi~.du 'kwa~.du ew a'kOR.du, 'la 'lo~.Zi Di 'mi~
A minha forma de agir de acordo com cada situação, pensar e mudar de idéia de acordo com cada decisão.	a 'mi~.Ja 'fOR.ma Di a'ZiR Di a'koR.du ko~ 'ka.da si.tu.a'sa~w~, pe~'sar i mu'daR Di i'dEj.a Di a'koR.du ko~ 'ka.da de.si'za~w~
de acordo com a lei de Deus, eu sou um criminoso de alta perigosidade. Porque eu me vejo oposição a todos os seus mandamentos.	Di a'koR.du ko~ a 'lej Di 'dews, ew 'sow u~ kri~.mi~'no.zu Di 'aw.ta pe.ri.go.zi'da.Di, puX'ke ew mi 've.Zu o.po.zi'sa~w~ a 'to.duz us 'sews ma~.da~'me~.tus
Sem a espada os acordos são só palavras.	se~j~ a es'pa.da uz a'koR.dus 'sa~w~ 'sO pa'la.vras
Todos são sábios, de acordo com seus próprios conhecimentos e perspicácia.	'to.dus 'sa~w~ 'sa.bjus, Di a'koR.du ko~ 'sews 'prO.prjus ko~.Je.si~'me~.tuz i peXs.pi'ka.sja
O importante é ser feliz de acordo com o tempo, o presente nos completa, e Deus faz nosso futuro, e nós apenas seguimos o destino que tem que ser.	u i~.poX'ta~.Ti E 'seX fe'liz Di a'koR.du ko~ u 'te~.pu, u pre'ze~.Ti nus ko~'plE.ta, i 'dews 'fajz 'nO.su fu'tu.ru, i 'nOjz a'pe~.nas se'gi~.muz u des'Ti~.nu ki te~j~ ki 'seX
Você não tem responsabilidade de viver de acordo com o que os outros pensam que você deve realizar. Eu não tenho responsabilidade de ser como eles esperam que eu seja.	vo'se 'na~w~ te~j~ Res.po~.sa.bi.li'da.Di Di vi'veR Di a'koR.du ko~ u ki uz 'ow.trus 'pe~.sa~w~ ki vo'se 'dE.vi Re.a.li'zaX, ew 'na~w~ 'te~.Ju Res.po~.sa.bi.li'da.Di Di 'seX 'ko~.mu 'e.liz es'pE.ra~w~ ki ew 'se.Za
Toda noite, quando eu vou dormir, morro. E, na manhã seguinte, quando acordo, renasço.	'to.da 'noj.Ti, 'kwa~.du ew 'vow doR'miX, 'mo.Ru, i, na ma~'Ja~ se'gi~.Ti, 'kwa~.du a'kOR.du, Re~'na.su
A cada dia que acordo com o Sol batendo na minha janela, percebo e agradeço a Deus pela dádiva de mais um dia de vida neste planeta maravilhoso.	a 'ka.da 'Di.a ki a'kOR.du ko~ u 'sOw ba'te~.du na 'mi~.Ja Za~'nE.la, peX'se.bu i a.gra'de.su a 'dews 'pe.la 'da.Di.va Di 'majz 'u~ 'Di.a Di 'vi.da 'nes.Ti pla~'ne.ta ma.ra.vi'Lo.zu
Não sou princesa, acordo descabelada. Sou desastrada. Não sei rir baixo e não respiro pra falar. Sou assim, sei lá...	'na~w~ 'sow pri~'se.za, a'kOR.du des.ka.be'la.da, 'sow de.zas'tra.da, 'na~w~ 'sej 'RiR 'baj.Su i 'na~w~ Res'pi.ru pra fa'laX, 'sow a'si~, 'sej 'la
Quando estou quase saciando meus desejos mais ocultos e proibidos, acordo! Nem em sonho você é possível pra mim.	'kwa~.du es'tow 'kwa.zi sa.si'a~.du 'mews de'ze.Zus 'majz o'kuw.tuz i proj'bi.dus, a'kOR.du, ne~j~ e~j~ 'so~.Ju vo'se E po'si.vew pra 'mi~
Não acordo entre Homens e Leões	'na~w~ a'kOR.du 'e~.tri 'o~.me~z i le'o~j~s
O homem correto faz antes de falar; apenas depois, fala de acordo com aquilo que fez.	u 'o~.me~j~ ko'RE.tu 'fajz 'a~.Tis Di fa'laX, a'pe~.nas de'pojs, 'fa.la Di a'koR.du ko~ a'ki.lu ki 'fejs
Eu te amo tanto, que pela madrugada acordo dizendo : como você me tira o sono.	ew Ti 'a~.mu 'ta~.tu, ki 'pe.la ma.dru'ga.da a'kOR.du Di'ze~.du, 'ko~.mu vo'se mi 'Ti.ra u 'so~.nu
Eu sou uma mulher guerreira, que todo dia acordo muito bela, confiante e disposta a viver a vida dignamente, com muito amor e muita fé em Deus. Ele é o meu guia e o meu maior protetor!	ew 'sow u~.ma mu'LER ge'Rej.ra, ki 'to.du 'Di.a a'kOR.du 'mu~j~.tu 'bE.la, ko~.fi'a~.Ti i Dis'pOs.ta a vi'ver a 'vi.da Di.gi~.na~'me~.Ti, ko~ 'mu~j~.tu a~'mor i 'mu~j~.ta 'fE e~j~ 'dews, 'e.li E u 'mew 'gi.a i u 'mew maj'OX pro.te'toX
Quando o pecador crê que Cristo é seu Salvador pessoal, então, de acordo com as Suas promessas infalíveis, Deus lhe perdoa o pecado e o justifica livremente.	'kwa~.du u pe.ka'doX 'kre ki 'kris.tu E 'sew saw.va'doX pe.so'aw, e~'ta~w~, Di a'koR.du ko~ as 'su.as pro~'mE.saz i~.fa'li.vejs, 'dews Li peR'do.a u pe'ka.du i u Zus.Ti'fi.ka li.vri~'me~.Ti
A sabedoria é como uma flor, de onde a abelha faz o mel e a aranha faz o veneno, cada uma de acordo com a sua própria natureza.	a sa.be.do'ri.a E 'ko~.mu u~.ma 'floX, Di 'o~.Di a a'be.La 'fajz u 'mEw i a a'ra~.Ja 'fajz u ve~'ne~.nu, 'ka.da u~.ma Di a'koR.du ko~ a 'su.a 'prO.prja na.tu're.za
Deus não muda seus preceitos de acordo com as mudanças sociais ou com a modernidade do homem. O que era pecado ontem, continua sendo pecado hoje e ainda continuará sendo até o final dos tempos.	'dews 'na~w~ 'mu.da 'sews pre'sej.tus Di a'koR.du ko~ as mu'da~.sas so.si'ajz ow ko~ a mo.deR.ni'da.Di du 'o~.me~j~, u ki 'E.ra pe'ka.du 'o~.te~j~, ko~.Ti~'nu.a 'se~.du pe'ka.du 'o.Zi i a'i~.da ko~.Ti~.nu.a'ra 'se~.du a'tE u fi~'naw dus 'te~.pus
Tento Esquecer-te; Fazê-la Apenas Uma Imagem Amigável é Complexo. Acordo Pensando, Durmo Sonhando. Talvez Ilusão; Talvez Paixão. É Preciso Um Lampião Para Clarear Essa Escuridão.	'te~.tu es.ke'seX Ti, fa'ze la a'pe~.naz u~.ma i~'ma.Ze~j~ a~.mi'ga.vew E ko~'plEk.su, a'kOR.du pe~'sa~.du, 'duR.mu so~'Ja~.du, taw'vejz i.lu'za~w~, taw'vejs paj'Sa~w~, E pre'si.zu u~ la~.pi'a~w~ 'pa.ra kla.re'ar 'E.sa es.ku.ri'da~w~
Eu acordo pensando em você Eu passo o dia inteiro pensando em você Eu não paro de pensar em você  Quando não te vejo Em meu coração sinto Uma dor Isso não é loucura  É amor!	ew a'kOR.du pe~'sa~.du e~j~ vo'se ew 'pa.su u 'Di.a i~'tej.ru pe~'sa~.du e~j~ vo'se ew 'na~w~ 'pa.ru Di pe~'sar e~j~ vo'se 'kwa~.du 'na~w~ Ti 've.Zu e~j~ 'mew ko.ra'sa~w~ 'si~.tu u~.ma 'dor 'i.su 'na~w~ E low'ku.ra E a~'moX
Quem vive de desculpas, faz um acordo com a derrota	'ke~j~ 'vi.vi Di des'kuw.pas, 'fajz u~ a'koR.du ko~ a de'RO.ta
Eu crio minhas próprias teorias, e vou agir de acordo com o que eu acredito!	ew 'kri.u 'mi~.Jas prO'pri.as te.o'ri.as, i 'vow a'ZiR Di a'koR.du ko~ u ki ew a.kre'Di.tu
Quando acordo já não existe um passado ou um futuro apenas existe um presente...	'kwa~.du a'kOR.du 'Za 'na~w~ e'zis.Ti u~ pa'sa.du ow u~ fu'tu.ru a'pe~.naz e'zis.Ti u~ pre'ze~.Ti
Todo o dia eu acordo sabendo que quanto mais vidas eu tento salvar mais inimigos eu faço e é só uma questão de tempo até que eu encontre aqueles com mais poder do que eu posso lidar.	'to.du u 'Di.a ew a'kOR.du sa'be~.du ki 'kwa~.tu 'majs 'vi.daz ew 'te~.tu saw'vaR 'majz i~.ni~'mi.guz ew 'fa.su i E 'sO u~.ma kes'ta~w~ Di 'te~.pu a'tE ki ew e~'ko~.tri a'ke.lis ko~ 'majs po'deR du ki ew 'pO.su li'daX
Quando violamos o acordo do casamento, violamos o desígnio de Deus para nós.	'kwa~.du vi.o'la~.muz u a'koR.du du ka.za~'me~.tu, vi.o'la~.muz u de'zi.gi~.nju Di 'dews 'pa.ra 'nOjs
Quando acordo pela manhã, escuto a voz de Deus, dizendo vai em frente, enfrenta esse dia, que achas que vai ser difícil que eu te capacito. Bom dia, lembra que sou teu pai, jamais te abandono!	'kwa~.du a'kOR.du 'pe.la ma~'Ja~, es'ku.tu a 'vOjz Di 'dews, Di'ze~.du 'vaj e~j~ 'fre~.Ti, e~'fre~.ta 'e.si 'Di.a, ki 'a.Sas ki 'vaj 'seR Di'fi.siw ki ew Ti ka.pa'si.tu, 'bo~ 'Di.a, 'le~.bra ki 'sow 'tew 'paj, Za~'majs Ti a.ba~'do~.nu
Assim como o percurso de um rio, a vida se molda no seu decorrer de acordo com o ambiente.	a'si~ 'ko~.mu u peX'kuX.su Di u~ 'Ri.u, a 'vi.da si 'mOw.da nu 'sew de.ko'ReR Di a'koR.du ko~ u a~.bi'e~.Ti
O universo responde de acordo com o que fazemos, quando nós amamos e cuidamos dos outros, recebemos amor e cuidado de volta.	u u~.ni'vEX.su Res'po~.Di Di a'koR.du ko~ u ki fa'ze~.mus, 'kwa~.du 'nOjz a~'ma~.muz i kuj'da~.mus duz 'ow.trus, Re.se'be~.muz a~'mor i kuj'da.du Di 'vOw.ta
Meio sol, meio lua, Acordo cedo para ouvir os passarinhos. Durmo tarde pra apreciar a lua.	'mej.u 'sOw, 'mej.u 'lu.a, a'kOR.du 'se.du 'pa.ra ow'vir us pa.sa'ri~.Jus, 'duR.mu 'taR.Di pra a.pre.si'ar a 'lu.a
Então pra quê? Pra quem? Porquê? Porque acordo todos os dias? Se eu sinto prazer em escrever é para que alguém leia. Alguém que certamente vai me magoar um dia. E vai embora.	e~'ta~w~ pra 'ke, pra 'ke~j~, puX'ke, puX'ke a'kOR.du 'to.duz us 'Di.as, si ew 'si~.tu pra'zer e~j~ es.kre'ver E 'pa.ra ki aw'ge~j~ 'lej.a, aw'ge~j~ ki sEX.ta~'me~.Ti 'vaj mi ma.go'ar u~ 'Di.a, i 'vaj e~'bO.ra
Não temos permissão para embelezar a mensagem ou moldá-la de acordo com as preferências das pessoas.	'na~w~ 'te~.mus peR.mi'sa~w~ 'pa.ra e~.be.le'zar a me~'sa.Ze~j~ ow mow'da la Di a'koR.du ko~ as pre.fe're~.sjas das pe'so.as
Seja corajoso o suficiente para viver a vida de seus sonhos de acordo com a sua visão e seu propósito, em vez das expectativas e opiniões dos outros.	'se.Za ko.ra'Zo.zu u su.fi.si'e~.Ti 'pa.ra vi'ver a 'vi.da Di 'sews 'so~.Jus Di a'koR.du ko~ a 'su.a vi'za~w~ i 'sew pro'pO.zi.tu, e~j~ 'vejz daz es.pek.ta'Ti.vaz i o.pi~.ni'o~j~s duz 'ow.trus
Salmos 3:5, Eu me deito e durmo; acordo, pois o Senhor me sustenta.	'saw.mus 'trejz, 'si~.ku, ew mi 'dej.tu i 'duR.mu, a'kOR.du, 'pojz u se~'JoR mi sus'te~.ta
Ando caçada, desanimada e sem esperanças. Quero dormir pra ver se amanhã acordo melhor.	'a~.du ka'sa.da, de.za~.ni~'ma.da i se~j~ es.pe'ra~.sas, 'kE.ru doR'miX pra 'veX si a~.ma~'Ja~ a'kOR.du me'LOX
Não acredite em nada, não importa onde você o leia ou quem o diga, a menos que esteja de acordo com sua própria razão	'na~w~ a.kre'Di.Ti e~j~ 'na.da, 'na~w~ i~'pOX.ta 'o~.Di vo'se u 'lej.a ow 'ke~j~ u 'Di.ga, a 'me~.nus ki es'te.Za Di a'koR.du ko~ 'su.a 'prO.prja Ra'za~w~
Não existe nada absoluto, tudo é relativo. Por isso devemos julgar de acordo com as circunstâncias.	'na~w~ e'zis.Ti 'na.da ab.so'lu.tu, 'tu.du E Re.la'Ti.vu, pur 'i.su de've~.mu.Zuw'gaR Di a'koR.du ko~ as siX.ku~s'ta~.sjas
Se o Espírito Santo nos guia em tudo, Ele irá fazê-lo de acordo com as Escrituras, e nunca de maneira contrária a elas.	si u es'pi.ri.tu 'sa~.tu nus 'gi.a e~j~ 'tu.du, 'e.li i'ra fa'ze lu Di a'koR.du ko~ az es.kri'tu.ras, i 'nu~.ka Di ma~'nej.ra ko~'tra.rja a 'E.las
A diferença dos nossos sonhos é que, você é o meu, e eu não sou o seu. A diferença quando acordo, é que ainda vivo sonhando contigo, e você ainda pensa em nós dois como amigos.	a Di.fe're~.sa dus 'nO.sus 'so~.Juz E ki, vo'se E u 'mew, i ew 'na~w~ 'sow u 'sew, a Di.fe're~.sa 'kwa~.du a'kOR.du, E ki a'i~.da 'vi.vu so~'Ja~.du ko~'Ti.gu, i vo'se a'i~.da 'pe~.sa e~j~ 'nOjs 'dojs 'ko~.mu a~'mi.gus
Se nossas ações estiverem de acordo com os ensinamentos de Cristo, daremos sempre muitos frutos. E frutos excelentes.	si 'nO.saz a'so~j~z es.Ti'vE.re~j~ Di a'koR.du ko~ uz e~.si~.na~'me~.tus Di 'kris.tu, da're~.mus 'se~.pri 'mu~j~.tus 'fru.tus, i 'fru.tuz e.se'le~.Tis
Acordo com o telefone tocando. Desculpe, foi engano. Não faz mal, hoje eu também não estou em casa.	a'kOR.du ko~ u te.le'fo~.ni to'ka~.du, des'kuw.pi, 'foj e~'ga~.nu, 'na~w~ 'fajz 'maw, 'o.Zi ew ta~'be~j~ 'na~w~ es'tow e~j~ 'ka.za
Sobre o verão: De acordo com a química a alta temperatura gera agitação das moléculas e maior probabilidade de se chocarem. Se é que me entendem.	'so.bri u ve'ra~w~, Di a'koR.du ko~ a 'ki~.mi.ka a 'aw.ta te~.pe.ra'tu.ra 'ZE.ra a.Zi.ta'sa~w~ das mo'lE.ku.laz i maj'OX pro.ba.bi.li'da.Di Di si So'ka.re~j~, si E ki mi e~'te~.de~j~
Hoje é um daqueles dias que eu já acordo saturada de todo mundo.	'o.Zi E u~ da'ke.lis 'Di.as ki ew 'Za a'kOR.du sa.tu'ra.da Di 'to.du 'mu~.du
Você está diferente! Claro né, acordo cada dia mais linda!!	vo'se es'ta Di.fe're~.Ti, 'kla.ru 'nE, a'kOR.du 'ka.da 'Di.a 'majs 'li~.da
Aqueça o seu coração de paz, tenha fé nos seus objetivos de acordo com a realidade, seja determinado e faça mudanças necessárias para vencer todos os desafios.	a'ke.sa u 'sew ko.ra'sa~w~ Di 'pajs, 'te~.Ja 'fE nus 'sewz ob.Ze'Ti.vus Di a'koR.du ko~ a Re.a.li'da.Di, 'se.Za de.teR.mi~'na.du i 'fa.sa mu'da~.sas ne.se'sa.rjas 'pa.ra ve~'seX 'to.duz us de.za'fi.us
Durmo com tantos planos na cabeça Acordo com uma preguiça infame de concretizá-los, sempre adiando para o próximo dia. É, isso é bem complicado.	'duR.mu ko~ 'ta~.tus 'pla~.nus na ka'be.sa a'kOR.du ko~ u~.ma pre'gi.sa i~'fa~.mi Di ko~.kre.Ti'za lus, 'se~.pri a.Di'a~.du 'pa.ra u 'prO.si~.mu 'Di.a, E, 'i.su E 'be~j~ ko~.pli'ka.du
Nem eu me conheço completamente, sou uma mistura de emoções, que variam de acordo com o local, com o tempo, com as pessoas.	ne~j~ ew mi ko~'Je.su ko~.plE.ta~'me~.Ti, 'sow u~.ma mis'tu.ra Di e~.mo'so~j~s, ki va'ri.a~w~ Di a'koR.du ko~ u lo'kaw, ko~ u 'te~.pu, ko~ as pe'so.as
A tia da prostituição chama-se Jezabel e os que com ela vivem de comum acordo são chamados de sobrinhos da perdição, da morte do sofrimento eterno.	a 'Ti.a da pros.Ti.tuj'sa~w~ 'Sa~.ma si Ze.za'bEw i us ki ko~ 'E.la 'vi.ve~j~ Di ko~'mu~ a'koR.du 'sa~w~ Sa~'ma.dus Di so'bri~.Jus da peR.Di'sa~w~, da 'mOX.Ti du so.fri~'me~.tu e'tER.nu
Elegância não é sinônimo de requinte; é simplesmente você estar de acordo com a sua essência da melhor forma possível.	e.le'ga~.sja 'na~w~ E si~'no~.ni~.mu Di Re'ki~.Ti, E si~.pliz'me~.Ti vo'se es'taR Di a'koR.du ko~ a 'su.a e'se~.sja da me'LOX 'fOR.ma po'si.vew
Sonho te beijando com a mesma frequência que acordo tentando entender porque você ainda é meu pesadelo.	'so~.Ju Ti bej'Za~.du ko~ a 'mez.ma fre'kwe~.sja ki a'kOR.du te~'ta~.du e~.te~'deX puX'ke vo'se a'i~.da E 'mew pe.za'de.lu
A verdade não muda de acordo com a nossa capacidade de digerir.	a veR'da.Di 'na~w~ 'mu.da Di a'koR.du ko~ a 'nO.sa ka.pa.si'da.Di Di Di.Ze'riX
Camaleão que vive de acordo com o que camufla, não pode reclamar do ambiente que manipula suas cores e nem dos lagartos que não participam desse carnaval de vestias.	ka~.ma.le'a~w~ ki 'vi.vi Di a'koR.du ko~ u ki ka~'mu.fla, 'na~w~ 'pO.Di Re.kla~'maR du a~.bi'e~.Ti ki ma~.ni'pu.la 'su.as 'ko.riz i ne~j~ dus la'gaX.tus ki 'na~w~ paX.Ti'si.pa~w~ 'de.si kaR.na'vaw Di ves'Ti.as
Quando sonho contigo grito seu nome e acordo chorando, pra não morrer de amor, vivo este sonho pra sempre te amando!	'kwa~.du 'so~.Ju ko~'Ti.gu 'gri.tu 'sew 'no~.mi i a'kOR.du So'ra~.du, pra 'na~w~ mo'ReR Di a~'moX, 'vi.vu 'es.Ti 'so~.Ju pra 'se~.pri Ti a~'ma~.du
E no livro, de acordo Com cada livro, Quero pertencer a várias Profissões.	i nu 'li.vru, Di a'koR.du ko~ 'ka.da 'li.vru, 'kE.ru peX.te~'ser a 'va.rjas pro.fi'so~j~s
Acordo ás vezes no meio da noite e saio à sua procura e tudo que encontro é minha saudade rondando sua cama vazia.	a'kOR.du 'ajs 've.zis nu 'mej.u da 'noj.Ti i 'saj.u a 'su.a pro'ku.ra i 'tu.du ki e~'ko~.tru E 'mi~.Ja saw'da.Di Ro~'da~.du 'su.a 'ka~.ma va'zi.a
Não estou neste mundo para viver de acordo com as suas expectativas e nem você com as minhas	'na~w~ es'tow 'nes.Ti 'mu~.du 'pa.ra vi'veR Di a'koR.du ko~ as 'su.az es.pek.ta'Ti.vaz i ne~j~ vo'se ko~ as 'mi~.Jas
Toda propaganda deve ser popular e estabelecer o seu nível espiritual de acordo com a capacidade de compreensão do mais ignorante dentre aqueles a quem ela pretende se dirigir.	'to.da pro.pa'ga~.da 'dE.vi 'seX po.pu'lar i es.ta.be.le'ser u 'sew 'ni.vew es.pi.ri.tu'aw Di a'koR.du ko~ a ka.pa.si'da.Di Di ko~.pre.e~'sa~w~ du 'majz i.gi~.no'ra~.Ti 'de~.tri a'ke.liz a 'ke~j~ 'E.la pre'te~.Di si Di.ri'ZiX
O povo busca um salvador na política e nela ele não estará, aí cada um de acordo a sua consciência escolhe seu reflexo para lhe representar...	u 'po.vu 'bus.ka u~ saw.va'doR na po'li.Ti.ka i 'nE.la 'e.li 'na~w~ es.ta'ra, a'i 'ka.da 'u~ Di a'koR.du a 'su.a ko~.si'e~.sja es'kO.Li 'sew Re'flEk.su 'pa.ra Li Re.pre.ze~'taX
Como num plano cartesiano, eu oscilo de acordo com as variáveis.	'ko~.mu nu~ 'pla~.nu kaX.te.zi'a~.nu, ew o'si.lu Di a'koR.du ko~ as va.ri'a.vejs
O pior de tudo é acordar e não sentir vontade de ter acordado, parece que quando acordo estou entrando em um pesadelo e só saio dele quando volto a dormir.	u pi'OR Di 'tu.du E a.koR'dar i 'na~w~ se~'TiR vo~'ta.Di Di 'ter a.koR'da.du, pa'rE.si ki 'kwa~.du a'kOR.du es'tow e~'tra~.du e~j~ u~ pe.za'de.lu i 'sO 'saj.u 'de.li 'kwa~.du 'vOw.tu a doR'miX
Não se curve, não dilua nada; não tente tornar lógico; não edite sua alma de acordo com a moda. Pelo contrário, siga implacavelmente suas obsessões mais intensas.	'na~w~ si 'kuR.vi, 'na~w~ Di'lu.a 'na.da, 'na~w~ 'te~.Ti toR'naR 'lO.Zi.ku, 'na~w~ e'Di.Ti 'su.a 'aw.ma Di a'koR.du ko~ a 'mO.da, 'pe.lu ko~'tra.rju, 'si.ga i~.pla.ka.vew'me~.Ti 'su.az ob.se'so~j~s 'majz i~'te~.sas
Se acordo muito cedo, fico de mau humor. Se acordo muito tarde, fico de mau humor. Talvez não seja uma questão de horário, mas de mundo.	si a'kOR.du 'mu~j~.tu 'se.du, 'fi.ku Di 'maw u~'moX, si a'kOR.du 'mu~j~.tu 'taR.Di, 'fi.ku Di 'maw u~'moX, taw'vejz 'na~w~ 'se.Za u~.ma kes'ta~w~ Di o'ra.rju, majs Di 'mu~.du
Não ando de acordo com a moda porque não gosto de nada que acaba...	'na~w~ 'a~.du Di a'koR.du ko~ a 'mO.da puX'ke 'na~w~ 'gOs.tu Di 'na.da ki a'ka.ba
Quando acordo digo para mim mesma. Tudo vai ficar bem. Tudo vai ficar bem. E, sempre fica.	'kwa~.du a'kOR.du 'Di.gu 'pa.ra 'mi~ 'mez.ma, 'tu.du 'vaj fi'kaR 'be~j~, 'tu.du 'vaj fi'kaR 'be~j~, i, 'se~.pri 'fi.ka
Vou colocar a música do plantão da globo como despertador, porque eu ja acordo no clima de desastre.	'vow ko.lo'kar a 'mu.zi.ka du pla~'ta~w~ da 'glo.bu 'ko~.mu des.peX.ta'doX, puX'ke ew 'Za a'kOR.du nu 'kli~.ma Di de'zas.tri
Por que nunca me disseste o que querias, para que eu vivesse exatamente de acordo com a tua vontade. Por que me deste liberdade, que eu não sabia usar?	puX 'ke 'nu~.ka mi Di'sEs.Ti u ki ke'ri.as, 'pa.ra ki ew vi've.si e.za.ta~'me~.Ti Di a'koR.du ko~ a 'tu.a vo~'ta.Di, puX 'ke mi 'dEs.Ti li.beR'da.Di, ki ew 'na~w~ sa'bi.a u'zaX
Acordo pela noite, pego o violão e faço uma canção...	a'kOR.du 'pe.la 'noj.Ti, 'pE.gu u vi.o'la~w~ i 'fa.su u~.ma ka~'sa~w~
circuluar sonho ímpar acordo par	siX.ku.lu'aX 'so~.Ju 'i~.par a'kOR.du 'paX
Isto é uma guerra. Aja de acordo.	'is.tu E u~.ma 'gE.Ra, 'a.Za Di a'koR.du
As emoções são superficiais e inconsistentes. Elas mudam de acordo com a situação.	az e~.mo'so~j~s 'sa~w~ su.peX.fi.si'ajz i i~.ko~.sis'te~.Tis, 'E.las 'mu.da~w~ Di a'koR.du ko~ a si.tu.a'sa~w~
Há chaves que Deus vai liberar de acordo com nossos níveis de maturidade e comprometimento.	'a 'Sa.vis ki 'dews 'vaj li.be'raR Di a'koR.du ko~ 'nO.sus 'ni.vejs Di ma.tu.ri'da.Di i ko~.pro~.me.Ti~'me~.tu
Não tenho culpa se meus dias têm nascido completamente coloridos. Simplesmente quando acordo decido que quero ser feliz, mas alguns ainda cismam em querer borrar minhas cores.	'na~w~ 'te~.Ju 'kuw.pa si 'mews 'Di.as 'te~j~ na'si.du ko~.plE.ta~'me~.Ti ko.lo'ri.dus, si~.pliz'me~.Ti 'kwa~.du a'kOR.du de'si.du ki 'kE.ru 'seX fe'lis, majz aw'gu~z a'i~.da 'siz.ma~w~ e~j~ ke'reR bo'RaR 'mi~.Jas 'ko.ris
Nós não mudamos, apenas evoluímos de acordo com as necessidades	'nOjs 'na~w~ mu'da~.mus, a'pe~.naz e.vo.lu'i~.mus Di a'koR.du ko~ as ne.se.si'da.Dis
São iguais, os vivos e os mortos, os que estão acordados e os que dormem, os jovens e os velhos: porque cada um destes opostos quando se transformam tornam-se o anterior.	'sa~w~ i'gwajs, us 'vi.vuz i us 'mOX.tus, us ki es'ta~w~ a.koR'da.duz i us ki 'dOR.me~j~, u'ZO.ve~z i us 'vE.Lus, puX'ke 'ka.da 'u~ 'des.Tiz o'pOs.tus 'kwa~.du si tra~s'fOR.ma~w~ 'tOR.na~w~ si u a~.te.ri'oX
A parte mais grave da corrupção é o conchavo e a impunidade que contaminam em pouco tempo os éticos e morais valores de qualquer sociedade.	a 'paX.Ti 'majs 'gra.vi da ko.Rup'sa~w~ E u ko~'Sa.vu i a i~.pu~.ni'da.Di ki ko~.ta~'mi~.na~w~ e~j~ 'pow.ku 'te~.pu uz 'E.Ti.kuz i mo'rajs va'lo.ris Di kwaw'kEX so.si.e'da.Di
Vamos fazer um acordo. Não conheço você e você não me conhece. E como não nos conhecemos, não temos nada a perder. Podemos ser sinceros. Pode ser? Sem máscaras.	'va~.mus fa'zer u~ a'koR.du, 'na~w~ ko~'Je.su vo'se i vo'se 'na~w~ mi ko~'JE.si, i 'ko~.mu 'na~w~ nus ko~.Je'se~.mus, 'na~w~ 'te~.mus 'na.da a peR'deX, po'de~.mus 'seX si~'sE.rus, 'pO.Di 'seX, se~j~ 'mas.ka.ras
Não deposite expectativas em mim, não há acordo espiritual, físico ou material que me obrigue a mudar a minha essência para me encaixar nesta existência.	'na~w~ de.po'zi.Ti es.pek.ta'Ti.vaz e~j~ 'mi~, 'na~w~ 'a a'koR.du es.pi.ri.tu'aw, 'fi.zi.ku ow ma.te.ri'aw ki mi o'bri.gi a mu'dar a 'mi~.Ja e'se~.sja 'pa.ra mi e~.kaj'SaR 'nEs.ta e.zis'te~.sja
Um acordo é sempre melhor do que uma guerra.	u~ a'koR.du E 'se~.pri me'LOR du ki u~.ma 'gE.Ra
Todos os dias antes de deitar e quando acordo, lavo minha alma e deixo o amor entrar.	'to.duz us 'Di.az 'a~.Tis Di dej'tar i 'kwa~.du a'kOR.du, 'la.vu 'mi~.Ja 'aw.ma i 'dej.Su u a~'mor e~'traX
Não havendo acordo torna-se proibido para uma das partes.	'na~w~ a've~.du a'koR.du 'tOR.na si proj'bi.du 'pa.ra u~.ma das 'paX.Tis
Na união conjugal Deus ordena as bênçãos quando há amor, submissão e acordo entre os dois.	na u~.ni'a~w~ ko~.Zu'gaw 'dewz oR'de~.na as 'be~.sa~w~s 'kwa~.du 'a a~'moX, sub.mi'sa~w~ i a'koR.du 'e~.tri us 'dojs
A cor que melhor combina com você, é aquela que escolhe de acordo com a sua energia atual	a 'koX ki me'LOX ko~'bi~.na ko~ vo'se, E a'kE.la ki es'kO.Li Di a'koR.du ko~ a 'su.a e~.neR'Zi.a a.tu'aw
Acordo significa discutir o problema entre duas ou mais pessoas e achar a melhor solução que agrade a maioria.	a'koR.du si.gi~.ni'fi.ka Dis.ku'Tir u pro'ble~.ma 'e~.tri 'du.az ow 'majs pe'so.az i a'Sar a me'LOX so.lu'sa~w~ ki a'gra.Di a maj.o'ri.a
Entre eu e Deus existe um acordo nos Céus: receber a Coroa Eterna que Jesus me prometeu.	'e~.tri ew i 'dewz e'zis.Ti u~ a'koR.du nus 'sEws, Re.se'ber a ko'ro.a e'tER.na ki Ze'zujs mi pro~.me'tew
Espere todos estarem de acordo com você e você perderá a chance de um grande feito!  Acredite estar correto por todos estarem de acordo com você e se afundará no engano!	es'pE.ri 'to.duz es'ta.re~j~ Di a'koR.du ko~ vo'se i vo'se peR.de'ra a 'Sa~.si Di u~ 'gra~.Di 'fej.tu, a.kre'Di.Ti es'taX ko'RE.tu puX 'to.duz es'ta.re~j~ Di a'koR.du ko~ vo'se i si a.fu~.da'ra nu e~'ga~.nu
Nosso mundo: As convicções são distintas; as ideologias necessárias; as atitudes pensadas; os acordos lucrativos, mas as diferenças parecem nunca serem aceitas.	'nO.su 'mu~.du, as ko~.vik'so~j~s 'sa~w~ Dis'Ti~.tas, az i.de.o.lo'Zi.as ne.se'sa.rjas, az a.Ti'tu.Dis pe~'sa.das, uz a'koR.dus lu.kra'Ti.vus, majz as Di.fe're~.sas pa'rE.se~j~ 'nu~.ka 'se.re~j~ a'sej.tas
Cérebro e coração, já está na hora de vocês entrarem em um acordo.	'sE.re.bru i ko.ra'sa~w~, 'Za es'ta na 'O.ra Di vo'sejz e~'tra.re~j~ e~j~ u~ a'koR.du
Sono, Lentos. Um acordo? Mas não estamos Acordados.	'so~.nu, 'le~.tus, u~ a'koR.du, majs 'na~w~ es'ta~.muz a.koR'da.dus
O Daesh é filho do Acordo secreto Sykes-Picot da mesma forma que Hitler é filho do Tratado de Versalhes.	u da'ES E 'fi.Lu du a'koR.du se'krE.tu 'saj.kis pi'ko da 'mez.ma 'fOR.ma ki 'Rit.ler E 'fi.Lu du tra'ta.du Di veX'sa.Lis
Incline-se demais as tentações e vaidades e o destino te mostrará o real resultado!	i~'kli~.ni si de~'majz as te~.ta'so~j~z i vaj'da.Diz i u des'Ti~.nu Ti mos.tra'ra u Re'aw Re.zuw'ta.du
Define-se espiritualmente uma aliança firme, promissora e eterna com Deus aquela à que uma das partes não quebre os respectivos acordos sancionados com fidelidade, integridade e respeito	de'fi~.ni si es.pi.ri.tu.aw'me~.Ti u~.ma a.li'a~.sa 'fiR.mi, pro~.mi'so.ra i e'tER.na ko~ 'dewz a'kE.la a ki u~.ma das 'paX.Tis 'na~w~ 'kE.bri us Res.pek'Ti.vuz a'koR.dus sa~.si.o~'na.dus ko~ fi.de.li'da.Di, i~.te.gri'da.Di i Res'pej.tu
O HOJE, é sempre o tempo certo para começar ou recomeçar. Faça um acordo com a sua coragem e vá.	u 'o.Zi, E 'se~.pri u 'te~.pu 'sEX.tu 'pa.ra ko~.me'sar ow Re.ko~.me'saX, 'fa.sa u~ a'koR.du ko~ a 'su.a ko'ra.Ze~j~ i 'va
Em questão de herança é bom que todos sejam de acordo e unidos.	e~j~ kes'ta~w~ Di e'ra~.sa E 'bo~ ki 'to.dus 'se.Za~w~ Di a'koR.du i u~'ni.dus
Mais 5 minutos?  Despertador desperta; Eu, em desacordo, Não acordo.	'majs 'si~.ku mi~'nu.tus, des.peX.ta'doR des'pEX.ta, ew, e~j~ de.za'koR.du, 'na~w~ a'kOR.du
Acordo. Se parar De sonhar, Me acorde.	a'koR.du, si pa'raR Di so~'JaX, mi a'kOR.Di
Se todos tiverem razão, alcançarão paz com diálogo direto. Se ninguém tiver razão, assim mesmo, a paz virá com diálogo. Entre as partes! É assim que se ama. E depois, um abraço.	si 'to.dus Ti'vE.re~j~ Ra'za~w~, aw.ka~.sa'ra~w~ 'pajs ko~ Di'a.lo.gu Di'rE.tu, si ni~'ge~j~ Ti'vE.Ra'za~w~, a'si~ 'mez.mu, a 'pajz vi'ra ko~ Di'a.lo.gu, 'e~.tri as 'paX.Tis, E a'si~ ki si 'a~.ma, i de'pojs, u~ a'bra.su
Um dos grandes motivos que faz qualquer casal ter longa fidelidade com alegria conjugal é o mútuo acordo do amor e respeito.	'u~ dus 'gra~.Dis mo'Ti.vus ki 'fajs kwaw'kEX ka'zaw 'teR 'lo~.ga fi.de.li'da.Di ko~ a.le'gri.a ko~.Zu'gaw E u 'mu.twu a'koR.du du a~'mor i Res'pej.tu
Quem faz acordo com as trevas, em nome da luz, pode ter a certeza que Deus não entrou neste pacto.	'ke~j~ 'fajz a'koR.du ko~ as 'trE.vas, e~j~ 'no~.mi da 'lujs, 'pO.Di 'ter a seX'te.za ki 'dews 'na~w~ e~'trow 'nes.Ti 'pak.tu
Há demônios nas pessoas que brigam por herança, quando estas procuram, por egoísmo, rixas e difamações, impedirem um acordo familiar.	'a de~'mo~.njus nas pe'so.as ki 'bri.ga~w~ pur e'ra~.sa, 'kwa~.du 'Es.tas pro'ku.ra~w~, pur e.go'iz.mu, 'Ri.Saz i Di.fa~.ma'so~j~s, i~.pe'Di.re~j~ u~ a'koR.du fa~.mi.li'aX
Acalento no coração o sonho de que poderei abraçar o mundo, acordo o dia antes do sol risonho, sentindo a poesia em cada segundo !	a.ka'le~.tu nu ko.ra'sa~w~ u 'so~.Ju Di ki po.de'rej a.bra'sar u 'mu~.du, a'kOR.du u 'Di.a 'a~.Tis du 'sOw Ri'zo~.Ju, se~'Ti~.du a po.e'zi.a e~j~ 'ka.da se'gu~.du
Toda manhã quando acordo e enxergo você ao meu lado, é como se estivesse desembrulhando um presente que Deus deixou para mim	'to.da ma~'Ja~ 'kwa~.du a'kOR.du i e~'SER.gu vo'se aw 'mew 'la.du, E 'ko~.mu si es.Ti'vE.si de.ze~.bru'La~.du u~ pre'ze~.Ti ki 'dews dej'Sow 'pa.ra 'mi~
Dizem que não há atalhos na vida e que nada é de graça. Mas o acordo que vou lhes oferecer é o mais próximo da liberdade que vocês chegarão.	'Di.ze~j~ ki 'na~w~ 'a a'ta.Lus na 'vi.da i ki 'na.da E Di 'gra.sa, majz u a'koR.du ki 'vow Liz o.fe.re'ser E u 'majs 'prO.si~.mu da li.beR'da.Di ki vo'sej.Se.ga'ra~w~
Em uma negociação quando se visa a maximizar os ganhos, corre-se o risco de corromper o acordo.	e~j~ u~.ma ne.go.si.a'sa~w~ 'kwa~.du si 'vi.za a mak.si~.mi'zar us 'ga~.Jus, 'kO.Ri si u 'Ris.ku Di ko.Ro~'per u a'koR.du
Fiz um acordo com o tempo, eu não fujo dele é ele não me persegue !!	'fiz u~ a'koR.du ko~ u 'te~.pu, ew 'na~w~ 'fu.Zu 'de.li E 'e.li 'na~w~ mi peX'sE.gi
Se você quer realmente defender aquilo em que acredita, viva de acordo.	si vo'se 'kE.Re.aw'me~.Ti de.fe~'der a'ki.lu e~j~ ki a.kre'Di.ta, 'vi.va Di a'koR.du
Alguns fazem acordo, deixando de ter consciência social.	aw'gu~s 'fa.ze~j~ a'koR.du, dej'Sa~.du Di 'teX ko~.si'e~.sja so.si'aw
Eu não tenho sorte, apenas acordo todos os dias as cinco horas da manhã.	ew 'na~w~ 'te~.Ju 'sOX.Ti, a'pe~.naz a'kOR.du 'to.duz us 'Di.az as 'si~.ku 'O.ras da ma~'Ja~
Chegamos a um princípio de acordo: nossa TRANSAção é de amor.	Se'ga~.muz a u~ pri~'si.pju Di a'koR.du, 'nO.sa tra~.za'sa~w~ E Di a~'moX
Discordar faz parte da vida, mas acordar faz parte da vida de pessoas plenas.  Simples Assim)	Dis.koR'daX 'fajs 'paX.Ti da 'vi.da, majz a.koR'daX 'fajs 'paX.Ti da 'vi.da Di pe'so.as 'ple~.nas, 'si~.pliz a'si~
De acordo com quem compôs o Salmo 91, o melhor lugar para refúgio e descanso é o esconderijo do Altíssimo, à Sua sombra.	Di a'koR.du ko~ 'ke~j~ ko~'pojz u 'saw.mu no've~.ta i 'u~, u me'LOR lu'gaX 'pa.ra Re'fu.Zju i des'ka~.su E u es.ko~.de'ri.Zu du aw'Ti.si~.mu, a 'su.a 'so~.bra
Você só pode dizer que houve um acordo, quando os lados envolvidos estiverem todos plenamente satisfeitos.	vo'se 'sO 'pO.Di Di'zeX ki 'ow.vi u~ a'koR.du, 'kwa~.du us 'la.duz e~.vow'vi.duz es.Ti'vE.re~j~ 'to.dus ple~.na~'me~.Ti sa.Tis'fej.tus
Casais que não respeitam uns aos outros se desgatam com pecado de ódio, ressentimentos e brigas, desvalorizando o seu acordo conjugal.	ka'zajs ki 'na~w~ Res'pej.ta~w~ u~z awz 'ow.trus si dez'ga.ta~w~ ko~ pe'ka.du Di 'O.Dju, Re.se~.Ti~'me~.tuz i 'bri.gas, dez.va.lo.ri'za~.du u 'sew a'koR.du ko~.Zu'gaw
De acordo com esse meu constante reinventar-se, não sei amanhã, mas sempre que eu te disser Eu te amo, é porque Te Amo.	Di a'koR.du ko~ 'e.si 'mew ko~s'ta~.Ti Rej~.ve~'taX si, 'na~w~ 'sej a~.ma~'Ja~, majs 'se~.pri ki ew Ti Di'sEr ew Ti 'a~.mu, E puX'ke Ti 'a~.mu
Quanto mais você tiver considerado diferentes formas de ajustar um acordo, mais ágil e criativo você será no meio da negociação.	'kwa~.tu 'majs vo'se Ti'vEX ko~.si.de'ra.du Di.fe're~.Tis 'fOR.mas Di a.Zus'tar u~ a'koR.du, 'majz 'a.Ziw i kri.a'Ti.vu vo'se se'ra nu 'mej.u da ne.go.si.a'sa~w~
O cristão deve viver de acordo com a natureza recebida no novo nascimento.	u kris'ta~w~ 'dE.vi vi'veR Di a'koR.du ko~ a na.tu're.za Re.se'bi.da nu 'no.vu na.si~'me~.tu
Para o cristão, viver e andar de acordo com o Espírito de Deus é dever, não opção.	'pa.ra u kris'ta~w~, vi'ver i a~'daR Di a'koR.du ko~ u es'pi.ri.tu Di 'dewz E de'veX, 'na~w~ op'sa~w~
A melhor condição sempre será a sua condição.	a me'LOX ko~.Di'sa~w~ 'se~.pri se'ra a 'su.a ko~.Di'sa~w~
Muitas pessoas acreditam que existe no sistema de coordenadas do mundo um ponto perfeito onde tempo e espaço chegam a um acordo.	'mu~j~.tas pe'so.az a.kre'Di.ta~w~ ki e'zis.Ti nu sis'te~.ma Di ko.oR.de~'na.das du 'mu~.du u~ 'po~.tu peX'fej.tu 'o~.Di 'te~.pu i es'pa.su 'Se.ga~w~ a u~ a'koR.du
Negociar bem não significa ganhar sempre, mas chegar a acordos mutuamente vantajosos.	ne.go.si'aR 'be~j~ 'na~w~ si.gi~.ni'fi.ka ga~'JaX 'se~.pri, majs Se'gar a a'koR.dus mu.tu.a~'me~.Ti va~.ta'ZO.zus
Nenhum acordo vale a sua Alma, honra e dignidade não tem preço.	ne~'Ju~ a'koR.du 'va.li a 'su.a 'aw.ma, 'o~.Ra i Di.gi~.ni'da.Di 'na~w~ te~j~ 'pre.su
Você sempre escolhe de acordo com as suas emoções. A forma que vemos o mundo é percebida de acordo como o sentimos. Isso pouco tem haver com fatos.	vo'se 'se~.pri es'kO.Li Di a'koR.du ko~ as 'su.az e~.mo'so~j~s, a 'fOR.ma ki 've~.muz u 'mu~.du E peX.se'bi.da Di a'koR.du 'ko~.mu u se~'Ti~.mus, 'i.su 'pow.ku te~j~ a'veX ko~ 'fa.tus
Amanhã estarei aqui, te amando outra vez com perfeição. Porque todas as manhãs, eu acordo pra te amar.	a~.ma~'Ja~ es.ta'rej a'ki, Ti a~'ma~.du 'ow.tra 'vejs ko~ peX.fej'sa~w~, puX'ke 'to.daz as ma~'Ja~j~s, ew a'kOR.du pra Ti a~'maX
Meu viver, minhas regras. Seu viver, suas regras. Nosso viver, nossas regras	'mew vi'veX, 'mi~.Jas 'RE.gras, 'sew vi'veX, 'su.as 'RE.gras, 'nO.su vi'veX, 'nO.sas 'RE.gras
Têm dias que acordo e minhas doses de café é uma golada de poesias.	'te~j~ 'Di.as ki a'kOR.du i 'mi~.Jas 'dO.zis Di ka'fE E u~.ma go'la.da Di po.e'zi.as
Cooperação é o melhor caminho para se chegar a um acordo satisfatório.	ko.o.pe.ra'sa~w~ E u me'LOX ka~'mi~.Ju 'pa.ra si Se'gar a u~ a'koR.du sa.Tis.fa'tO.rju
Acordo poesia Ao sonhar de dia Escuto o musical dos pássaros E a sinfonia da ventania.	a'kOR.du po.e'zi.a aw so~'JaR Di 'Di.a es'ku.tu u mu.zi'kaw dus 'pa.sa.ruz i a si~.fo~'ni.a da ve~.ta~'ni.a
Então é um acordo se é algo que você quer e uma conversa se for vontade da Nicole?	e~'ta~w~ E u~ a'koR.du si E 'aw.gu ki vo'se 'kEr i u~.ma ko~'vEX.sa si 'foR vo~'ta.Di da ni'kO.li
Trabalhadores e patrões sabem que o acordo arrebenta sempre do lado mais falso.	tra.ba.La'do.riz i pa'tro~j~s 'sa.be~j~ ki u a'koR.du a.Re'be~.ta 'se~.pri du 'la.du 'majs 'faw.su
A terra também veste-se de flores na primavera. E de e de acordo com as suas estações ela vai variando as suas belas roupagens...	a 'tE.Ra ta~'be~j~ 'vEs.Ti si Di 'flo.ris na pri~.ma'vE.ra, i Di i Di a'koR.du ko~ as 'su.az es.ta'so~j~z 'E.la 'vaj va.ri'a~.du as 'su.as 'bE.las Row'pa.Ze~s
Junto com a vida, ganhamos a concessão do livre arbítrio, ao mesmo tempo juros a pagar no final. De acordo com a forma com que ela a vida, foi levada	'Zu~.tu ko~ a 'vi.da, ga~'Ja~.muz a ko~.se'sa~w~ du 'li.vri aR'bi.trju, aw 'mez.mu 'te~.pu 'Zu.ruz a pa'gaR nu fi~'naw, Di a'koR.du ko~ a 'fOR.ma ko~ ki 'E.la a 'vi.da, 'foj le'va.da
Proponho um acordo, que os antagônicos se unam, tomem as ruas contra os corruptos, mas todos eles, sem paixão por esse ou aquele.	pro'po~.Ju u~ a'koR.du, ki uz a~.ta'go~.ni.kus si 'u~.na~w~, 'to~.me~j~ as 'Ru.as 'ko~.tra us ko'Rup.tus, majs 'to.duz 'e.lis, se~j~ paj'Sa~w~ pur 'e.si ow a'ke.li
Note o desiquilíbrio espiritual das almas que falam de Deus e que seguem os conselhos dos homens: não existe um acordo no Espírito com os seus corações de carne.	'nO.Ti u de.zi.ki'li.brju es.pi.ri.tu'aw daz 'aw.mas ki 'fa.la~w~ Di 'dewz i ki 'sE.ge~j~ us ko~'se.Lus duz 'o~.me~s, 'na~w~ e'zis.Ti u~ a'koR.du nu es'pi.ri.tu ko~ us 'sews ko.ra'so~j~s Di 'kaR.ni
Um mau acordo pode ser muito mais vantajoso que uma boa briga	u~ 'maw a'koR.du 'pO.Di 'seR 'mu~j~.tu 'majs va~.ta'Zo.zu ki u~.ma 'bo.a 'bri.ga
Quando uma nova criação inicia-se, tudo transforma-se de acordo com a criatura. rojane mary	'kwa~.du u~.ma 'nO.va kri.a'sa~w~ i~.ni'si.a si, 'tu.du tra~s'fOR.ma si Di a'koR.du ko~ a kri.a'tu.ra, Ro'Za~.ni 'ma.ri
Presuma o pior cenário! Presuma catástrofe e aja de acordo!	pre'zu~.ma u pi'OX se~'na.rju, pre'zu~.ma ka'tas.tro.fi i 'a.Za Di a'koR.du
Quando algo não está de acordo com aquilo que desejamos, mudemos a trajetória do caminho.	'kwa~.du 'aw.gu 'na~w~ es'ta Di a'koR.du ko~ a'ki.lu ki de.ze'Za~.mus, mu'de~.muz a tra.Ze'tO.rja du ka~'mi~.Ju
Acordo todos os dias as quatro horas da manhã para viver duas horas a mais por dia. rojane mary	a'kOR.du 'to.duz us 'Di.az as 'kwa.tru 'O.ras da ma~'Ja~ 'pa.ra vi'veR 'du.az 'O.raz a 'majs puR 'Di.a, Ro'Za~.ni 'ma.ri
Eu quando Rio transbordo e acordo para um continente chamado eu	ew 'kwa~.du 'Ri.u tra~z'bOR.du i a'kOR.du 'pa.ra u~ ko~.Ti~'ne~.Ti Sa~'ma.du ew
Faça primeiro parceria com Deus quando envolver relacionamentos com terceiros, a fim de que ambos participem e consultem os acordos superiores.	'fa.sa pri~'mej.ru paX.se'ri.a ko~ 'dews 'kwa~.du e~.vow've.Re.la.si.o~.na~'me~.tus ko~ teX'sej.rus, a 'fi~ Di ki 'a~.bus paX.Ti'si.pe~j~ i ko~'suw.te~j~ uz a'koR.dus su.pe.ri'o.ris
LHANEZA  Às saudações, cada Sicrano as corresponde de acordo com a sua essência, estado emocional e empatia.	La~'ne.za as saw.da'so~j~s, 'ka.da si'kra~.nu as ko.Res'po~.Di Di a'koR.du ko~ a 'su.a e'se~.sja, es'ta.du e~.mo.si.o~'naw i e~.pa'Ti.a
Um acordo só é verdadeiro se ambos os lados forem soldados pelo bom caráter.	u~ a'koR.du 'sO E veR.da'dej.ru si 'a~.buz us 'la.dus 'fo.re~j~ sow'da.dus 'pe.lu 'bo~ ka'ra.teX
Eu acordo e tudo que conheço vai ser vendido, destruído ou ser tomado por gente que eu não gosto.	ew a'kOR.du i 'tu.du ki ko~'Je.su 'vaj 'seR ve~'Di.du, des.tru'i.du ow 'seX to~'ma.du puR 'Ze~.Ti ki ew 'na~w~ 'gOs.tu
Eu vou jogar de acordo com as suas regras quando você jogar de acordo com as minhas.	ew 'vow Zo'gaR Di a'koR.du ko~ as 'su.as 'RE.gras 'kwa~.du vo'se Zo'gaR Di a'koR.du ko~ as 'mi~.Jas
As melhores frases são aquelas que vão ao encontro dos nossos sentimentos.	as me'LO.ris 'fra.zis 'sa~w~ a'kE.las ki 'va~w~ aw e~'ko~.tru dus 'nO.sus se~.Ti~'me~.tus
Antes de se combinar alguma coisa com alguém já há acordos pré-estabelecidos.	'a~.Tis Di si ko~.bi~'nar aw'gu~.ma 'koj.za ko~ aw'ge~j~ 'Za 'a a'koR.dus 'prE es.ta.be.le'si.dus
Com as pessoas que você ama, cumpra os acordos. E com as pessoas que você odeia, nem acordos faça.	ko~ as pe'so.as ki vo'se 'a~.ma, 'ku~.pra uz a'koR.dus, i ko~ as pe'so.as ki vo'se o'dej.a, ne~j~ a'koR.dus 'fa.sa
De cada um, de acordo com suas possibilidades; a cada um, de acordo com suas necessidades.	Di 'ka.da 'u~, Di a'koR.du ko~ 'su.as po.si.bi.li'da.Dis, a 'ka.da 'u~, Di a'koR.du ko~ 'su.as ne.se.si'da.Dis
Vivemos tempos em que desabam, fragosamente, certezas tidas por solidamente construídas	vi've~.mus 'te~.puz e~j~ ki de'za.ba~w~, fra.gO.za~'me~.Ti, seX'te.zas 'Ti.das puX sO.li.da~'me~.Ti ko~s.tru'i.das
Nunca aceite palavras que não estejam de acordo com teus objetivos.	'nu~.ka a'sej.Ti pa'la.vras ki 'na~w~ es'te.Za~w~ Di a'koR.du ko~ 'tewz ob.Ze'Ti.vus
Divertir-se é estar de acordo	Di.veX'TiX si E es'taR Di a'koR.du
O tempo anda de acordo com as horas, não adianta tentar mudar isso!	u 'te~.pu 'a~.da Di a'koR.du ko~ az 'O.ras, 'na~w~ a.Di'a~.ta te~'taR mu'dar 'i.su
Quando acordo penso em você   Quando durmo sonho com você  Acho que vou enlouquecer!	'kwa~.du a'kOR.du 'pe~.su e~j~ vo'se 'kwa~.du 'duR.mu 'so~.Ju ko~ vo'se 'a.Su ki 'vow e~.low.ke'seX
Se o mundo é desigual, valores e princípios não seriam diferentes. Eles mudam de acordo com as necessidades que lhes são impostas!	si u 'mu~.du E de.zi'guaw, va'lo.riz i pri~'si.pjus 'na~w~ se'ri.a~w~ Di.fe're~.Tis, 'e.lis 'mu.da~w~ Di a'koR.du ko~ as ne.se.si'da.Dis ki Lis 'sa~w~ i~'pOs.tas
Porque sempre quando eu acordo  eu olho no celular pra ver se tem mensagem sua :(	puX'ke 'se~.pri 'kwa~.du ew a'kOR.du ew 'O.Lu nu se.lu'laX pra 'veX si te~j~ me~'sa.Ze~j~ 'su.a
Durmo no passado, acordo no presente e vivo no futuro.	'duR.mu nu pa'sa.du, a'kOR.du nu pre'ze~.Ti i 'vi.vu nu fu'tu.ru
De que adianta dizer que você está no meu pensamento desde o momento em que acordo?...	Di ki a.Di'a~.ta Di'zeX ki vo'se es'ta nu 'mew pe~.sa~'me~.tu 'dez.Di u mo~'me~.tu e~j~ ki a'kOR.du
O mistério da vida me deixa pensativa, eu amo, eu xingo, eu estudo, eu cuido, eu respondo, eu acordo, eu como, eu cheiro, eu viajo, eu aproveito e um dia eu morro.	u mis'tE.rju da 'vi.da mi 'dej.Sa pe~.sa'Ti.va, ew 'a~.mu, ew 'Si~.gu, ew es'tu.du, ew 'kuj.du, ew Res'po~.du, ew a'kOR.du, ew 'ko~.mu, ew 'Sej.ru, ew vi'a.Zu, ew a.pro'vej.tu i u~ 'Di.a ew 'mo.Ru
Todos os dias quando acordo agradeço a Deus por mais um dia na vida e quando vou dormir agradeço por mais uma vida nesse dia. o dia é uma vida...	'to.duz us 'Di.as 'kwa~.du a'kOR.du a.gra'de.su a 'dews puR 'majz 'u~ 'Di.a na 'vi.da i 'kwa~.du 'vow doR'mir a.gra'de.su puR 'majz u~.ma 'vi.da 'ne.si 'Di.a, u 'Di.a E u~.ma 'vi.da
Acordo todos os dias, visto o amor de você e saio distribuindo minha admiração confessada.	a'kOR.du 'to.duz us 'Di.as, 'vis.tu u a~'moR Di vo'se i 'saj.u Dis.tri.bu'i~.du 'mi~.Ja a.Di~.mi.ra'sa~w~ ko~.fe'sa.da
Acordo ao seu lado e juro que ainda me sinto sonhando...	a'kOR.du aw 'sew 'la.du i 'Zu.ru ki a'i~.da mi 'si~.tu so~'Ja~.du
Acordo! dou um beijo na solidão, um abraço bem forte na saudade e faço elas me prometerem que nunca vão me abandonar.	a'kOR.du, 'dow u~ 'bej.Zu na so.li'da~w~, u~ a'bra.su 'be~j~ 'fOX.Ti na saw'da.Di i 'fa.su 'E.las mi pro~.me'te.re~j~ ki 'nu~.ka 'va~w~ mi a.ba~.do~'naX
A mente se desenvolve de acordo com o que se alimenta.	a 'me~.Ti si de.ze~'vOw.vi Di a'koR.du ko~ u ki si a.li~'me~.ta
Não há um método, há oportunidade. Cada um vai aproveitá-la de acordo com a sua vontade de crescer, mudar de vida e beneficiar a toda sua família e aqueles que vão se espelhar em seu sucesso	'na~w~ 'a u~ 'mE.to.du, 'a o.poX.tu~.ni'da.Di, 'ka.da 'u~ 'vaj a.pro.vej'ta la Di a'koR.du ko~ a 'su.a vo~'ta.Di Di kre'seX, mu'daR Di 'vi.da i be~.ne.fi.si'ar a 'to.da 'su.a fa~'mi.lja i a'ke.lis ki 'va~w~ si es.pe'Lar e~j~ 'sew su'sE.su
Todos os dias quando acordo Não tenho mais O tempo que passou.	'to.duz us 'Di.as 'kwa~.du a'kOR.du 'na~w~ 'te~.Ju 'majz u 'te~.pu ki pa'sow
Sonho Do sonho que acordo Desperto um desejo. Vontade de morrer Ou de ganhar um beijo.	'so~.Ju du 'so~.Ju ki a'kOR.du des'pEX.tu u~ de'ze.Zu, vo~'ta.Di Di mo'Rer ow Di ga~'Jar u~ 'bej.Zu
Se Deus deu o livre arbítrio, quem somos nós para julgarmos uns aos outros? Viva de acordo com a sua consciência e quando chegar a hora enfrente as consequências de suas escolhas.	si 'dews 'dew u 'li.vri aR'bi.trju, 'ke~j~ 'so~.mus 'nOjs 'pa.ra Zuw'gaR.muz u~z awz 'ow.trus, 'vi.va Di a'koR.du ko~ a 'su.a ko~.si'e~.sja i 'kwa~.du Se'gar a 'O.ra e~'fre~.Ti as ko~.se'kwe~.sjas Di 'su.az es'ko.Las
É mais fácil pregar princípios do que viver de acordo com eles.	E 'majs 'fa.siw pre'gaX pri~'si.pjus du ki vi'veR Di a'koR.du ko~ 'e.lis
Não importa se é segunda-feira ou sábado, a cada dia que eu acordo, fico feliz com mais uma oportunidade de viver e lutar pela realização dos meus sonhos.	'na~w~ i~'pOX.ta si E se'gu~.da 'fej.ra ow 'sa.ba.du, a 'ka.da 'Di.a ki ew a'kOR.du, 'fi.ku fe'lis ko~ 'majz u~.ma o.poX.tu~.ni'da.Di Di vi'ver i lu'taX 'pe.la Re.a.li.za'sa~w~ dus 'mews 'so~.Jus
A mente consciente e inconsciente age e reage de acordo com os nossos impulsos.	a 'me~.Ti ko~.si'e~.Ti i i~.ko~.si'e~.Ti 'a.Zi i Re'a.Zi Di a'koR.du ko~ us 'nO.suz i~'puw.sus
Molde seu sonho, de acordo com o esforço que você faz para realizá-lo.	'mOw.Di 'sew 'so~.Ju, Di a'koR.du ko~ u es'foX.su ki vo'se 'fajs 'pa.ra Re.a.li'za lu
Pessoas, Você não pode mudar seus sentimentos. É melhor deixar fazer o que elas querem De acordo com suas vontades. Se você deixar, Elas irão roubar seu coração.	pe'so.as, vo'se 'na~w~ 'pO.Di mu'daX 'sews se~.Ti~'me~.tus, E me'LOR dej'SaX fa'zer u ki 'E.las 'kE.re~j~ Di a'koR.du ko~ 'su.as vo~'ta.Dis, si vo'se dej'SaX, 'E.laz i'ra~w~ Row'baX 'sew ko.ra'sa~w~
O ser humano é propenso a agir de acordo com aquilo que tem dentro de si.	u 'ser u~'ma~.nu E pro'pe~.su a a'ZiR Di a'koR.du ko~ a'ki.lu ki te~j~ 'de~.tru Di 'si
Todos os dias que eu me acordo, e a luz do sol vem esmurrar a minha cara, eu lembro que não sou nada, e que a vida de um miserável brasileiro não passa de um escravo do governo!	'to.duz us 'Di.as ki ew mi a'kOR.du, i a 'lujz du 'sOw 've~j~ ez.mu'Rar a 'mi~.Ja 'ka.ra, ew 'le~.bru ki 'na~w~ 'sow 'na.da, i ki a 'vi.da Di u~ mi.ze'ra.vew bra.zi'lej.ru 'na~w~ 'pa.sa Di u~ es'kra.vu du go'veR.nu
Quem ministra para receber aplausos, fecha acordo com o orgulho e recebe uma rubrica do diabo...	'ke~j~ mi~'nis.tra 'pa.ra Re.se'ber a'plaw.zus, 'fE.Sa a'koR.du ko~ u oR'gu.Lu i Re'sE.bi u~.ma Ru'bri.ka du Di'a.bu
Talvez um dia a vida seja pintada  de acordo com o que sonhamos...	taw'vejz u~ 'Di.a a 'vi.da 'se.Za pi~'ta.da Di a'koR.du ko~ u ki so~'Ja~.mus
Cansei de tudo que me tira o sorriso quando eu acordo querendo gargalhar.	ka~'sej Di 'tu.du ki mi 'Ti.ra u so'Ri.zu 'kwa~.du ew a'kOR.du ke're~.du gaR.ga'LaX
Clarice Lispector	kla'ri.si lis.pek'toX
A hora da Estrela	a 'O.ra da es'tre.la
Dedicatória do autor, Na verdade Clarice Lispector	de.Di.ka'tO.rja du aw'toX, na veR'da.Di kla'ri.si lis.pek'toX
Pois que dedico esta coisa ai ao antigo Schumann e sua doce Clara que são hoje ossos, ai de nós.	'pojs ki de'Di.ku 'Es.ta 'koj.za 'aj aw a~'Ti.gu 'Su~.ma~ i 'su.a 'do.si 'kla.ra ki 'sa~w~ 'o.Zi 'O.sus, 'aj Di 'nOjs
Dedico-me à cor rubra muito escarlate como o meu sangue de homem em plena idade e portanto dedico-me a meu sangue.	de'Di.ku mi a 'ko'Ru.bra 'mu~j~.tu es.kaR'la.Ti 'ko~.mu u 'mew 'sa~.gi Di 'o~.me~j~ e~j~ 'ple~.na i'da.Di i poX'ta~.tu de'Di.ku mi a 'mew 'sa~.gi
Dedico-me sobretudo aos gnomos, anões, sílfides e ninfas que me habitam a vida.	de'Di.ku mi so.bre'tu.du aws gi~'no~.mus, a~'no~j~s, 'siw.fi.Diz i 'ni~.fas ki mi a'bi.ta~w~ a 'vi.da
Dedico-me à tempestade de Beethoven.	de'Di.ku mi a te~.pes'ta.Di Di be'to.ve~
À vibração das cores neutras de Bach.	a vi.bra'sa~w~ das 'ko.ris 'new.tras Di 'baX
A Chopin que me amolece os ossos.	a So'pa~ ki mi a~.mo'lE.si uz 'O.sus
A Stravinsky que me espantou e com quem voei em fogo.	a stra'vi~s.ki ki mi es.pa~'tow i ko~ 'ke~j~ vo'ej e~j~ 'fo.gu
À Morte e Transfiguração, em que Richard Strauss me revela um destino?	a 'mOX.Ti i tra~s.fi.gu.ra'sa~w~, e~j~ ki 'Ri.SaR.Di 'straws mi Re'vE.la u~ des'Ti~.nu
Sobretudo dedico-me às vésperas de hoje e a hoje, ao transparente véu de Debussy, a Marlos Nobre, a Prokofiev, a Carl Orff, a Schönberg, aos dodecafônicos, aos gritos rascantes dos eletrônicos, a todos esses que em mim atingiram zonas assustadoramente inesperadas, todos esses profetas do presente e que a mim me vaticinaram a mim mesmo a ponto de eu neste instante explodir em: eu.	so.bre'tu.du de'Di.ku mi as 'vEs.pe.ras Di 'o.Zi i a 'o.Zi, aw tra~s.pa're~.Ti 'vEw Di de.bu'si, a 'maR.lus 'nO.bri, a pro.ko.fi'E.vi, a 'karl 'OXf, a So~'bER.gi, aws do.de.ka'fo~.ni.kus, aws 'gri.tus Ras'ka~.Tis duz e.le'tro~.ni.kus, a 'to.duz 'e.sis ki e~j~ 'mi~ a.Ti~'Zi.ra~w~ 'zo~.naz a.sus.ta.do.ra~'me~.Ti i~.nes.pe'ra.das, 'to.duz 'e.sis pro'fE.tas du pre'ze~.Ti i ki a 'mi~ mi va.Ti.si~'na.ra~w~ a 'mi~ 'mez.mu a 'po~.tu Di ew 'nes.Ti i~s'ta~.Ti es.plo'Dir e~j~, ew
Meditar não precisa de ter resultados: a meditação pode ter como fim apenas ela mesma.	me.Di'taR 'na~w~ pre'si.za Di 'te.Re.zuw'ta.dus, a me.Di.ta'sa~w~ 'pO.Di 'teX 'ko~.mu 'fi~ a'pe~.naz 'E.la 'mez.ma
Eu medito sem palavras e sobre o nada.	ew me'Di.tu se~j~ pa'la.vraz i 'so.bri u 'na.da
O que me atrapalha a vida é escrever.	u ki mi a.tra'pa.La a 'vi.da E es.kre'veX
E, e não esquecer que a estrutura do átomo não é vista mas sabe-se dela.	i, i 'na~w~ es.ke'seX ki a es.tru'tu.ra du 'a.to~.mu 'na~w~ E 'vis.ta majs 'sa.bi si 'dE.la
Sei de muita coisa que não vi.	'sej Di 'mu~j~.ta 'koj.za ki 'na~w~ 'vi
E vós também.	i 'vOjs ta~'be~j~
Não se pode dar uma prova da existência do que é mais verdadeiro, o jeito é acreditar.	'na~w~ si 'pO.Di 'dar u~.ma 'prO.va da e.zis'te~.sja du ki E 'majs veR.da'dej.ru, u 'Zej.tu E a.kre.Di'taX
Acreditar chorando.	a.kre.Di'taX So'ra~.du
Esta história acontece em estado de emergência e de calamidade pública.	'Es.ta is'tO.rja a.ko~'tE.si e~j~ es'ta.du Di e~.meR'Ze~.sja i Di ka.la~.mi'da.Di 'pu.bli.ka
Trata-se de livro inacabado porque lhe falta a resposta.	'tra.ta si Di 'li.vru i~.na.ka'ba.du puX'ke Li 'faw.ta a Res'pOs.ta
Resposta esta que espero que alguém no mundo ma dê.	Res'pOs.ta 'Es.ta ki es'pE.ru ki aw'ge~j~ nu 'mu~.du ma 'de
É uma história em tecnicolor para ter algum luxo, por Deus, que eu também preciso.	E u~.ma is'tO.rja e~j~ tEk.ni'kO.loX 'pa.ra 'ter aw'gu~ 'lu.Su, puR 'dews, ki ew ta~'be~j~ pre'si.zu
Amém para nós todos.	a~'me~j~ 'pa.ra 'nOjs 'to.dus
Tudo no mundo começou com um sim.	'tu.du nu 'mu~.du ko~.me'sow ko~ u~ 'si~
Uma molécula disse sim a outra molécula e nasceu a vida.	u~.ma mo'lE.ku.la 'Di.si 'si~ a 'ow.tra mo'lE.ku.la i na'sew a 'vi.da
Mas antes da pré-história havia a pré-história da pré-história e havia o nunca e havia o sim.	majz 'a~.Tis da 'prE is'tO.rja a'vi.a a 'prE is'tO.rja da 'prE is'tO.rja i a'vi.a u 'nu~.ka i a'vi.a u 'si~
Sempre houve.	'se~.pri 'ow.vi
Não sei o quê, mas sei que o universo jamais começou.	'na~w~ 'sej u 'ke, majs 'sej ki u u~.ni'vEX.su Za~'majs ko~.me'sow
Que ninguém se engane, só consigo a simplicidade através de muito trabalho.	ki ni~'ge~j~ si e~'ga~.ni, 'sO ko~'si.gu a si~.pli.si'da.Di a.tra'vEjs Di 'mu~j~.tu tra'ba.Lu
Enquanto eu tiver perguntas e não houver resposta continuarei a escrever.	e~'kwa~.tu ew Ti'vEX peR'gu~.taz i 'na~w~ ow'vE.Res'pOs.ta ko~.Ti~.nu.a'rej a es.kre'veX
Como começar pelo início, se as coisas acontecem antes de acontecer?	'ko~.mu ko~.me'saX 'pe.lu i~'ni.sju, si as 'koj.zaz a.ko~'tE.se~j~ 'a~.Tis Di a.ko~.te'seX
Se antes da pré-pré-história já havia os monstros apocalípticos?	si 'a~.Tis da 'prE 'prE is'tO.rja 'Za a'vi.a us 'mo~s.truz a.po.ka'lip.Ti.kus
Se esta história não existe, passará a existir.	si 'Es.ta is'tO.rja 'na~w~ e'zis.Ti, pa.sa'ra a e.zis'TiX
Pensar é um ato.	pe~'sar E u~ 'a.tu
Os dois juntos, sou eu que escrevo o que estou escrevendo.	us 'doj'Zu~.tus, 'sow ew ki es'kre.vu u ki es'tow es.kre've~.du
Deus é o mundo.	'dewz E u 'mu~.du
A verdade é sempre um contato interior e inexplicável.	a veR'da.Di E 'se~.pri u~ ko~'ta.tu i~.te.ri'or i i~.nes.pli'ka.vew
A minha vida a mais verdadeira é irreconhecível, extremamente interior e não tem uma só palavra que a signifique.	a 'mi~.Ja 'vi.da a 'majs veR.da'dej.ra E i.Re.ko~.Je'si.vew, es.tre~.ma~'me~.Ti i~.te.ri'or i 'na~w~ te~j~ u~.ma 'sO pa'la.vra ki a si.gi~.ni'fi.ki
Meu coração se esvaziou de todo desejo e reduz-se ao próprio último ou primeiro pulsar.	'mew ko.ra'sa~w~ si ez.va.zi'ow Di 'to.du de'ze.Zu i Re'dujs si aw 'prO.prju 'uw.Ti~.mu ow pri~'mej.ru puw'saX
A dor de dentes que perpassa esta história deu uma fisgada funda em plena boca nossa.	a 'doR Di 'de~.Tis ki peX'pa.sa 'Es.ta is'tO.rja 'dew u~.ma fiz'ga.da 'fu~.da e~j~ 'ple~.na 'bo.ka 'nO.sa
Então eu canto alto agudo uma melodia sincopada e estridente, é a minha própria dor, eu que carrego o mundo e há falta de felicidade.	e~'ta~w~ ew 'ka~.tu 'aw.tu a'gu.du u~.ma me.lo'Di.a si~.ko'pa.da i es.tri'de~.Ti, E a 'mi~.Ja 'prO.prja 'doX, ew ki ka'RE.gu u 'mu~.du i 'a 'faw.ta Di fe.li.si'da.Di
Nunca vi palavra mais doida, inventada pelas nordestinas que andam por aí aos montes.	'nu~.ka 'vi pa'la.vra 'majs 'doj.da, i~.ve~'ta.da 'pe.las noR.des'Ti~.nas ki 'a~.da~w~ pur a'i aws 'mo~.Tis
Como eu irei dizer agora, esta história será o resultado de uma visão gradual, há dois anos e meio venho aos poucos descobrindo os porquês.	'ko~.mu ew i'rej Di'zer a'gO.ra, 'Es.ta is'tO.rja se'ra u Re.zuw'ta.du Di u~.ma vi'za~w~ gra.du'aw, 'a 'dojz 'a~.nuz i 'mej.u 've~.Ju aws 'pow.kus des.ko'bri~.du us puX'kejs
É visão da iminência de.	E vi'za~w~ da i~.mi~'ne~.sja Di
De quê?	Di 'ke
Quem sabe se mais tarde saberei.	'ke~j~ 'sa.bi si 'majs 'taR.Di sa.be'rej
Como que estou escrevendo na hora mesma em que sou lido.	'ko~.mu ki es'tow es.kre've~.du na 'O.ra 'mez.ma e~j~ ki 'sow 'li.du
Escrevo neste instante com algum prévio pudor por vos estar invadindo com tal narrativa tão exterior e explícita.	es'kre.vu 'nes.Ti i~s'ta~.Ti ko~ aw'gu~ 'prE.vju pu'doX puR vuz es'tar i~.va'Di~.du ko~ 'taw na.Ra'Ti.va 'ta~w~ es.te.ri'or i es'pli.si.ta
De onde no entanto até sangue arfante de tão vivo de vida poderá quem sabe escorrer e logo se coagular em cubos de geléia trêmula.	Di 'o~.Di nu e~'ta~.tu a'tE 'sa~.gi aX'fa~.Ti Di 'ta~w~ 'vi.vu Di 'vi.da po.de'ra 'ke~j~ 'sa.bi es.ko'Rer i 'lO.gu si ko.a.gu'lar e~j~ 'ku.bus Di Ze'lEj.a 'tre~.mu.la
Será essa história um dia o meu coágulo?	se'ra 'E.sa is'tO.rja u~ 'Di.a u 'mew ko'a.gu.lu
Que sei eu.	ki 'sej ew
Se há veracidade nela, e é claro que a história é verdadeira embora inventada, que cada um a reconheça em si mesmo porque todos nós somos um e quem não tem pobreza de dinheiro tem pobreza de espírito ou saudade por lhe faltar coisa mais preciosa que ouro, existe a quem falte o delicado essencial.	si 'a ve.ra.si'da.Di 'nE.la, i E 'kla.ru ki a is'tO.rja E veR.da'dej.ra e~'bO.ra i~.ve~'ta.da, ki 'ka.da 'u~ a Re.ko~'Je.sa e~j~ 'si 'mez.mu puX'ke 'to.dus 'nOjs 'so~.muz 'u~ i 'ke~j~ 'na~w~ te~j~ po'bre.za Di Di~'Jej.ru te~j~ po'bre.za Di es'pi.ri.tu ow saw'da.Di puR Li faw'taX 'koj.za 'majs pre.si'O.za ki 'ow.ru, e'zis.Ti a 'ke~j~ 'faw.Ti u de.li'ka.du e.se~.si'aw
Como é que sei tudo o que vai se seguir e que ainda o desconheço, já que nunca o vivi?	'ko~.mu E ki 'sej 'tu.du u ki 'vaj si se'gir i ki a'i~.da u des.ko~'Je.su, 'Za ki 'nu~.ka u vi'vi
É que numa rua do Rio de Janeiro, peguei no ar de relaxe o sentimento de perdição no rosto de urna moça nordestina.	E ki 'nu~.ma 'Ru.a du 'Ri.u Di Za~'nej.ru, pe'gej nu 'aR Di Re'la.Si u se~.Ti~'me~.tu Di peR.Di'sa~w~ nu 'Ros.tu Di 'uR.na 'mo.sa noR.des'Ti~.na
Sem falar que eu em menino me criei no Nordeste.	se~j~ fa'laX ki ew e~j~ me~'ni~.nu mi kri'ej nu noR'dEs.Ti
Também sei das coisas por estar vivendo.	ta~'be~j~ 'sej das 'koj.zas pur es'taR vi've~.du
Quem vive sabe, mesmo sem saber que sabe.	'ke~j~ 'vi.vi 'sa.bi, 'mez.mu se~j~ sa'beX ki 'sa.bi
Assim é que os senhores sabem mais do que imaginam e estão fingindo de sonsos.	a'si~ E ki us se~'Jo.ris 'sa.be~j~ 'majs du ki i~.ma'Zi~.na~w~ i es'ta~w~ fi~'Zi~.du Di 'so~.sus
Proponho-me a que não seja complexo o que escreverei, embora obrigado a usar as palavras que vos sustentam.	pro'po~.Ju mi a ki 'na~w~ 'se.Za ko~'plEk.su u ki es.kre.ve'rej, e~'bO.ra o.bri'ga.du a u'zar as pa'la.vras ki vus sus'te~.ta~w~
A história, determino com falso livre arbítrio, vai ter uns sete personagens e eu sou um dos mais importantes deles, é claro.	a is'tO.rja, de.teR'mi~.nu ko~ 'faw.su 'li.vri aR'bi.trju, 'vaj 'ter u~s 'sE.Ti peX.so~'na.Ze~z i ew 'sow 'u~ dus 'majz i~.poX'ta~.Tis 'de.lis, E 'kla.ru
Eu, Rodrigo S. M. Relato antigo, este, pois não quero ser, modernoso e inventar modismos à guisa de originalidade.	ew, Ro'dri.gu 'E.si 'e~.mi Re'la.tu a~'Ti.gu, 'es.Ti, 'pojs 'na~w~ 'kE.ru 'seX, mo.deR'no.zu i i~.ve~'taR mo'Diz.muz a 'gi.za Di o.ri.Zi~.na.li'da.Di
Assim é que experimentarei contra os meus hábitos uma história com começo, meio e gran finale seguido de silêncio e de chuva caindo.	a'si~ E ki es.pe.ri~.me~.ta'rej 'ko~.tra us 'mewz 'a.bi.tuz u~.ma is'tO.rja ko~ ko~'me.su, 'mej.u i 'gra~ fi~'na.li se'gi.du Di si'le~.sju i Di 'Su.va ka'i~.du
História exterior e explícita, sim, mas que contém segredos, a começar por um dos títulos, Quanto ao futuro, que é precedido por um ponto final e seguido de outro ponto final.	is'tO.rja es.te.ri'or i es'pli.si.ta, 'si~, majs ki ko~'te~j~ se'gre.dus, a ko~.me'saX pur 'u~ dus 'Ti.tu.lus, 'kwa~.tu aw fu'tu.ru, ki E pre.se'Di.du pur u~ 'po~.tu fi~'naw i se'gi.du Di 'ow.tru 'po~.tu fi~'naw
Não se trata de capricho meu, no fim talvez se entenda a necessidade do delimitado.	'na~w~ si 'tra.ta Di ka'pri.Su 'mew, nu 'fi~ taw'vejs si e~'te~.da a ne.se.si'da.Di du de.li~.mi'ta.du
Mal e mal vislumbro o final que, se minha pobreza permitir, quero que seja grandioso.	'maw i 'maw viz'lu~.bru u fi~'naw ki, si 'mi~.Ja po'bre.za peR.mi'TiX, 'kE.ru ki 'se.Za gra~.Di'o.zu
Se em vez de ponto fosse seguido por reticências o título ficaria aberto a possíveis imaginações vossas, porventura até malsãs e sem piedade.	si e~j~ 'vejz Di 'po~.tu 'fo.si se'gi.du pu.Re.Ti'se~.sjaz u 'Ti.tu.lu fi.ka'ri.a a'bEX.tu a po'si.vejz i~.ma.Zi~.na'so~j~s 'vO.sas, poR.ve~'tu.ra a'tE maw'sa~j~z i se~j~ pi.e'da.Di
Bem, é verdade que também eu não tenho piedade do meu personagem principal, a nordestina: é um relato que desejo frio.	'be~j~, E veR'da.Di ki ta~'be~j~ ew 'na~w~ 'te~.Ju pi.e'da.Di du 'mew peX.so~'na.Ze~j~ pri~.si'paw, a noR.des'Ti~.na, E u~ Re'la.tu ki de'ze.Zu 'fri.u
Mas tenho o direito de ser dolorosamente frio, e não vós.	majs 'te~.Ju u Di'rej.tu Di 'seR do.lo.rO.za~'me~.Ti 'fri.u, i 'na~w~ 'vOjs
Por tudo isto é que não vos dou a vez.	puX 'tu.du 'is.tu E ki 'na~w~ vus 'dow a 'vejs
Não se trata apenas de narrativa, é antes de tudo vida primária que respira, respira; respira.	'na~w~ si 'tra.ta a'pe~.nas Di na.Ra'Ti.va, E 'a~.Tis Di 'tu.du 'vi.da pri~'ma.rja ki Res'pi.ra, Res'pi.ra, Res'pi.ra
Material poroso, um dia viverei aqui a vida de uma molécula com seu estrondo possível de átomos.	ma.te.ri'aw po'ro.zu, u~ 'Di.a vi.ve'rej a'ki a 'vi.da Di u~.ma mo'lE.ku.la ko~ 'sew es'tro~.du po'si.vew Di 'a.to~.mus
O que escrevo é mais do que invenção, é minha obrigação contar sobre essa moça entre milhares delas.	u ki es'kre.vu E 'majs du ki i~.ve~'sa~w~, E 'mi~.Ja o.bri.ga'sa~w~ ko~'taX 'so.bri 'E.sa 'mo.sa 'e~.tri mi'La.ris 'dE.las
E dever meu, nem que seja de pouca arte, o de revelar-lhe a vida.	i de'veR 'mew, ne~j~ ki 'se.Za Di 'pow.ka 'aX.Ti, u Di Re.ve'laX Li a 'vi.da
Porque há o direito ao grito.	puX'ke 'a u Di'rej.tu aw 'gri.tu
Então eu grito.	e~'ta~w~ ew 'gri.tu
Grito puro e sem pedir esmola.	'gri.tu 'pu.ru i se~j~ pe'Dir ez'mO.la
Sei que há moças que vendem o corpo, única posse real, em, troca de um bom jantar em vez de um sanduíche de mortadela.	'sej ki 'a 'mo.sas ki 've~.de~j~ u 'koX.pu, 'u~.ni.ka 'pO.si Re'aw, e~j~, 'trO.ka Di u~ 'bo~ Za~'tar e~j~ 'vejz Di u~ sa~.du'i.Si Di moX.ta'dE.la
Mas a pessoa de quem falarei mal tem corpo para vender, ninguém a quer, ela é virgem e inócua, não faz falta a ninguém.	majz a pe'so.a Di 'ke~j~ fa.la'rej 'maw te~j~ 'koX.pu 'pa.ra ve~'deX, ni~'ge~j~ a 'kEX, 'E.la E 'viR.Ze~j~ i i~.nO.kwa, 'na~w~ 'fajs 'faw.ta a ni~'ge~j~
Aliás, descubro eu agora, também eu não faço a menor falta, e até o que escrevo um outro escreveria.	a.li'ajs, des'ku.bru ew a'gO.ra, ta~'be~j~ ew 'na~w~ 'fa.su a me~'nOX 'faw.ta, i a'tE u ki es'kre.vu u~ 'ow.tru es.kre.ve'ri.a
Um outro escritor, sim, mas teria que ser homem porque escritora mulher pode lacrimejar piegas.	u~ 'ow.tru es.kri'toX, 'si~, majs te'ri.a ki 'ser 'o~.me~j~ puX'ke es.kri'to.ra mu'LEX 'pO.Di la.kri~.me'ZaX pi'E.gas
Como a nordestina, há milhares de moças espalhadas por cortiços, vagas de cama num quarto, atrás de balcões trabalhando até a estafa.	'ko~.mu a noR.des'Ti~.na, 'a mi'La.ris Di 'mo.saz es.pa'La.das puX koX'Ti.sus, 'va.gas Di 'ka~.ma nu~ 'kwaX.tu, a'trajs Di baw'ko~j~s tra.ba'La~.du a'tE a es'ta.fa
Não notam sequer que são facilmente substituíveis e que tanto existiriam como não existiriam.	'na~w~ 'nO.ta~w~ se'kEX ki 'sa~w~ fa.siw'me~.Ti subs.Ti.tu'i.vejz i ki 'ta~.tu e.zis.Ti'ri.a~w~ 'ko~.mu 'na~w~ e.zis.Ti'ri.a~w~
Poucas se queixam e ao que eu saiba nenhuma reclama por não saber a quem.	'pow.kas si 'kej.Sa~w~ i aw ki ew 'saj.ba ne~'Ju~.ma Re'kla~.ma puR 'na~w~ sa'ber a 'ke~j~
Esse quem será que existe?	'e.si 'ke~j~ se'ra ki e'zis.Ti
Estou esquentando o corpo para iniciar, esfregando as mãos uma na outra para ter coragem.	es'tow es.ke~'ta~.du u 'koX.pu 'pa.ra i~.ni.si'aX, es.fre'ga~.du as 'ma~w~z u~.ma na 'ow.tra 'pa.ra 'teX ko'ra.Ze~j~
Agora me lembrei de que houve um tempo em que para me esquentar o espírito eu rezava: o movimento é espírito.	a'gO.ra mi le~'brej Di ki 'ow.vi u~ 'te~.pu e~j~ ki 'pa.ra mi es.ke~'tar u es'pi.ri.tu ew Re'za.va, u mo.vi~'me~.tu E es'pi.ri.tu
A reza era um meio de mudamente e escondido de todos atingir-me a mim mesmo.	a 'Re.za 'E.ra u~ 'mej.u Di mu.da~'me~.Ti i es.ko~'Di.du Di 'to.duz a.Ti~'ZiX mi a 'mi~ 'mez.mu
Quando rezava conseguia um oco de alma, e esse oco é o tudo que posso eu jamais ter.	'kwa~.du Re'za.va ko~.se'gi.a u~ 'o.ku Di 'aw.ma, i 'e.si 'o.ku E u 'tu.du ki 'pO.su ew Za~'majs 'teX
Mais do que isso, nada.	'majs du ki 'i.su, 'na.da
Mas o vazio tem o valor e a semelhança do pleno.	majz u va'zi.u te~j~ u va'lor i a se~.me'La~.sa du 'ple~.nu
Um meio de obter é não procurar, um meio de ter é o de não pedir e somente acreditar que a silêncio que eu creio em mim é resposta a meu, a meu mistério.	u~ 'mej.u Di ob'ter E 'na~w~ pro.ku'raX, u~ 'mej.u Di 'ter E u Di 'na~w~ pe'Dir i sO~'me~.Ti a.kre.Di'taX ki a si'le~.sju ki ew 'krej.u e~j~ 'mi~ E Res'pOs.ta a 'mew, a 'mew mis'tE.rju
Pretendo, como já insinuei, escrever de modo cada vez mais simples.	pre'te~.du, 'ko~.mu 'Za i~.si~.nu'ej, es.kre'veR Di 'mO.du 'ka.da 'vejz 'majs 'si~.plis
Aliás o material de que disponho é parco e singelo demais, as informações sobre os personagens são poucas e nâo muito elucidativas, informações essas que penosamente me vêm de mim para mim mesmo, é trabalho de carpintaria.	a.li'ajz u ma.te.ri'aw Di ki Dis'po~.Ju E 'paX.ku i si~'ZE.lu de~'majs, az i~.foR.ma'so~j~s 'so.bri us peX.so~'na.Ze~s 'sa~w~ 'pow.kaz i 'na~w~ 'mu~j~.tu e.lu.si.da'Ti.vas, i~.foR.ma'so~j~z 'E.sas ki pe~.nO.za~'me~.Ti mi 've~j~ Di 'mi~ 'pa.ra 'mi~ 'mez.mu, E tra'ba.Lu Di kaX.pi~.ta'ri.a
Sim, mas não esquecer que para escrever não-importa-o-quê o meu material básico é a palavra.	'si~, majs 'na~w~ es.ke'seX ki 'pa.ra es.kre'veR 'na~w~ i~.poX'ta u 'ke u 'mew ma.te.ri'aw 'ba.zi.ku E a pa'la.vra
Assim é que esta história será feita de palavras que se agrupam em frases e destas se evola um sentido secreto que ultrapassa palavras e frases.	a'si~ E ki 'Es.ta is'tO.rja se'ra 'fej.ta Di pa'la.vras ki si a'gru.pa~w~ e~j~ 'fra.ziz i 'dEs.tas si e'vO.la u~ se~'Ti.du se'krE.tu ki uw.tra'pa.sa pa'la.vraz i 'fra.zis
É claro que, como todo escritor, tenho a tentação de usar termos suculentos: conheço adjetivos esplendorosos, carnudos substantivos e verbos tão esguios que atravessam agudos o ar em vias de ação, já que palavra é ação, concordais?	E 'kla.ru ki, 'ko~.mu 'to.du es.kri'toX, 'te~.Ju a te~.ta'sa~w~ Di u'zaX 'teR.mus su.ku'le~.tus, ko~'Je.su a.Di.Ze'Ti.vuz es.ple~.do'rO.zus, kaR'nu.dus subs.ta~'Ti.vuz i 'vER.bus 'ta~w~ ez'gi.us ki a.tra'vE.sa~w~ a'gu.duz u 'ar e~j~ 'vi.as Di a'sa~w~, 'Za ki pa'la.vra E a'sa~w~, ko~.koR'dajs
Mas não vou enfeitar a palavra pois se eu tocar no pão da moça esse pão se tornará em ouro, e á jovem (ela tem dezenove anos) e a jovem não poderia mordê-lo, morrendo de fome.	majs 'na~w~ 'vow e~.fej'tar a pa'la.vra 'pojs si ew to'kaR nu 'pa~w~ da 'mo.sa 'e.si 'pa~w~ si toR.na'ra e~j~ 'ow.ru, i a 'ZO.ve~j~, 'E.la te~j~ de.ze~'nO.vi 'a~.nus, i a 'ZO.ve~j~ 'na~w~ po.de'ri.a moR'de lu, mo'Re~.du Di 'fo~.mi
Tenho então que falar simples para captar a sua delicada e vaga existência.	'te~.Ju e~'ta~w~ ki fa'laX 'si~.plis 'pa.ra kap'tar a 'su.a de.li'ka.da i 'va.ga e.zis'te~.sja
Limito-me a humildemente, mas sem fazer estardalhaço de minha humildade que já não seria humildade, limito-me a contar as fracas aventuras de uma moça numa cidade toda feita contra ela.	li~'mi.tu mi a u~.miw.Di~'me~.Ti, majs se~j~ fa'zer es.taR.da'La.su Di 'mi~.Ja u~.miw'da.Di ki 'Za 'na~w~ se'ri.a u~.miw'da.Di, li~'mi.tu mi a ko~'tar as 'fra.kaz a.ve~'tu.ras Di u~.ma 'mo.sa 'nu~.ma si'da.Di 'to.da 'fej.ta 'ko~.tra 'E.la
Ela, que deveria ter ficado no sertão de Alagoas com vestido de chita e sem nenhuma: datilografia, já que escrevia tão mal, só tinha até o terceiro ano primário.	'E.la, ki de.ve'ri.a 'teX fi'ka.du nu seX'ta~w~ Di a.la'go.as ko~ ves'Ti.du Di 'Si.ta i se~j~ ne~'Ju~.ma, da.Ti.lo.gra'fi.a, 'Za ki es.kre'vi.a 'ta~w~ 'maw, 'sO 'Ti~.Ja a'tE u teX'sej.ru 'a~.nu pri~'ma.rju
Por ser ignorante era obrigada na datilografia a copiar lentamente letra por letra, a tia é que lhe dera um curso ralo de como bater à máquina.	puX 'ser i.gi~.no'ra~.Ti 'E.ra o.bri'ga.da na da.Ti.lo.gra'fi.a a ko.pi'aR le~.ta~'me~.Ti 'le.tra puR 'le.tra, a 'Ti.a E ki Li 'dE.ra u~ 'kuX.su 'Ra.lu Di 'ko~.mu ba'ter a 'ma.ki~.na
E a moça ganhara uma dignidade: era enfim datilógrafa.	i a 'mo.sa ga~'Ja.ra u~.ma Di.gi~.ni'da.Di, 'E.ra e~'fi~ da.Ti'lO.gra.fa
Embora, ao que parece, não aprovasse na linguagem duas consoantes juntas e copiava a letra linda e redonda do amado chefe a palavra designar de modo como em língua falada diria: desiguinar.	e~'bO.ra, aw ki pa'rE.si, 'na~w~ a.pro'va.si na li~'gwa.Ze~j~ 'du.as ko~.so'a~.Ti'Zu~.taz i ko.pi'a.va a 'le.tra 'li~.da i Re'do~.da du a~'ma.du 'SE.fi a pa'la.vra de.zi.gi~'naR Di 'mO.du 'ko~.mu e~j~ 'li~.gwa fa'la.da Di'ri.a, de.zi.gi~'naX
Desculpai-me mas vou continuar a falar de mim que sou meu desconhecido, e ao escrever me surpreendo um pouco pois descobri que tenho um destino.	des.kuw'paj mi majs 'vow ko~.Ti~.nu'ar a fa'laR Di 'mi~ ki 'sow 'mew des.ko~.Je'si.du, i aw es.kre'veR mi suX.pre'e~.du u~ 'pow.ku 'pojs des.ko'bri ki 'te~.Ju u~ des'Ti~.nu
Quem já não se perguntou: sou um monstro ou isto é ser uma pessoa?	'ke~j~ 'Za 'na~w~ si peR.gu~'tow, 'sow u~ 'mo~s.tru ow 'is.tu E 'ser u~.ma pe'so.a
Quero antes afiançar que essa moça não se conhece senão através de ir vivendo à toa.	'kE.ru 'a~.Tiz a.fi.a~'saX ki 'E.sa 'mo.sa 'na~w~ si ko~'JE.si se~'na~w~ a.tra'vEjs Di 'iR vi've~.du a 'to.a
Se tivesse a tolice de se perguntar quem sou eu? cairia estatelada e em cheio no chão.	si Ti'vE.si a to'li.si Di si peR.gu~'taX 'ke~j~ 'sow ew, kaj'ri.a es.ta.te'la.da i e~j~ 'Sej.u nu 'Sa~w~
É que quem sou eu? provoca necessidade.	E ki 'ke~j~ 'sow ew, pro'vO.ka ne.se.si'da.Di
E como satisfazer a necessidade?	i 'ko~.mu sa.Tis.fa'zer a ne.se.si'da.Di
Quem se indaga é incompleto.	'ke~j~ si i~'da.ga E i~.ko~'plE.tu
A pessoa de quem vou falar é tão tola que às vezes sorri para os outros na rua.	a pe'so.a Di 'ke~j~ 'vow fa'lar E 'ta~w~ 'to.la ki as 've.zis so'Ri 'pa.ra uz 'ow.trus na 'Ru.a
Ninguém lhe responde ao sorriso porque nem ao menos a olham.	ni~'ge~j~ Li Res'po~.Di aw so'Ri.zu puX'ke ne~j~ aw 'me~.nuz a 'O.La~w~
Voltando a mim: o que escreverei não pode ser absorvido por mentes que muito exijam e ávidas de requintes.	vow'ta~.du a 'mi~, u ki es.kre.ve'rej 'na~w~ 'pO.Di 'ser ab.soR'vi.du puR 'me~.Tis ki 'mu~j~.tu e'zi.Za~w~ i 'a.vi.das Di Re'ki~.Tis
Pois o que estarei dizendo será apenas nu.	'pojz u ki es.ta'rej Di'ze~.du se'ra a'pe~.nas 'nu
Embora tenha como pano de fundo, e agora mesmo, a, penumbra atormentada que sempre há nos meus sonhos quando de noite atormentado durmo.	e~'bO.ra 'te~.Ja 'ko~.mu 'pa~.nu Di 'fu~.du, i a'gO.ra 'mez.mu, a, pe~'nu~.bra a.toR.me~'ta.da ki 'se~.pri 'a nus 'mews 'so~.Jus 'kwa~.du Di 'noj.Ti a.toR.me~'ta.du 'duR.mu
Que não se esperem, então, estrelas no que se segue: nada cintilará, trata-se de matéria opaca e por sua própria natureza desprezível por todos.	ki 'na~w~ si es'pE.re~j~, e~'ta~w~, es'tre.las nu ki si 'sE.gi, 'na.da si~.Ti.la'ra, 'tra.ta si Di ma'tE.rja o'pa.ka i puX 'su.a 'prO.prja na.tu're.za des.pre'zi.vew puX 'to.dus
É que a esta história falta melodia cantabile.	E ki a 'Es.ta is'tO.rja 'faw.ta me.lo'Di.a ka~.ta'bi.li
O seu ritmo é às vezes descompassado.	u 'sew 'Ri.Ti~.mu E as 've.zis des.ko~.pa'sa.du
E tem fatos.	i te~j~ 'fa.tus
Apaixonei-me subitamente por fatos sem literatura, fatos são pedras duras e agir está me interessando mais do que pensar, de fatos não há como fugir.	a.paj.So~'nej mi su.bi.ta~'me~.Ti puX 'fa.tus se~j~ li.te.ra'tu.ra, 'fa.tus 'sa~w~ 'pE.dras 'du.raz i a'Zir es'ta mi i~.te.re'sa~.du 'majs du ki pe~'saX, Di 'fa.tus 'na~w~ 'a 'ko~.mu fu'ZiX
Pergunto-me se eu deveria caminhar à frente do tempo e esboçar logo um final.	peR'gu~.tu mi si ew de.ve'ri.a ka~.mi~'Jar a 'fre~.Ti du 'te~.pu i ez.bo'saR 'lO.gu u~ fi~'naw
Acontece porém que eu mesmo ainda não sei bem como esse isto terminará.	a.ko~'tE.si po're~j~ ki ew 'mez.mu a'i~.da 'na~w~ 'sej 'be~j~ 'ko~.mu 'e.si 'is.tu teR.mi~.na'ra
E também porque entendo que devo caminhar passo a passo de acordo com um prazo determinado por horas: até um bicho lida com o tempo.	i ta~'be~j~ puX'ke e~'te~.du ki 'de.vu ka~.mi~'JaX 'pa.su a 'pa.su Di a'koR.du ko~ u~ 'pra.zu de.teR.mi~'na.du pur 'O.ras, a'tE u~ 'bi.Su 'li.da ko~ u 'te~.pu
E esta é também a minha mais primeira condição: a de caminhar paulatinamente apesar da impaciência que tenho em relação a essa moça.	i 'Es.ta E ta~'be~j~ a 'mi~.Ja 'majs pri~'mej.ra ko~.Di'sa~w~, a Di ka~.mi~'JaX paw.la.Ti~.na~'me~.Ti a.pe'zaR da i~.pa.si'e~.sja ki 'te~.Ju e~j~ Re.la'sa~w~ a 'E.sa 'mo.sa
Com esta história eu vou me sensibilizar, e bem sei que cada dia é um dia roubado da morte.	ko~ 'Es.ta is'tO.rja ew 'vow mi se~.si.bi.li'zaX, i 'be~j~ 'sej ki 'ka.da 'Di.a E u~ 'Di.a Row'ba.du da 'mOX.Ti
Eu não, sou um intelectual, escrevo com o corpo.	ew 'na~w~, 'sow u~ i~.te.lek.tu'aw, es'kre.vu ko~ u 'koX.pu
E o que escrevo é uma névoa úmida.	i u ki es'kre.vu E u~.ma 'nE.vo.a 'u~.mi.da
As palavras são sons transfundidos de sombras que se entrecruzam desiguais, estalactites, renda, música transfigurada de órgão.	as pa'la.vras 'sa~w~ 'so~s tra~s.fu~'Di.dus Di 'so~.bras ki si e~.tre'kru.za~w~ de.zi'gwajs, es.ta.lak'Ti.Tis, 'Re~.da, 'mu.zi.ka tra~s.fi.gu'ra.da Di 'OR.ga~w~
Mal ouso clamar palavras a essa rede vibrante e rica, mórbida e obscura tendo como contratom o , baixo grosso da dor.	'maw 'ow.zu kla~'maX pa'la.vraz a 'E.sa 'Re.Di vi'bra~.Ti i 'Ri.ka, 'mOR.bi.da i obs'ku.ra 'te~.du 'ko~.mu ko~.tra'to~ u, 'baj.Su 'gro.su da 'doX
Alegro com brio.	a'lE.gru ko~ 'bri.u
Tentarei tirar duro do carvão.	te~.ta'rej Ti'raR 'du.ru du kaR'va~w~
Sei que estou adiando a história e que brinco de bola sem a bola.	'sej ki es'tow a.Di'a~.du a is'tO.rja i ki 'bri~.ku Di 'bO.la se~j~ a 'bO.la
O fato é um ato?	u 'fa.tu E u~ 'a.tu
Juro que este livro é feito sem palavras.	'Zu.ru ki 'es.Ti 'li.vru E 'fej.tu se~j~ pa'la.vras
É uma fotografia muda.	E u~.ma fo.to.gra'fi.a 'mu.da
Este livro é uma pergunta.	'es.Ti 'li.vru E u~.ma peR'gu~.ta
Mas desconfio que toda essa conversa é feita apenas para adiar a pobreza da história, pois estou com medo.	majs des.ko~'fi.u ki 'to.da 'E.sa ko~'vEX.sa E 'fej.ta a'pe~.nas 'pa.ra a.Di'ar a po'bre.za da is'tO.rja, 'pojz es'tow ko~ 'me.du
Antes de ter surgido na minha vida essa datilógrafa, eu era um homem até mesmo um pouco contente, apesar do mau êxito na minha literatura.	'a~.Tis Di 'teX suR'Zi.du na 'mi~.Ja 'vi.da 'E.sa da.Ti'lO.gra.fa, ew 'E.ra u~ 'o~.me~j~ a'tE 'mez.mu u~ 'pow.ku ko~'te~.Ti, a.pe'zaR du 'maw 'e.zi.tu na 'mi~.Ja li.te.ra'tu.ra
As coisas estavam de algum modo tão boas que podiam se tornar muito ruins porque o que amadurece plenamente pode ,apodrecer.	as 'koj.zaz es'ta.va~w~ Di aw'gu~ 'mO.du 'ta~w~ 'bo.as ki po'Di.a~w~ si toR'naR 'mu~j~.tu Ru'i~s puX'ke u ki a~.ma.du'rE.si ple~.na~'me~.Ti 'pO.Di, a.po.dre'seX
Transgredir, porém, os meus próprios limites me fascinou de repente.	tra~z.gre'DiX, po're~j~, us 'mews 'prO.prjus li~'mi.Tis mi fa.si~'now Di Re'pe~.Ti
E foi quando pensei em escrever sobre a realidade, já que essa me ultrapassa.	i 'foj 'kwa~.du pe~'sej e~j~ es.kre'veX 'so.bri a Re.a.li'da.Di, 'Za ki 'E.sa mi uw.tra'pa.sa
Qualquer que seja o que quer dizer realidade.	kwaw'kEX ki 'se.Za u ki 'kER Di'ze.Re.a.li'da.Di
O que narrarei será meloso?	u ki na.Ra'rej se'ra me'lo.zu
Tem tendência mas então agora mesmo seco e endureço tudo.	te~j~ te~'de~.sja majz e~'ta~w~ a'gO.ra 'mez.mu 'sE.ku i e~.du're.su 'tu.du
E pelo menos o que escrevo não pede favor a ninguém e não implora socorro: aguenta-se na sua chamada dor com uma dignidade de barão.	i 'pe.lu 'me~.nuz u ki es'kre.vu 'na~w~ 'pE.Di fa'vor a ni~'ge~j~ i 'na~w~ i~'plO.ra so'ko.Ru, a'gwe~.ta si na 'su.a Sa~'ma.da 'doX ko~ u~.ma Di.gi~.ni'da.Di Di ba'ra~w~
Parece que estou mudando de modo de escrever.	pa'rE.si ki es'tow mu'da~.du Di 'mO.du Di es.kre'veX
Mas acontece que só escrevo o que quero, não sou um profissional, e preciso falar dessa nordestina senão sufoco.	majz a.ko~'tE.si ki 'sO es'kre.vu u ki 'kE.ru, 'na~w~ 'sow u~ pro.fi.si.o~'naw, i pre'si.zu fa'laR 'dE.sa noR.des'Ti~.na se~'na~w~ su'fo.ku
Ela me acusa e o meio de me defender é escrever sobre ela.	'E.la mi a'ku.za i u 'mej.u Di mi de.fe~'der E es.kre'veX 'so.bri 'E.la
Escrevo em traços vivos e ríspidos de pintura.	es'kre.vu e~j~ 'tra.sus 'vi.vuz i 'Ris.pi.dus Di pi~'tu.ra
Estarei lidando com fatos como se fossem as irremediáveis pedras de que falei.	es.ta'rej li'da~.du ko~ 'fa.tus 'ko~.mu si 'fo.se~j~ az i.Re~.me.Di'a.vejs 'pE.dras Di ki fa'lej
E que anjos esvoacem em vespas transparentes em torno de minha cabeça quente porque esta quer enfim se transformar em objeto-coisa, é mais fácil.	i ki 'a~.Zuz ez.vo'a.se~j~ e~j~ 'ves.pas tra~s.pa're~.Tiz e~j~ 'toR.nu Di 'mi~.Ja ka'be.sa 'ke~.Ti puX'ke 'Es.ta 'kEr e~'fi~ si tra~s.foR'mar e~j~ ob'ZE.tu 'koj.za, E 'majs 'fa.siw
Será mesmo que a ação ultrapassa a palavra?	se'ra 'mez.mu ki a a'sa~w~ uw.tra'pa.sa a pa'la.vra
Mas que ao escrever, que o nome real seja dado às coisas.	majs ki aw es.kre'veX, ki u 'no~.mi Re'aw 'se.Za 'da.du as 'koj.zas
Cada coisa é uma palavra.	'ka.da 'koj.za E u~.ma pa'la.vra
E quando não se a tem, inventar-se-á.	i 'kwa~.du 'na~w~ si a te~j~, i~.ve~'taX si 'a
Esse vosso Deus que nos mandou inventar.	'e.si 'vO.su 'dews ki nus ma~'dow i~.ve~'taX
Por que escrevo?	puX 'ke es'kre.vu
Antes de tudo porque captei o espírito da língua e assim às vezes a forma é que faz conteúdo.	'a~.Tis Di 'tu.du puX'ke kap'tej u es'pi.ri.tu da 'li~.gwa i a'si~ as 've.ziz a 'fOR.ma E ki 'fajs ko~.te'u.du
Escrevo portanto não por causa da nordestina mas por motivo grave de força maior, como se diz nos requerimentos oficiais, por força de lei.	es'kre.vu poX'ta~.tu 'na~w~ puX 'kaw.za da noR.des'Ti~.na majs puR mo'Ti.vu 'gra.vi Di 'foX.sa maj'OX, 'ko~.mu si 'Diz nus Re.ke.ri~'me~.tuz o.fi.si'ajs, puX 'foX.sa Di 'lej
Sim, minha força está na solidão.	'si~, 'mi~.Ja 'foX.sa es'ta na so.li'da~w~
Não tenho medo nem de chuvas tempestivas nem das grandes ventanias soltas, pois eu também sou ó escuro da noite.	'na~w~ 'te~.Ju 'me.du ne~j~ Di 'Su.vas te~.pes'Ti.vas ne~j~ das 'gra~.Dis ve~.ta~'ni.as 'sow.tas, 'pojz ew ta~'be~j~ 'sow 'O es'ku.ru da 'noj.Ti
Embora não aguente bem ouvir um assovio no escuro, e passos.	e~'bO.ra 'na~w~ a'gwe~.Ti 'be~j~ ow'vir u~ a.so'vi.u nu es'ku.ru, i 'pa.sus
lembro-me de uma namorada: era moça-mulher e que escuridão dentro de seu corpo.	'le~.bru mi Di u~.ma na~.mo'ra.da, 'E.ra 'mo.sa mu'LEr i ki es.ku.ri'da~w~ 'de~.tru Di 'sew 'koX.pu
Nunca a esqueci: jamais se esquece a pessoa com quem se dormiu.	'nu~.ka a es.ke'si, Za~'majs si es'kE.si a pe'so.a ko~ 'ke~j~ si doR'miw
O acontecimento fica tatuado em marca de fogo na carne viva e todos os que percebem o estigma fogem com horror.	u a.ko~.te.si~'me~.tu 'fi.ka ta.tu'a.du e~j~ 'maX.ka Di 'fo.gu na 'kaR.ni 'vi.va i 'to.duz us ki peX'sE.be~j~ u es'Ti.gi~.ma 'fO.Ze~j~ ko~ o'RoX
Quero neste instante falar da nordestina.	'kE.ru 'nes.Ti i~s'ta~.Ti fa'laR da noR.des'Ti~.na
É o seguinte: ela como uma cadela vadia era teleguiada exclusivamente por si mesma.	E u se'gi~.Ti, 'E.la 'ko~.mu u~.ma ka'dE.la va'Di.a 'E.ra te.le.gi'a.da es.klu.zi.va~'me~.Ti puX 'si 'mez.ma
Pois reduzira-se a si.	'pojs Re.du'zi.ra si a si
Também eu, de fracasso em fracasso, me reduzi a mim mas pelo menos quero encontrar o mundo e seu Deus.	ta~'be~j~ ew, Di fra'ka.su e~j~ fra'ka.su, mi Re.du'zi a 'mi~ majs 'pe.lu 'me~.nus 'kE.ru e~.ko~'trar u 'mu~.du i 'sew 'dews
Quero acrescentar, à guisa de informações sobre a jovem e sobre mim, que vivemos exclusivamente no presente pois sempre e eternamente é o dia de hoje, e o dia de amanhã será um hoje, a eternidade é o estado das coisas neste momento.	'kE.ru a.kre.se~'taX, a 'gi.za Di i~.foR.ma'so~j~s 'so.bri a 'ZO.ve~j~ i 'so.bri 'mi~, ki vi've~.muz es.klu.zi.va~'me~.Ti nu pre'ze~.Ti 'pojs 'se~.pri i e.tER.na~'me~.Ti E u 'Di.a Di 'o.Zi, i u 'Di.a Di a~.ma~'Ja~ se'ra u~ 'o.Zi, a e.teR.ni'da.Di E u es'ta.du das 'koj.zas 'nes.Ti mo~'me~.tu
E eis que fiquei agora receoso quando pus palavras sobre a nordestina.	i 'ejs ki fi'kej a'gO.ra Re.se'o.zu 'kwa~.du 'pujs pa'la.vras 'so.bri a noR.des'Ti~.na
E a pergunta é: como escrevo?	i a peR'gu~.ta E, 'ko~.mu es'kre.vu
Verifico que escrevo de ouvido assim como aprendi inglês e francês de ouvido.	ve.ri'fi.ku ki es'kre.vu Di ow'vi.du a'si~ 'ko~.mu a.pre~'Di i~'glejz i fra~'sejs Di ow'vi.du
Antecedentes meus do escrever?	a~.te.se'de~.Tis 'mews du es.kre'veX
sou um homem que tem mais dinheiro do que os que passam fome, o que faz de mim de algum modo um desonesto.	'sow u~ 'o~.me~j~ ki te~j~ 'majs Di~'Jej.ru du ki us ki 'pa.sa~w~ 'fo~.mi, u ki 'fajz Di 'mi~ Di aw'gu~ 'mO.du u~ de.zo~'nEs.tu
E só minto na hora exata da mentira.	i 'sO 'mi~.tu na 'O.ra e'za.ta da me~'Ti.ra
Mas quando escrevo não minto.	majs 'kwa~.du es'kre.vu 'na~w~ 'mi~.tu
Que mais?	ki 'majs
Sim, não tenho classe social, marginalizado que sou.	'si~, 'na~w~ 'te~.Ju 'kla.si so.si'aw, maR.Zi~.na.li'za.du ki 'sow
A classe alta me tem como um monstro esquisito, a média com desconfiança de que eu possa desequilibrá-la, a classe baixa nunca vem a mim.	a 'kla.si 'aw.ta mi te~j~ 'ko~.mu u~ 'mo~s.tru es.ki'zi.tu, a 'mE.Dja ko~ des.ko~.fi'a~.sa Di ki ew 'pO.sa de.ze.ki.li'bra la, a 'kla.si 'baj.Sa 'nu~.ka 've~j~ a 'mi~
Não, não é fácil escrever.	'na~w~, 'na~w~ E 'fa.siw es.kre'veX
É duro como quebrar rochas.	E 'du.ru 'ko~.mu ke'bra'RO.Sas
Mas voam faíscas e lascas como aços espelhados.	majs 'vo.a~w~ fa'is.kaz i 'las.kas 'ko~.mu 'a.suz es.pe'La.dus
Ah que medo de começar e ainda nem sequer sei o nome da moça.	'a ki 'me.du Di ko~.me'sar i a'i~.da ne~j~ se'kEX 'sej u 'no~.mi da 'mo.sa
Sem falar que a história me desespera por ser simples demais.	se~j~ fa'laX ki a is'tO.rja mi de.zes'pE.ra puX 'seX 'si~.plis de~'majs
O que me proponho contar parece fácil e à mão de todos.	u ki mi pro'po~.Ju ko~'taX pa'rE.si 'fa.siw i a 'ma~w~ Di 'to.dus
Mas a sua elaboração é muito difícil.	majz a 'su.a e.la.bo.ra'sa~w~ E 'mu~j~.tu Di'fi.siw
Pois tenho que tornar nítido o que está quase apagado e que mal vejo.	'pojs 'te~.Ju ki toR'naR 'ni.Ti.du u ki es'ta 'kwa.zi a.pa'ga.du i ki 'maw 've.Zu
Com mãos de dedos duros enlameados apalpar o invisível na própria lama.	ko~ 'ma~w~s Di 'de.dus 'du.ruz e~.la~.me'a.duz a.paw'par u i~.vi'zi.vew na 'prO.prja 'la~.ma
De uma coisa tenho certeza: essa narrativa mexerá com uma coisa delicada: a criação de uma pessoa inteira que na certa está tão viva quanto eu.	Di u~.ma 'koj.za 'te~.Ju seX'te.za, 'E.sa na.Ra'Ti.va me.Se'ra ko~ u~.ma 'koj.za de.li'ka.da, a kri.a'sa~w~ Di u~.ma pe'so.a i~'tej.ra ki na 'sEX.ta es'ta 'ta~w~ 'vi.va 'kwa~.tu ew
Cuidai dela porque meu poder é só mostrá-la para que vós a reconheçais na rua, andando de leve por causa da esvoaçada magreza:	kuj'daj 'dE.la puX'ke 'mew po'der E 'sO mos'tra la 'pa.ra ki 'vOjz a Re.ko~.Je'sajs na 'Ru.a, a~'da~.du Di 'lE.vi puX 'kaw.za da ez.vo.a'sa.da ma'gre.za
E se for triste a minha narrativa?	i si 'foX 'tris.Ti a 'mi~.Ja na.Ra'Ti.va
Depois na certa escreverei algo alegre, embora alegre por quê?	de'pojs na 'sEX.ta es.kre.ve'rej 'aw.gu a'lE.gri, e~'bO.ra a'lE.gri puX 'ke
Porque também sou um homem de hosanas e um dia, quem sabe, cantarei loas que não as dificuldades da nordestina.	puX'ke ta~'be~j~ 'sow u~ 'o~.me~j~ Di o'za~.naz i u~ 'Di.a, 'ke~j~ 'sa.bi, ka~.ta'rej 'lo.as ki 'na~w~ as Di.fi.kuw'da.Dis da noR.des'Ti~.na
Por enquanto quero andar nu ou em farrapos, quero experimentar pelo menos uma vez a falta de gosto que dizem ter a hóstia.	pur e~'kwa~.tu 'kE.ru a~'daR 'nu ow e~j~ fa'Ra.pus, 'kE.ru es.pe.ri~.me~'taX 'pe.lu 'me~.nuz u~.ma 'vejz a 'faw.ta Di 'gos.tu ki 'Di.ze~j~ 'ter a 'Os.Tja
Comer a hóstia será sentir o insosso do mundo e banhar-se no não.	ko~'mer a 'Os.Tja se'ra se~'Tir u i~'so.su du 'mu~.du i ba~'JaX si nu 'na~w~
Isso será coragem minha, a de abandonar sentimentos antigos já confortáveis.	'i.su se'ra ko'ra.Ze~j~ 'mi~.Ja, a Di a.ba~.do~'naX se~.Ti~'me~.tuz a~'Ti.gu'Za ko~.foX'ta.vejs
Agora não é confortável: para falar da moça tenho que não fazer a barba, durante dias e adquirir olheiras escuras por dormir pouco, só cochilar de pura exaustão, sou um trabalhador manual.	a'gO.ra 'na~w~ E ko~.foX'ta.vew, 'pa.ra fa'laR da 'mo.sa 'te~.Ju ki 'na~w~ fa'zer a 'baR.ba, du'ra~.Ti 'Di.az i a.Di.ki'rir o'Lej.raz es'ku.ras puR doR'miX 'pow.ku, 'sO ko.Si'laR Di 'pu.ra e.zaws'ta~w~, 'sow u~ tra.ba.La'doR ma~.nu'aw
Além de vestir-me com roupa velha rasgada.	a'le~j~ Di ves'TiX mi ko~ 'Row.pa 'vE.La Raz'ga.da
Tudo isso para me pôr no nível da nordestina.	'tu.du 'i.su 'pa.ra mi 'poR nu 'ni.vew da noR.des'Ti~.na
Sabendo no entanto que talvez eu tivesse que me apresentar de modo mais convincente às sociedades que muito reclamam de quem está neste instante mesmo batendo à máquina.	sa'be~.du nu e~'ta~.tu ki taw'vejz ew Ti'vE.si ki mi a.pre.ze~'taR Di 'mO.du 'majs ko~.vi~'se~.Ti as so.si.e'da.Dis ki 'mu~j~.tu Re'kla~.ma~w~ Di 'ke~j~ es'ta 'nes.Ti i~s'ta~.Ti 'mez.mu ba'te~.du a 'ma.ki~.na
Tudo isso, sim, a história é história.	'tu.du 'i.su, 'si~, a is'tO.rja E is'tO.rja
Mas sabendo antes para nunca esquecer que a palavra é fruto da palavra.	majs sa'be~.du 'a~.Tis 'pa.ra 'nu~.ka es.ke'seX ki a pa'la.vra E 'fru.tu da pa'la.vra
A palavra tem que se parecer com a palavra.	a pa'la.vra te~j~ ki si pa.re'seX ko~ a pa'la.vra
Atingi-la é o meu primeiro dever para comigo.	a.Ti~'Zi la E u 'mew pri~'mej.ru de'veX 'pa.ra ko~'mi.gu
E a palavra não pode ser enfeitada e artisticamente vã, tem que ser apenas ela.	i a pa'la.vra 'na~w~ 'pO.Di 'ser e~.fej'ta.da i aX.Tis.Ti.ka~'me~.Ti 'va~, te~j~ ki 'ser a'pe~.naz 'E.la
Bem, é verdade que também queria alcançar uma sensação fina e que esse finíssimo não se quebrasse em linha perpétua.	'be~j~, E veR'da.Di ki ta~'be~j~ ke'ri.a aw.ka~'sar u~.ma se~.sa'sa~w~ 'fi~.na i ki 'e.si fi~'ni.si~.mu 'na~w~ si ke'bra.si e~j~ 'li~.Ja peX'pE.twa
Ao mesmo tempo que quero também alcançar o trombone mais grosso e baixo, grave e terra, tão a troco de nada que por nervosismo de escrever eu tivesse um acesso incontrolável de riso vindo do peito.	aw 'mez.mu 'te~.pu ki 'kE.ru ta~'be~j~ aw.ka~'sar u tro~'bo~.ni 'majs 'gro.su i 'baj.Su, 'gra.vi i 'tE.Ra, 'ta~w~ a 'tro.ku Di 'na.da ki puR neR.vo'ziz.mu Di es.kre'ver ew Ti'vE.si u~ a'sE.su i~.ko~.tro'la.vew Di 'Ri.zu 'vi~.du du 'pej.tu
E quero aceitar minha liberdade sem pensar o que muitos acham: que existir é coisa de doido, caso de loucura.	i 'kE.ru a.sej'taR 'mi~.Ja li.beR'da.Di se~j~ pe~'sar u ki 'mu~j~.tuz 'a.Sa~w~, ki e.zis'Tir E 'koj.za Di 'doj.du, 'ka.zu Di low'ku.ra
Porque parece.	puX'ke pa'rE.si
Existir não é lógico.	e.zis'TiR 'na~w~ E 'lO.Zi.ku
A ação desta história terá como resultado minha transfiguração em outrem e minha materialização enfim em objeto.	a a'sa~w~ 'dEs.ta is'tO.rja te'ra 'ko~.mu Re.zuw'ta.du 'mi~.Ja tra~s.fi.gu.ra'sa~w~ e~j~ 'ow.tre~j~ i 'mi~.Ja ma.te.ri.a.li.za'sa~w~ e~'fi~ e~j~ ob'ZE.tu
Sim, e talvez alcance a flauta doce em que eu me enovelarei em macio cipó.	'si~, i taw'vejz aw'ka~.si a 'flaw.ta 'do.si e~j~ ki ew mi e~.no.ve.la'rej e~j~ ma'si.u si'pO
Mas voltemos a hoje.	majs vow'te~.muz a 'o.Zi
Porque, como se sabe, hoje é hoje.	puX'ke, 'ko~.mu si 'sa.bi, 'o.Zi E 'o.Zi
Não estão me entendendo e eu ouço escuro que estão rindo de mim em risos rápidos e ríspidos de velhos.	'na~w~ es'ta~w~ mi e~.te~'de~.du i ew 'ow.su es'ku.ru ki es'ta~w~ 'Ri~.du Di 'mi~ e~j~ 'Ri.zus 'Ra.pi.duz i 'Ris.pi.dus Di 'vE.Lus
E ouço passos cadenciados na rua:	i 'ow.su 'pa.sus ka.de~.si'a.dus na 'Ru.a
Tenho um arrepio de medo.	'te~.Ju u~ a.Re'pi.u Di 'me.du
Ainda bem que o que eu vou escrever já deve estar na certa de algum modo escrito em mim.	a'i~.da 'be~j~ ki u ki ew 'vow es.kre'veR 'Za 'dE.vi es'taR na 'sEX.ta Di aw'gu~ 'mO.du es'kri.tu e~j~ 'mi~
Tenho é que me copiar com uma delicadeza de borboleta branca.	'te~.Ju E ki mi ko.pi'aX ko~ u~.ma de.li.ka'de.za Di boR.bo'le.ta 'bra~.ka
Essa idéia de borboleta branca vem de que, se a moça vier a se casar, casar-se-á magra e leve, e, como virgem, de branco.	'E.sa i'dEj.a Di boR.bo'le.ta 'bra~.ka 've~j~ Di ki, si a 'mo.sa vi'Er a si ka'zaX, ka'zaX si 'a 'ma.gra i 'lE.vi, i, 'ko~.mu 'viR.Ze~j~, Di 'bra~.ku
Ou não se casará?	ow 'na~w~ si ka.za'ra
O fato é que tenho nas minhas mãos um destino e no entanto não me sinto com o poder de livremente inventar: sigo uma oculta linha fatal.	u 'fa.tu E ki 'te~.Ju nas 'mi~.Jas 'ma~w~z u~ des'Ti~.nu i nu e~'ta~.tu 'na~w~ mi 'si~.tu ko~ u po'deR Di li.vri~'me~.Ti i~.ve~'taX, 'si.gu u~.ma o'kuw.ta 'li~.Ja fa'taw
Sou obrigado a procurar uma verdade que me ultrapassa.	'sow o.bri'ga.du a pro.ku'rar u~.ma veR'da.Di ki mi uw.tra'pa.sa
Por que escrevo sobre uma jovem que nem pobreza enfeitada tem?	puX 'ke es'kre.vu 'so.bri u~.ma 'ZO.ve~j~ ki ne~j~ po'bre.za e~.fej'ta.da te~j~
Talvez porque nela haja um recolhimento e também porque na pobreza de corpo e espírito eu toco na santidade, eu que quero sentir o sopro do meu além.	taw'vejs puX'ke 'nE.la 'a.Za u~ Re.ko.Li~'me~.tu i ta~'be~j~ puX'ke na po'bre.za Di 'koX.pu i es'pi.ri.tu ew 'tO.ku na sa~.Ti'da.Di, ew ki 'kE.ru se~'Tir u 'so.pru du 'mew a'le~j~
Para ser mais do que eu, pois tão pouco sou.	'pa.ra 'seR 'majs du ki ew, 'pojs 'ta~w~ 'pow.ku 'sow
Escrevo por não ter nada a fazer no mundo: sobrei e não há lugar para mim na terra dos homens.	es'kre.vu puR 'na~w~ 'teR 'na.da a fa'zeR nu 'mu~.du, so'brej i 'na~w~ 'a lu'gaX 'pa.ra 'mi~ na 'tE.Ra duz 'o~.me~s
Escrevo porque sou um desesperado e estou cansado, não suporto mais a rotina de me ser e se não fosse a sempre novidade que é escrever, eu me morreria simbolicamente todos os dias.	es'kre.vu puX'ke 'sow u~ de.zes.pe'ra.du i es'tow ka~'sa.du, 'na~w~ su'pOX.tu 'majz a Ro'Ti~.na Di mi 'ser i si 'na~w~ 'fo.si a 'se~.pri no.vi'da.Di ki E es.kre'veX, ew mi mo.Re'ri.a si~.bO.li.ka~'me~.Ti 'to.duz us 'Di.as
Mas preparado estou para sair discretamente pela saída da porta dos fundos.	majs pre.pa'ra.du es'tow 'pa.ra sa'iR Dis.krE.ta~'me~.Ti 'pe.la sa'i.da da 'pOX.ta dus 'fu~.dus
Experimentei quase tudo, inclusive a paixão e o seu desespero.	es.pe.ri~.me~'tej 'kwa.zi 'tu.du, i~.klu'zi.vi a paj'Sa~w~ i u 'sew de.zes'pe.ru
E agora só quereria ter o que eu tivesse sido e não fui.	i a'gO.ra 'sO ke.re'ri.a 'ter u ki ew Ti'vE.si 'si.du i 'na~w~ 'fuj
Pareço conhecer nos menores detalhes essa nordestina, pois se vivo com ela.	pa're.su ko~.Je'seR nus me~'nO.ris de'ta.Liz 'E.sa noR.des'Ti~.na, 'pojs si 'vi.vu ko~ 'E.la
E como muito adivinhei a seu respeito, ela se me grudou na pele qual melado pegajoso ou lama negra.	i 'ko~.mu 'mu~j~.tu a.Di.vi~'Jej a 'sew Res'pej.tu, 'E.la si mi gru'dow na 'pE.li 'kwaw me'la.du pe.ga'Zo.zu ow 'la~.ma 'ne.gra
Quando eu era menino li a história de um velho que estava com medo de atravessar um rio.	'kwa~.du ew 'E.ra me~'ni~.nu li a is'tO.rja Di u~ 'vE.Lu ki es'ta.va ko~ 'me.du Di a.tra.ve'sar u~ 'Ri.u
E foi quando apareceu um homem jovem que também queria passar para a outra margem.	i 'foj 'kwa~.du a.pa.re'sew u~ 'o~.me~j~ 'ZO.ve~j~ ki ta~'be~j~ ke'ri.a pa'saX 'pa.ra a 'ow.tra 'maR.Ze~j~
O velho aproveitou e disse:	u 'vE.Lu a.pro.vej'tow i 'Di.si
Me leva também?	mi 'lE.va ta~'be~j~
Eu bem montado nos teus ombros?	ew 'be~j~ mo~'ta.du nus 'tewz 'o~.brus
O moço consentiu e passada a travessia avisou-lhe:	u 'mo.su ko~.se~'Tiw i pa'sa.da a tra.ve'si.a a.vi'zow Li
Já chegamos, agora pode descer.	'Za Se'ga~.mus, a'gO.ra 'pO.Di de'seX
Ah, essa não!	'a, 'E.sa 'na~w~
É tão bom estar aqui montado como estou que nunca mais vou sair de você!	E 'ta~w~ 'bo~ es'tar a'ki mo~'ta.du 'ko~.mu es'tow ki 'nu~.ka 'majs 'vow sa'iR Di vo'se
Pois a datilógrafa não quer sair dos meus ombros.	'pojz a da.Ti'lO.gra.fa 'na~w~ 'kEX sa'iR dus 'mewz 'o~.brus
Logo eu que constato que a pobreza é feia e promíscua.	'lO.gu ew ki ko~s'ta.tu ki a po'bre.za E 'fej.a i pro~'mis.kwa
Por isso não sei se minha história vai ser, ser o quê?	pur 'i.su 'na~w~ 'sej si 'mi~.Ja is'tO.rja 'vaj 'seX, 'ser u 'ke
Não sei de nada, ainda não me animei a escrevê-la.	'na~w~ 'sej Di 'na.da, a'i~.da 'na~w~ mi a~.ni~'mej a es.kre've la
Terá acontecimentos?	te'ra a.ko~.te.si~'me~.tus
Mas quais?	majs 'kwajs
Também não sei.	ta~'be~j~ 'na~w~ 'sej
Não estou tentando criar em vós uma expectativa aflita e voraz: é que realmente não sei o que me espera, tenho um personagem buliçoso nas mãos e que me escapa a cada instante querendo que eu o recupere.	'na~w~ es'tow te~'ta~.du kri'ar e~j~ 'vOjz u~.ma es.pek.ta'Ti.va a'fli.ta i vo'rajs, E ki Re.aw'me~.Ti 'na~w~ 'sej u ki mi es'pE.ra, 'te~.Ju u~ peX.so~'na.Ze~j~ bu.li'so.zu nas 'ma~w~z i ki mi es'ka.pa a 'ka.da i~s'ta~.Ti ke're~.du ki ew u Re.ku'pE.ri
Esqueci de dizer que tudo o que estou agora escrevendo é acompanhado pelo ruflar enfático de um tambor batido por um soldado.	es.ke'si Di Di'zeX ki 'tu.du u ki es'tow a'gO.ra es.kre've~.du E a.ko~.pa~'Ja.du 'pe.lu Ru'flar e~'fa.Ti.ku Di u~ ta~'boR ba'Ti.du pur u~ sow'da.du
No instante mesmo em que eu começar a história, de súbito cessará o tambor.	nu i~s'ta~.Ti 'mez.mu e~j~ ki ew ko~.me'sar a is'tO.rja, Di 'su.bi.tu se.sa'ra u ta~'boX
Vejo a nordestina se olhando ao espelho e, um ruflar de tambor, no espelho aparece o meu rosto cansado e barbudo.	've.Zu a noR.des'Ti~.na si o'La~.du aw es'pe.Lu i, u~ Ru'flaR Di ta~'boX, nu es'pe.Lu a.pa'rE.si u 'mew 'Ros.tu ka~'sa.du i baR'bu.du
Tanto nós nos intertrocamos.	'ta~.tu 'nOjs nuz i~.teX.tro'ka~.mus
Não há dúvida que ela é uma pessoa física.	'na~w~ 'a 'du.vi.da ki 'E.la E u~.ma pe'so.a 'fi.zi.ka
E adianto um fato: trata-se de moça que nunca se viu nua porque tinha vergonha.	i a.Di'a~.tu u~ 'fa.tu, 'tra.ta si Di 'mo.sa ki 'nu~.ka si 'viw 'nu.a puX'ke 'Ti~.Ja veR'go~.Ja
Vergonha por pudor ou por ser feia?	veR'go~.Ja puX pu'dor ow puX 'seX 'fej.a
Pergunto-me também como é que eu vou cair de quatro em fatos e fatos.	peR'gu~.tu mi ta~'be~j~ 'ko~.mu E ki ew 'vow ka'iR Di kwa'tru e~j~ 'fa.tuz i 'fa.tus
É que de repente o figurativo me fascinou: crio a ação humana e estremeço.	E ki Di Re'pe~.Ti u fi.gu.ra'Ti.vu mi fa.si~'now, 'kri.u a a'sa~w~ u~'ma~.na i es.tre~'me.su
Também quero o figurativo assim como um pintor que só pintasse cores abstratas quisesse mostrar que o fazia por gosto, e não por não saber desenhar.	ta~'be~j~ 'kE.ru u fi.gu.ra'Ti.vu a'si~ 'ko~.mu u~ pi~'toX ki 'sO pi~'ta.si 'ko.riz abs'tra.tas ki'zE.si mos'traX ki u fa'zi.a puR 'gos.tu, i 'na~w~ puR 'na~w~ sa'beR de.ze~'JaX
Para desenhar a moça tenho que me domar e para poder captar sua alma tenha que me alimentar frugalmente de frutas e beber vinho branco gelado pois faz calor neste cubículo onde me tranquei e de onde tenho a velocidade de querer ver o mundo.	'pa.ra de.ze~'Jar a 'mo.sa 'te~.Ju ki mi do~'mar i 'pa.ra po'deX kap'taX 'su.a 'aw.ma 'te~.Ja ki mi a.li~.me~'taX fru.gaw'me~.Ti Di 'fru.taz i be'beR 'vi~.Ju 'bra~.ku Ze'la.du 'pojs 'fajs ka'loR 'nes.Ti ku'bi.ku.lu 'o~.Di mi tra~'kej i Di 'o~.Di 'te~.Ju a ve.lo.si'da.Di Di ke'reR 'ver u 'mu~.du
Também tive que me abster de sexo e de futebol.	ta~'be~j~ 'Ti.vi ki mi abs'teR Di 'sEk.su i Di fu.Ti'bOw
Sem falar que não entro em contacto com ninguém.	se~j~ fa'laX ki 'na~w~ 'e~.tru e~j~ ko~'tak.tu ko~ ni~'ge~j~
Voltarei algum dia à minha vida anterior?	vow.ta'rej aw'gu~ 'Di.a a 'mi~.Ja 'vi.da a~.te.ri'oX
Duvido muito.	du'vi.du 'mu~j~.tu
Vejo agora que esqueci de dizer que por enquanto nada leio para não contaminar com luxos a simplicidade de minha linguagem.	've.Zu a'gO.ra ki es.ke'si Di Di'zeX ki pur e~'kwa~.tu 'na.da 'lej.u 'pa.ra 'na~w~ ko~.ta~.mi~'naX ko~ 'lu.Suz a si~.pli.si'da.Di Di 'mi~.Ja li~'gwa.Ze~j~
Pois como eu disse a palavra tem que se parecer com a palavra, instrumento meu.	'pojs 'ko~.mu ew 'Di.si a pa'la.vra te~j~ ki si pa.re'seX ko~ a pa'la.vra, i~s.tru~'me~.tu 'mew
Ou não sou um escritor?	ow 'na~w~ 'sow u~ es.kri'toX
Na verdade sou mais ator porque, com apenas um modo de pontuar, faço malabarismos de entonação, obrigo o respirar alheio a me acompanhar o texto.	na veR'da.Di 'sow 'majz a'toX puX'ke, ko~ a'pe~.naz u~ 'mO.du Di po~.tu'aX, 'fa.su ma.la.ba'riz.mus Di e~.to~.na'sa~w~, o'bri.gu u Res.pi'rar a'Lej.u a mi a.ko~.pa~'Jar u 'tes.tu
Também esqueci de dizer que o registro que em breve vai ter que começar, pois já não aguento a pressão dos fatos, o registro que em breve vai ter que começar é escrito sob o patrocínio do refrigerante mais popular do mundo e que nem por isso me paga nada, refrigerante esse espalhado por todos os países.	ta~'be~j~ es.ke'si Di Di'zeX ki u Re'Zis.tru ki e~j~ 'brE.vi 'vaj 'teX ki ko~.me'saX, 'poj'Za 'na~w~ a'gwe~.tu a pre'sa~w~ dus 'fa.tus, u Re'Zis.tru ki e~j~ 'brE.vi 'vaj 'teX ki ko~.me'sar E es'kri.tu sob u pa.tro'si~.nju du Re.fri.Ze'ra~.Ti 'majs po.pu'laR du 'mu~.du i ki ne~j~ pur 'i.su mi 'pa.ga 'na.da, Re.fri.Ze'ra~.Ti 'e.si es.pa'La.du puX 'to.duz us pa'i.zis
Aliás foi ele quem patrocinou o último terremoto em Guatemala.	a.li'ajs 'foj 'e.li 'ke~j~ pa.tro.si~'now u 'uw.Ti~.mu te.Re~'mO.tu e~j~ gwa.te~'ma.la
Apesar de ter gosto do cheiro de esmalte de unhas, de sabão Aristolino e plástico mastigado.	a.pe'zaR Di 'teR 'gos.tu du 'Sej.ru Di ez'maw.Ti Di 'u~.Jas, Di sa'ba~w~ a.ris.to'li~.nu i 'plas.Ti.ku mas.Ti'ga.du
Tudo isso não impede que todos o amem com servilidade e subserviência.	'tu.du 'i.su 'na~w~ i~'pE.Di ki 'to.duz u 'a~.me~j~ ko~ seR.vi.li'da.Di i sub.seR.vi'e~.sja
Ela é um meio da pessoa atualizar-se e pisar na hora presente.	'E.la E u~ 'mej.u da pe'so.a a.tu.a.li'zaX si i pi'zaR na 'O.ra pre'ze~.Ti
Quanto à moça, ela vive num limbo impessoal, sem alcançar o pior nem o melhor.	'kwa~.tu a 'mo.sa, 'E.la 'vi.vi nu~ 'li~.bu i~.pe.so'aw, se~j~ aw.ka~'sar u pi'OR ne~j~ u me'LOX
Ela somente vive, inspirando e expirando, inspirando e expirando.	'E.la sO~'me~.Ti 'vi.vi, i~s.pi'ra~.du i es.pi'ra~.du, i~s.pi'ra~.du i es.pi'ra~.du
Na verdade, para que mais que isso?	na veR'da.Di, 'pa.ra ki 'majs ki 'i.su
O seu viver é ralo.	u 'sew vi'ver E 'Ra.lu
Mas por que estou me sentindo culpado?	majs puX 'ke es'tow mi se~'Ti~.du kuw'pa.du
E procurando aliviar-me do peso de nada ter feito de concreto em benefício da moça.	i pro.ku'ra~.du a.li.vi'aX mi du 'pe.zu Di 'na.da 'teX 'fej.tu Di ko~'krE.tu e~j~ be~.ne'fi.sju da 'mo.sa
Moça essa, e vejo que já estou quase na história, moça essa que dormia de combinação de brim com manchas bastante suspeitas de sangue pálido.	'mo.sa 'E.sa, i 've.Zu ki 'Za es'tow 'kwa.zi na is'tO.rja, 'mo.sa 'E.sa ki doR'mi.a Di ko~.bi~.na'sa~w~ Di 'bri~ ko~ 'ma~.Sas bas'ta~.Ti sus'pej.tas Di 'sa~.gi 'pa.li.du
Para adormecer nas frígidas noites de inverno enroscava-se em si mesma, recebendo-se e dando-se o próprio parco calor.	'pa.ra a.doR.me'seR nas 'fri.Zi.das 'noj.Tis Di i~'vER.nu e~.Ros'ka.va si e~j~ 'si 'mez.ma, Re.se'be~.du si i 'da~.du si u 'prO.prju 'paX.ku ka'loX
Dormia de boca aberta por causa do nariz entupido, dormia exausta, dormia até o nunca.	doR'mi.a Di 'bo.ka a'bEX.ta puX 'kaw.za du na'riz e~.tu'pi.du, doR'mi.a e'zaws.ta, doR'mi.a a'tE u 'nu~.ka
Devo acrescentar um algo que importa muito para a apreensão da narrativa: é que esta é acompanhada do princípio ao fim por uma levíssima e constante dor de dentes, coisa de dentina exposta.	'de.vu a.kre.se~'tar u~ 'aw.gu ki i~'pOX.ta 'mu~j~.tu 'pa.ra a a.pre.e~'sa~w~ da na.Ra'Ti.va, E ki 'Es.ta E a.ko~.pa~'Ja.da du pri~'si.pju aw 'fi~ pur u~.ma le'vi.si~.ma i ko~s'ta~.Ti 'doR Di 'de~.Tis, 'koj.za Di de~'Ti~.na es'pOs.ta
Afianço também que a história será igualmente acompanhada pelo violino plangente tocado por um homem magro bem na esquina.	a.fi'a~.su ta~'be~j~ ki a is'tO.rja se'ra i.gwaw'me~.Ti a.ko~.pa~'Ja.da 'pe.lu vi.o'li~.nu pla~'Ze~.Ti to'ka.du pur u~ 'o~.me~j~ 'ma.gru 'be~j~ na es'ki~.na
A sua cara é estreita e amarela como se ele já tivesse morrido:	a 'su.a 'ka.ra E es'trej.ta i a~.ma'rE.la 'ko~.mu si 'e.li 'Za Ti'vE.si mo'Ri.du
E talvez tenha.	i taw'vejs 'te~.Ja
Tudo isso eu disse tão longamente por medo de ter prometido demais e dar apenas o simples e o pouco.	'tu.du 'i.su ew 'Di.si 'ta~w~ lo~.ga~'me~.Ti puR 'me.du Di 'teX pro~.me'Ti.du de~'majz i 'dar a'pe~.naz u 'si~.pliz i u 'pow.ku
Pois esta história é quase nada.	'pojz 'Es.ta is'tO.rja E 'kwa.zi 'na.da
O jeito é começar de repente assim como eu me lanço de repente na água gélida do mar, modo de enfrentar com uma coragem suicida o intenso frio.	u 'Zej.tu E ko~.me'saR Di Re'pe~.Ti a'si~ 'ko~.mu ew mi 'la~.su Di Re'pe~.Ti na 'a.gwa 'ZE.li.da du 'maX, 'mO.du Di e~.fre~'taX ko~ u~.ma ko'ra.Ze~j~ suj'si.da u i~'te~.su 'fri.u
Vou agora começar pelo meio dizendo que, que ela era incompetente.	'vow a'gO.ra ko~.me'saX 'pe.lu 'mej.u Di'ze~.du ki, ki 'E.la 'E.ra i~.ko~.pe'te~.Ti
Incompetente para a vida.	i~.ko~.pe'te~.Ti 'pa.ra a 'vi.da
Faltava-lhe o jeito de se ajeitar.	faw'ta.va Li u 'Zej.tu Di si a.Zej'taX
Só vagamente tomava conhecimento da espécie de ausência que tinha de si em si mesma.	'sO va.ga~'me~.Ti to~'ma.va ko~.Je.si~'me~.tu da es'pE.si Di aw'ze~.sja ki 'Ti~.Ja Di 'si e~j~ 'si 'mez.ma
Se fosse criatura que se exprimisse diria: o mundo é fora de mim, eu sou fora de mim.	si 'fo.si kri.a'tu.ra ki si es.pri~'mi.si Di'ri.a, u 'mu~.du E 'fO.ra Di 'mi~, ew 'sow 'fO.ra Di 'mi~
Vai ser difícil escrever esta história.	'vaj 'seR Di'fi.siw es.kre'ver 'Es.ta is'tO.rja
Apesar de eu não ter nada a ver com a moça, terei que me escrever todo através dela por entre espantos meus.	a.pe'zaR Di ew 'na~w~ 'teR 'na.da a 'veX ko~ a 'mo.sa, te'rej ki mi es.kre'veX 'to.du a.tra'vEjs 'dE.la pur 'e~.tri es'pa~.tus 'mews
Os fatos são sonoros mas entre os fatos há um sussurro.	us 'fa.tus 'sa~w~ so~'nO.rus majz 'e~.tri us 'fa.tuz 'a u~ su'su.Ru
É o sussurro o que me impressiona.	E u su'su.Ru u ki mi i~.pre.si'o~.na
Isso disse ele.	'i.su 'Di.si 'e.li
Quanto à moça, achou que se deve por respeito responder alguma coisa e falou cerimoniosa a seu escondidamente amado chefe:	'kwa~.tu a 'mo.sa, a'Sow ki si 'dE.vi pu.Res'pej.tu Res.po~'der aw'gu~.ma 'koj.za i fa'low se.ri~.mo~.ni'O.za a 'sew es.ko~.Di.da~'me~.Ti a~'ma.du 'SE.fi
Me desculpe o aborrecimento.	mi des'kuw.pi u a.bo.Re.si~'me~.tu
O Senhor Raimundo Silveira, que a essa altura já lhe havia virado as costas, voltou-se um pouco surpreendido com a inesperada delicadeza e alguma coisa na cara quase sorridente da datilógrafa o fez dizer com menos grosseria na voz, embora a contragosto:	u se~'Jo.Rai~'mu~.du siw'vej.ra, ki a 'E.sa aw'tu.ra 'Za Li a'vi.a vi'ra.du as 'kOs.tas, vow'tow si u~ 'pow.ku suX.pre.e~'Di.du ko~ a i~.nes.pe'ra.da de.li.ka'de.za i aw'gu~.ma 'koj.za na 'ka.ra 'kwa.zi so.Ri'de~.Ti da da.Ti'lO.gra.fa u 'fejz Di'zeX ko~ 'me~.nus gro.se'ri.a na 'vOjs, e~'bO.ra a ko~.tra'gos.tu
Bem, a despedida pode não ser para já, é capaz até de demorar um pouco.	'be~j~, a des.pe'Di.da 'pO.Di 'na~w~ 'seX 'pa.ra 'Za, E ka'pajz a'tE Di de~.mo'rar u~ 'pow.ku
Depois de receber o aviso foi ao banheiro para ficar sozinha porque estava toda atordoada.	de'pojs Di Re.se'ber u a'vi.zu 'foj aw ba~'Jej.ru 'pa.ra fi'kaX sO'zi~.Ja puX'ke es'ta.va 'to.da a.toR.do'a.da
Olhou-se maquinalmente ao espelho que encimava a pia imunda e rachada, cheia de cabelos, o que tanto combinava com sua vida.	o'Low si ma.ki~.naw'me~.Ti aw es'pe.Lu ki e~.si~'ma.va a 'pi.a i~'mu~.da i Ra'Sa.da, 'Sej.a Di ka'be.lus, u ki 'ta~.tu ko~.bi~'na.va ko~ 'su.a 'vi.da
Pareceu-lhe que o espelho; baço e escurecido não refletia imagem alguma.	pa.re'sew Li ki u es'pe.Lu, 'ba.su i es.ku.re'si.du 'na~w~ Re.fle'Ti.a i~'ma.Ze~j~ aw'gu~.ma
Sumira por acaso a sua existência física?	su~'mi.ra pur a'ka.zu a 'su.a e.zis'te~.sja 'fi.zi.ka
Logo depois passou a ilusão e enxergou a cara toda deformada pelo espelho ordinário, o nariz tornado enorme como o de um palhaço de nariz de papelão.	'lO.gu de'pojs pa'sow a i.lu'za~w~ i e~.SeR'gow a 'ka.ra 'to.da de.foR'ma.da 'pe.lu es'pe.Lu oR.Di~'na.rju, u na'ris toR'na.du e~'nOR.mi 'ko~.mu u Di u~ pa'La.su Di na'riz Di pa.pe'la~w~
Olhou-se e levemente pensou: tão jovem e já com ferrugem.	o'Low si i lE.ve~'me~.Ti pe~'sow, 'ta~w~ 'ZO.ve~j~ i 'Za ko~ fe'Ru.Ze~j~
Há os que têm.	'a us ki 'te~j~
E há os que não têm.	i 'a us ki 'na~w~ 'te~j~
É muito simples: a moça não tinha.	E 'mu~j~.tu 'si~.plis, a 'mo.sa 'na~w~ 'Ti~.Ja
Não tinha o quê?	'na~w~ 'Ti~.Ja u 'ke
É apenas isso mesmo: não tinha.	E a'pe~.naz 'i.su 'mez.mu, 'na~w~ 'Ti~.Ja
Se der para me entenderem, está bem.	si 'dEX 'pa.ra mi e~.te~'de.re~j~, es'ta 'be~j~
Se não, também está bem.	si 'na~w~, ta~'be~j~ es'ta 'be~j~
Mas por que trato dessa moça quando o que mais desejo é trigo puramente maduro e ouro no estio?	majs puX 'ke 'tra.tu 'dE.sa 'mo.sa 'kwa~.du u ki 'majs de'ze.Zu E 'tri.gu pu.ra~'me~.Ti ma'du.ru i 'ow.ru nu es'Ti.u
Quando era pequena sua tia para castigá-la com á o medo dissera-lhe que homem-vampiro, aquele que chupa sangue da pessoa mordendo-lhe o tenro da garganta, não tinha reflexo no espelho.	'kwa~.du 'E.ra pe'ke~.na 'su.a 'Ti.a 'pa.ra kas.Ti'ga la ko~ a u 'me.du Di'sE.ra Li ki 'o~.me~j~ va~'pi.ru, a'ke.li ki 'Su.pa 'sa~.gi da pe'so.a moR'de~.du Li u 'te~.Ru da gaR'ga~.ta, 'na~w~ 'Ti~.Ja Re'flEk.su nu es'pe.Lu
Até que não seria de todo ruim ser vampiro pois bem que lhe iria algum rosado de sangue no amarelado do rosto, ela que não parecia ter sangue a menos que viesse um dia a derramá-lo.	a'tE ki 'na~w~ se'ri.a Di 'to.du Ru'i~ 'seR va~'pi.ru 'pojs 'be~j~ ki Li i'ri.a aw'gu~ Ro'za.du Di 'sa~.gi nu a~.ma.re'la.du du 'Ros.tu, 'E.la ki 'na~w~ pa.re'si.a 'teX 'sa~.gi a 'me~.nus ki vi'E.si u~ 'Di.a a de.Ra~'ma lu
A moça tinha ombros curvos como os de uma cerzideira.	a 'mo.sa 'Ti~.Ja 'o~.brus 'kuR.vus 'ko~.mu us Di u~.ma seR.zi'dej.ra
Aprendera em pequena á cerzir.	a.pre~'de.ra e~j~ pe'ke~.na a seR'ziX
Ela se realizaria muito mais se se desse ao delicado labor de restaurar fios, quem sabe se de seda.	'E.la si Re.a.li.za'ri.a 'mu~j~.tu 'majs si si 'dE.si aw de.li'ka.du la'boR Di Res.taw'raX 'fi.us, 'ke~j~ 'sa.bi si Di 'se.da
Ou de luxo: cetim bem brilhoso, um beijo de almas.	ow Di 'lu.Su, se'Ti~ 'be~j~ bri'Lo.zu, u~ 'bej.Zu Di 'aw.mas
Cerzideirinha mosquito.	seR.zi.dej'ri~.Ja mos'ki.tu
Carregar em costas de formiga um grão de açúcar.	ka.Re'gar e~j~ 'kOs.tas Di foR'mi.ga u~ 'gra~w~ Di a'su.kaX
Não sabia que era infeliz.	'na~w~ sa'bi.a ki 'E.ra i~.fe'lis
É porque ela acreditava.	E puX'ke 'E.la a.kre.Di'ta.va
Em quê?	e~j~ 'ke
Em vós, mas não é preciso acreditar em alguém ou em alguma coisa, basta, acreditar.	e~j~ 'vOjs, majs 'na~w~ E pre'si.zu a.kre.Di'tar e~j~ aw'ge~j~ ow e~j~ aw'gu~.ma 'koj.za, 'bas.ta, a.kre.Di'taX
Isso lhe dava às vezes estado de graça.	'i.su Li 'da.va as 've.ziz es'ta.du Di 'gra.sa
Nunca perdera a fé.	'nu~.ka peR'de.ra a 'fE
Ela me incomoda tanto que fiquei oco. Estou oco desta moça.	'E.la mi i~.ko~'mO.da 'ta~.tu ki fi'kej 'o.ku, es'tow 'o.ku 'dEs.ta 'mo.sa
E ela tanto mais me incomoda quanto menos reclama.	i 'E.la 'ta~.tu 'majs mi i~.ko~'mO.da 'kwa~.tu 'me~.nus Re'kla~.ma
Estou com raiva.	es'tow ko~ 'Raj.va
Uma cólera de derrubar copos e pratos e quebrar vidraças.	u~.ma 'kO.le.ra Di de.Ru'baX 'kO.puz i 'pra.tuz i ke'braR vi'dra.sas
Como me vingar?	'ko~.mu mi vi~'gaX
Ou melhor, como me compensar?	ow me'LOX, 'ko~.mu mi ko~.pe~'saX
Já sei: amando meu cão que tem mais comida do que a moça.	'Za 'sej, a~'ma~.du 'mew 'ka~w~ ki te~j~ 'majs ko~'mi.da du ki a 'mo.sa
Por que ela não reage?	puX 'ke 'E.la 'na~w~ Re'a.Zi
Cadê um pouco de fibra?	ka'de u~ 'pow.ku Di 'fi.bra
Não, ela é doce e obediente.	'na~w~, 'E.la E 'do.si i o.be.Di'e~.Ti
Viu ainda dois olhos enormes, redondos, saltados e interrogativos, tinha olhar de quem tem uma asa ferida, distúrbio talvez da tireóide, olhos que perguntavam.	'viw a'i~.da 'dojz 'O.Luz e~'nOR.mis, Re'do~.dus, saw'ta.duz i i~.te.Ro.ga'Ti.vus, 'Ti~.Ja o'LaR Di 'ke~j~ te~j~ u~.ma 'a.za fe'ri.da, Dis'tuR.bju taw'vejz da Ti.re'Oj.Di, 'O.Lus ki peR.gu~'ta.va~w~
A quem interrogava ela?	a 'ke~j~ i~.te.Ro'ga.va 'E.la
a Deus?	a 'dews
Deus é de quem conseguir pegá-lo.	'dewz E Di 'ke~j~ ko~.se'giX pe'ga lu
Na distração aparece, Deus.	na Dis.tra'sa~w~ a.pa'rE.si, 'dews
Não fazia perguntas.	'na~w~ fa'zi.a peR'gu~.tas
Adivinhava que não há respostas.	a.Di.vi~'Ja.va ki 'na~w~ 'a Res'pOs.tas
Era lá tola de perguntar?	'E.ra 'la 'to.la Di peR.gu~'taX
E de receber um não na cara?	i Di Re.se'ber u~ 'na~w~ na 'ka.ra
Talvez a pergunta vazia fosse apenas para que um dia alguém não viesse a dizer que ela nem ao menos havia perguntado.	taw'vejz a peR'gu~.ta va'zi.a 'fo.si a'pe~.nas 'pa.ra ki u~ 'Di.a aw'ge~j~ 'na~w~ vi'E.si a Di'zeX ki 'E.la ne~j~ aw 'me~.nuz a'vi.a peR.gu~'ta.du
Por falta de quem lhe respondesse ela mesma parecia se ter respondido: é assim porque é assim.	puX 'faw.ta Di 'ke~j~ Li Res.po~'de.si 'E.la 'mez.ma pa.re'si.a si 'te.Res.po~'Di.du, E a'si~ puX'ke E a'si~
Existe no mundo outra resposta?	e'zis.Ti nu 'mu~.du 'ow.tra Res'pOs.ta
Se alguém sabe de uma melhor, que se apresente e a diga, estou há anos esperando.	si aw'ge~j~ 'sa.bi Di u~.ma me'LOX, ki si a.pre'ze~.Ti i a 'Di.ga, es'tow 'a 'a~.nuz es.pe'ra~.du
Enquanto isso as nuvens são brancas e o céu é todo azul.	e~'kwa~.tu 'i.su as 'nu.ve~s 'sa~w~ 'bra~.kaz i u 'sEw E 'to.du a'zuw
Para que tanto Deus.	'pa.ra ki 'ta~.tu 'dews
Por que não um pouco para os homens:	puX 'ke 'na~w~ u~ 'pow.ku 'pa.ra uz 'o~.me~s
Ela nascera com maus antecedentes e agora parecia uma filha de um não-sei-o-quê com ar de se desculpar por ocupar espaço.	'E.la na'se.ra ko~ 'mawz a~.te.se'de~.Tiz i a'gO.ra pa.re'si.a u~.ma 'fi.La Di u~ 'na~w~ 'sej u 'ke ko~ 'aR Di si des.kuw'paX pur o.ku'par es'pa.su
No espelho distraidamente examinou de perto as manchas no rosto.	nu es'pe.Lu Dis.tra.i.da~'me~.Ti e.za~.mi~'now Di 'pEX.tu as 'ma~.Sas nu 'Ros.tu
Em Alagoas chamavam-se panos, diziam que vinham do fígado.	e~j~ a.la'go.a.Sa~'ma.va~w~ si 'pa~.nus, Di'zi.a~w~ ki 'vi~.Ja~w~ du 'fi.ga.du
Disfarçava os panos com grossa camada de pó branco e se ficava meio caiada era melhor que o pardacento.	Dis.faX'sa.va us 'pa~.nus ko~ 'grO.sa ka~'ma.da Di 'pO 'bra~.ku i si fi'ka.va 'mej.u kaj'a.da 'E.ra me'LOX ki u paR.da'se~.tu
Ela toda era um pouco encardida pois raramente se lavava.	'E.la 'to.da 'E.ra u~ 'pow.ku e~.kaR'Di.da 'pojs Ra.ra~'me~.Ti si la'va.va
De dia usava saia e blusa, de noite dormia de combinação.	Di 'Di.a u'za.va 'saj.a i 'blu.za, Di 'noj.Ti doR'mi.a Di ko~.bi~.na'sa~w~
Uma colega de quarto não sabia como avisar-lhe que seu cheiro era murrinhento.	u~.ma ko'lE.ga Di 'kwaX.tu 'na~w~ sa'bi.a 'ko~.mu a.vi'zaX Li ki 'sew 'Sej.ru 'E.ra mu.Ri~'Je~.tu
E como não sabia, ficou por isso mesmo, pois tinha medo de ofendê-la.	i 'ko~.mu 'na~w~ sa'bi.a, fi'kow pur 'i.su 'mez.mu, 'pojs 'Ti~.Ja 'me.du Di o.fe~'de la
Nada nela era iridescente, embora a pele do rosto entre as manchas tivesse um leve brilho de opala.	'na.da 'nE.la 'E.ra i.ri.de'se~.Ti, e~'bO.ra a 'pE.li du 'Ros.tu 'e~.tri as 'ma~.Sas Ti'vE.si u~ 'lE.vi 'bri.Lu Di o'pa.la
Mas não importava.	majs 'na~w~ i~.poX'ta.va
Ninguém olhava para ela na rua, ela era café frio.	ni~'ge~j~ o'La.va 'pa.ra 'E.la na 'Ru.a, 'E.la 'E.ra ka'fE 'fri.u
E assim se passava o tempo para a moça esta.	i a'si~ si pa'sa.va u 'te~.pu 'pa.ra a 'mo.sa 'Es.ta
Assoava o nariz na barra da combinação.	a.so'a.va u na'riz na 'ba.Ra da ko~.bi~.na'sa~w~
Não tinha aquela coisa delicada que se chama encanto.	'na~w~ 'Ti~.Ja a'kE.la 'koj.za de.li'ka.da ki si 'Sa~.ma e~'ka~.tu
Sofro por ela.	'so.fru pur 'E.la
Essa moça não sabia que ela era o que era, assim como um cachorro não sabe que é cachorro.	'E.sa 'mo.sa 'na~w~ sa'bi.a ki 'E.la 'E.ra u ki 'E.ra, a'si~ 'ko~.mu u~ ka'So.Ru 'na~w~ 'sa.bi ki E ka'So.Ru
Daí não se sentir infeliz.	da'i 'na~w~ si se~'Tir i~.fe'lis
A única coisa que queria era viver.	a 'u~.ni.ka 'koj.za ki ke'ri.a 'E.ra vi'veX
Não sabia para quê, não se indagava.	'na~w~ sa'bi.a 'pa.ra 'ke, 'na~w~ si i~.da'ga.va
Quem sabe, achava que havia uma gloriazinha em viver.	'ke~j~ 'sa.bi, a'Sa.va ki a'vi.a u~.ma glO.rja'zi~.Ja e~j~ vi'veX
Ela pensava que a pessoa é obrigada a ser feliz	'E.la pe~'sa.va ki a pe'so.a E o.bri'ga.da a 'seX fe'lis
Então era.	e~'ta~w~ 'E.ra
Antes de nascer ela era uma idéia?	'a~.Tis Di na'ser 'E.la 'E.ra u~.ma i'dEj.a
Antes de nascer ela era morta?	'a~.Tis Di na'ser 'E.la 'E.ra 'mOX.ta
E depois de nascer ela ia morrer?	i de'pojs Di na'ser 'E.la 'i.a mo'ReX
Mas que fina talhada de melancia.	majs ki 'fi~.na ta'La.da Di me.la~'si.a
Há poucos fatos a narrar e eu mesmo não sei ainda o que estou denunciando.	'a 'pow.kus 'fa.tuz a na'Rar i ew 'mez.mu 'na~w~ 'sej a'i~.da u ki es'tow de~.nu~.si'a~.du
Agora (explosão) em rapidíssimos traços desenharei a vida pregressa da moça até o momento do espelho do banheiro.	a'gO.ra, es.plo'za~w~, e~j~ Ra.pi'Di.si~.mus 'tra.sus de.ze~.Ja'rej a 'vi.da pre'grE.sa da 'mo.sa a'tE u mo~'me~.tu du es'pe.Lu du ba~'Jej.ru
Nascera inteiramente raquítica, herança do sertão, os maus antecedentes de que falei.	na'se.ra i~.tej.ra~'me~.Ti Ra'ki.Ti.ka, e'ra~.sa du seX'ta~w~, us 'mawz a~.te.se'de~.Tis Di ki fa'lej
Com dois anos de idade lhe haviam morrido os pais de febres ruins no sertão de Alagoas, lá onde o diabo perdera as botas.	ko~ 'dojz 'a~.nus Di i'da.Di Li a'vi.a~w~ mo'Ri.du us 'pajs Di 'fE.bris Ru'i~s nu seX'ta~w~ Di a.la'go.as, 'la 'o~.Di u Di'a.bu peR'de.ra as 'bO.tas
Muito depois fora para Maceió com a tia beata, única parenta sua no mundo.	'mu~j~.tu de'pojs 'fo.ra 'pa.ra ma.sej'O ko~ a 'Ti.a be'a.ta, 'u~.ni.ka pa're~.ta 'su.a nu 'mu~.du
Uma outra vez se lembrava de coisa esquecida.	u~.ma 'ow.tra 'vejs si le~'bra.va Di 'koj.za es.ke'si.da
Por exemplo a tia lhe dando cascudos no alto da cabeça porque o cocuruto de uma cabeça devia ser, imaginava a tia, um ponto vital.	pur e'ze~.plu a 'Ti.a Li 'da~.du kas'ku.dus nu 'aw.tu da ka'be.sa puX'ke u ko.ku'ru.tu Di u~.ma ka'be.sa de'vi.a 'seX, i~.ma.Zi~'na.va a 'Ti.a, u~ 'po~.tu vi'taw
Dava-lhe sempre com os nós dos dedos na cabeça de ossos fracos por falta de cálcio.	'da.va Li 'se~.pri ko~ us 'nOjs dus 'de.dus na ka'be.sa Di 'O.sus 'fra.kus puX 'faw.ta Di 'kaw.sju
Batia mas não era somente porque ao bater gozava de grande prazer sensual, a tia que não se casara por nojo, é que também considerava de dever seu evitar que a menina viesse um dia a ser uma dessas moças que em Maceió ficavam nas ruas de cigarro aceso esperando homem.	ba'Ti.a majs 'na~w~ 'E.ra sO~'me~.Ti puX'ke aw ba'teR go'za.va Di 'gra~.Di pra'zeX se~.su'aw, a 'Ti.a ki 'na~w~ si ka'za.ra puR 'no.Zu, E ki ta~'be~j~ ko~.si.de'ra.va Di de'veX 'sew e.vi'taX ki a me~'ni~.na vi'E.si u~ 'Di.a a 'ser u~.ma 'dE.sas 'mo.sas ki e~j~ ma.sej'O fi'ka.va~w~ nas 'Ru.as Di si'ga.Ru a'se.zu es.pe'ra~.du 'o~.me~j~
Embora a menina não tivesse dado mostras de no futuro vir a ser vagabunda de rua.	e~'bO.ra a me~'ni~.na 'na~w~ Ti'vE.si 'da.du 'mOs.tras Di nu fu'tu.ru 'vir a 'seR va.ga'bu~.da Di 'Ru.a
Pois até mesmo o fato de vir a ser uma mulher não parecia pertencer à sua vocação.	'pojz a'tE 'mez.mu u 'fa.tu Di 'vir a 'ser u~.ma mu'LER 'na~w~ pa.re'si.a peX.te~'ser a 'su.a vo.ka'sa~w~
As pancadas ela esquecia pois esperando-se um pouco a dor termina por passar;	as pa~'ka.daz 'E.la es.ke'si.a 'pojz es.pe'ra~.du si u~ 'pow.ku a 'doX teR'mi~.na puX pa'saX
Mas o que doía mais era ser privada da sobremesa de todos os dias: goiabada com queijo, a única paixão na sua vida.	majz u ki do'i.a 'majz 'E.ra 'seX pri'va.da da so.bre~'me.za Di 'to.duz us 'Di.as, goj.a'ba.da ko~ 'kej.Zu, a 'u~.ni.ka paj'Sa~w~ na 'su.a 'vi.da
Pois não era que esse castigo se tornara o predileto da tia sabida?	'pojs 'na~w~ 'E.ra ki 'e.si kas'Ti.gu si toR'na.ra u pre.Di'lE.tu da 'Ti.a sa'bi.da
A menina não perguntava por que era sempre castigada mas nem tudo se precisa saber e não saber fazia parte importante de sua vida.	a me~'ni~.na 'na~w~ peR.gu~'ta.va puX 'ke 'E.ra 'se~.pri kas.Ti'ga.da majs ne~j~ 'tu.du si pre'si.za sa'ber i 'na~w~ sa'beX fa'zi.a 'paX.Ti i~.poX'ta~.Ti Di 'su.a 'vi.da
Esse não-saber pode parecer ruim mas não é tanto porque ela sabia muita coisa assim como ninguém ensina cachorro a abanar o rabo e nem a pessoa a sentir fome; nasce-se e fica-se logo sabendo.	'e.si 'na~w~ sa'beX 'pO.Di pa.re'se.Ru'i~ majs 'na~w~ E 'ta~.tu puX'ke 'E.la sa'bi.a 'mu~j~.ta 'koj.za a'si~ 'ko~.mu ni~'ge~j~ e~'si~.na ka'So.Ru a a.ba~'nar u 'Ra.bu i ne~j~ a pe'so.a a se~'TiX 'fo~.mi, 'na.si si i 'fi.ka si 'lO.gu sa'be~.du
Assim como ninguém lhe ensinaria um dia a morrer: na certa morreria um dia como se antes tivesse estudado de cor a representação do papel de estrela.	a'si~ 'ko~.mu ni~'ge~j~ Li e~.si~.na'ri.a u~ 'Di.a a mo'ReX, na 'sEX.ta mo.Re'ri.a u~ 'Di.a 'ko~.mu si 'a~.Tis Ti'vE.si es.tu'da.du Di 'kor a Re.pre.ze~.ta'sa~w~ du pa'pEw Di es'tre.la
Pois na hora da morte a pessoa se torna brilhante estrela de cinema, é o instante de glória de cada um e é quando como no canto coral se ouvem agudos sibilantes.	'pojs na 'O.ra da 'mOX.Ti a pe'so.a si 'tOR.na bri'La~.Ti es'tre.la Di si~'ne~.ma, E u i~s'ta~.Ti Di 'glO.rja Di 'ka.da 'u~ i E 'kwa~.du 'ko~.mu nu 'ka~.tu ko'raw si 'ow.ve~j~ a'gu.dus si.bi'la~.Tis
Quando era pequena tivera vontade intensa de criar um bicho.	'kwa~.du 'E.ra pe'ke~.na Ti'vE.ra vo~'ta.Di i~'te~.sa Di kri'ar u~ 'bi.Su
Mas a tia achava que ter um bicho era mais uma boca para comer.	majz a 'Ti.a a'Sa.va ki 'ter u~ 'bi.Su 'E.ra 'majz u~.ma 'bo.ka 'pa.ra ko~'meX
Do contacto com à tia ficara-lhe a cabeça baixa.	du ko~'tak.tu ko~ a 'Ti.a fi'ka.ra Li a ka'be.sa 'baj.Sa
Mas a sua beatice não lhe pegara: morta a tia, ela nunca mais fora a uma igreja porque não sentia nada e as divindades lhe eram estranhas.	majz a 'su.a be.a'Ti.si 'na~w~ Li pe'ga.ra, 'mOX.ta a 'Ti.a, 'E.la 'nu~.ka 'majs 'fo.ra a u~.ma i'gre.Za puX'ke 'na~w~ se~'Ti.a 'na.da i as Di.vi~'da.Dis Li 'E.ra~w~ es'tra~.Jas
Pois que vida é assim: aperta-se o botão e a vida acende.	'pojs ki 'vi.da E a'si~, a'pEX.ta si u bo'ta~w~ i a 'vi.da a'se~.Di
Nem se dava conta de que vivia numa sociedade técnica onde ela era um parafuso dispensável.	ne~j~ si 'da.va 'ko~.ta Di ki vi'vi.a 'nu~.ma so.si.e'da.Di 'tEk.ni.ka 'o~.Di 'E.la 'E.ra u~ pa.ra'fu.zu Dis.pe~'sa.vew
Mas uma coisa descobriu inquieta: já não sabia mais ter tido pai e mãe, tinha esquecido o sabor.	majz u~.ma 'koj.za des.ko'briw i~.ki'E.ta, 'Za 'na~w~ sa'bi.a 'majs 'teX 'Ti.du 'paj i 'ma~j~, 'Ti~.Ja es.ke'si.du u sa'boX
E, se pensava melhor, dir-se-ia que havia brotado da terra do sertão em cogumelo logo mofado.	i, si pe~'sa.va me'LOX, 'DiX si 'i.a ki a'vi.a bro'ta.du da 'tE.Ra du seX'ta~w~ e~j~ ko.gu~'mE.lu 'lO.gu mo'fa.du
Ela falava; sim, mas era extremamente muda.	'E.la fa'la.va, 'si~, majz 'E.ra es.tre~.ma~'me~.Ti 'mu.da
Uma palavra dela eu às vezes consigo mas ela me foge por entre os dedos.	u~.ma pa'la.vra 'dE.la ew as 've.zis ko~'si.gu majz 'E.la mi 'fO.Zi pur 'e~.tri us 'de.dus
Apesar da morte da tia, tinha certeza de que com ela ia ser diferente, pois nunca ia morrer.	a.pe'zaR da 'mOX.Ti da 'Ti.a, 'Ti~.Ja seX'te.za Di ki ko~ 'E.la 'i.a 'seR Di.fe're~.Ti, 'pojs 'nu~.ka 'i.a mo'ReX
É paixão minha ser o outro.	E paj'Sa~w~ 'mi~.Ja 'ser u 'ow.tru
No caso a outra.	nu 'ka.zu a 'ow.tra
Estremeço esquálido igual a ela.	es.tre~'me.su es'kwa.li.du i'gwaw a 'E.la
O definível está me cansando um pouco.	u de.fi~'ni.vew es'ta mi ka~'sa~.du u~ 'pow.ku
Prefiro a verdade que há no prenúncio.	pre'fi.ru a veR'da.Di ki 'a nu pre~'nu~.sju
Quando eu me livrar dessa história, voltarei ao domínio mais irresponsável de apenas ter leves prenúncios.	'kwa~.du ew mi li'vraR 'dE.sa is'tO.rja, vow.ta'rej aw do~'mi~.nju 'majz i.Res.po~'sa.vew Di a'pe~.nas 'teR 'lE.vis pre~'nu~.sjus
Eu não inventei essa moça.	ew 'na~w~ i~.ve~'tej 'E.sa 'mo.sa
Ela forçou dentro de mim a sua existência.	'E.la foX'sow 'de~.tru Di 'mi~ a 'su.a e.zis'te~.sja
Ela não era nem de longe débil mental, era à mercê e crente como uma idiota.	'E.la 'na~w~ 'E.ra ne~j~ Di 'lo~.Zi 'dE.biw me~'taw, 'E.ra a meX'se i 'kre~.Ti 'ko~.mu u~.ma i.Di'O.ta
A moça que pelo menos comida não mendigava, havia toda uma subclasse de gente mais perdida e com fome.	a 'mo.sa ki 'pe.lu 'me~.nus ko~'mi.da 'na~w~ me~.Di'ga.va, a'vi.a 'to.da u~.ma sub'kla.si Di 'Ze~.Ti 'majs peR'Di.da i ko~ 'fo~.mi
Depois, ignora-se por quê, tinham vindo para o Rio, o inacreditável Rio de Janeiro, a tia lhe arranjara emprego, finalmente morrera e ela, agora sozinha, morava numa vaga de quarto compartilhado com mais quatro moças balconistas das Lojas Americanas.	de'pojs, i.gi~'nO.ra si puX 'ke, 'Ti~.Ja~w~ 'vi~.du 'pa.ra u 'Ri.u, u i~.na.kre.Di'ta.vew 'Ri.u Di Za~'nej.ru, a 'Ti.a Li a.Ra~'Za.ra e~'pre.gu, fi~.naw'me~.Ti mo'Re.ra i 'E.la, a'gO.ra sO'zi~.Ja, mo'ra.va 'nu~.ma 'va.ga Di 'kwaX.tu ko~.paX.Ti'La.du ko~ 'majs 'kwa.tru 'mo.sas baw.ko~'nis.tas das 'lO.Zaz a~.me.ri'ka~.nas
O quarto ficava num velho sobrado colonial da áspera rua do Acre entre as prostitutas que serviam a marinheiros, depósitos de carvão e de cimento em pó, não longe do cais do porto.	u 'kwaX.tu fi'ka.va nu~ 'vE.Lu so'bra.du ko.lo~.ni'aw da 'as.pe.ra 'Ru.a du 'a.kri 'e~.tri as pros.Ti'tu.tas ki seR'vi.a~w~ a ma.ri~'Jej.rus, de'pO.si.tus Di kaR'va~w~ i Di si~'me~.tu e~j~ 'pO, 'na~w~ 'lo~.Zi du 'kajs du 'poX.tu
O cais imundo dava-lhe saudade do futuro.	u 'kajz i~'mu~.du 'da.va Li saw'da.Di du fu'tu.ru
O que é que há?	u ki E ki 'a
Pois estou como que ouvindo acordes de piano alegre, será isto o símbolo de que a vida da moça iria ter um futuro esplendoroso?	'pojz es'tow 'ko~.mu ki ow'vi~.du a'kOR.Dis Di pi'a~.nu a'lE.gri, se'ra 'is.tu u 'si~.bo.lu Di ki a 'vi.da da 'mo.sa i'ri.a 'ter u~ fu'tu.ru es.ple~.do'ro.zu
Estou contente com essa possibilidade e farei tudo para que esta se torne real.	es'tow ko~'te~.Ti ko~ 'E.sa po.si.bi.li'da.Di i fa'rej 'tu.du 'pa.ra ki 'Es.ta si 'tOR.ni Re'aw
Rua do Acre.	'Ru.a du 'a.kri
Mas que lugar.	majs ki lu'gaX
Os gordos ratos da rua do Acre.	us 'goR.dus 'Ra.tus da 'Ru.a du 'a.kri
Lá é que não piso pois tenho terror sem nenhuma vergonha do pardo pedaço de vida imunda.	'la E ki 'na~w~ 'pi.zu 'pojs 'te~.Ju te'RoX se~j~ ne~'Ju~.ma veR'go~.Ja du 'paR.du pe'da.su Di 'vi.da i~'mu~.da
Uma vez por outra tinha a sorte de ouvir de madrugada um galo cantar a vida e ela se lembrava nostálgica do sertão.	u~.ma 'vejs pur 'ow.tra 'Ti~.Ja a 'sOX.Ti Di ow'viR Di ma.dru'ga.da u~ 'ga.lu ka~'tar a 'vi.da i 'E.la si le~'bra.va nos'taw.Zi.ka du seX'ta~w~
Onde caberia um galo a cocoricar naquelas paragens ressequidas de artigos por atacado de exportação e importação?	'o~.Di ka.be'ri.a u~ 'ga.lu a ko.ko.ri'kaR na'kE.las pa'ra.Ze~s Re.se'ki.das Di aX'Ti.gus pur a.ta'ka.du Di es.poX.ta'sa~w~ i i~.poX.ta'sa~w~
Se o leitor possui alguma riqueza e vida bem acomodada, sairá de si para ver como é às vezes o outro.	si u lej'toX po'suj aw'gu~.ma Ri'ke.za i 'vi.da 'be~j~ a.ko~.mo'da.da, saj'ra Di 'si 'pa.ra 'veX 'ko~.mu E as 've.ziz u 'ow.tru
Se é pobre, não estará me lendo porque ler-me é supérfluo para quem tem uma leve fome permanente.	si E 'pO.bri, 'na~w~ es.ta'ra mi 'le~.du puX'ke 'leX mi E su'pEX.flwu 'pa.ra 'ke~j~ te~j~ u~.ma 'lE.vi 'fo~.mi peR.ma~'ne~.Ti
Faço aqui o papel de vossa válvula de escape e da vida massacrante da média burguesia.	'fa.su a'ki u pa'pEw Di 'vO.sa 'vaw.vu.la Di es'ka.pi i da 'vi.da ma.sa'kra~.Ti da 'mE.Dja buR.ge'zi.a
Bem sei que é assustador sair de si mesmo, mas tudo o que é novo assusta.	'be~j~ 'sej ki E a.sus.ta'doX sa'iR Di 'si 'mez.mu, majs 'tu.du u ki E 'no.vu a'sus.ta
Embora a moça anônima da história seja tão antiga que podia ser uma figura bíblica.	e~'bO.ra a 'mo.sa a~'no~.ni~.ma da is'tO.rja 'se.Za 'ta~w~ a~'Ti.ga ki po'Di.a 'ser u~.ma fi'gu.ra 'bi.bli.ka
Ela era subterrânea e nunca tinha tido floração.	'E.la 'E.ra sub.te'Ra~.nja i 'nu~.ka 'Ti~.Ja 'Ti.du flo.ra'sa~w~
Minto: ela era capim.	'mi~.tu, 'E.la 'E.ra ka'pi~
Dos verões sufocantes da abafada rua do Acre ela só sentia o suor, um suor que cheirava mal.	dus ve'ro~j~s su.fo'ka~.Tis da a.ba'fa.da 'Ru.a du 'a.kri 'E.la 'sO se~'Ti.a u su'OX, u~ su'OX ki Sej'ra.va 'maw
Esse suor me parece de má origem.	'e.si su'OR mi pa'rE.si Di 'ma o'ri.Ze~j~
Não sei se estava tuberculosa, acho que não.	'na~w~ 'sej si es'ta.va tu.beX.ku'lO.za, 'a.Su ki 'na~w~
No escuro da noite um homem assobiando e passos pesados, o uivo do vira-latas abandonado.	nu es'ku.ru da 'noj.Ti u~ 'o~.me~j~ a.so.bi'a~.du i 'pa.sus pe'za.dus, u 'uj.vu du 'vi.ra 'la.taz a.ba~.do~'na.du
Enquanto isso, as constelações silenciosas e o espaço que é tempo que nada tem a ver com ela e conosco.	e~'kwa~.tu 'i.su, as ko~s.te.la'so~j~s si.le~.si'O.zaz i u es'pa.su ki E 'te~.pu ki 'na.da te~j~ a 'veX ko~ 'E.la i ko~'nos.ku
Pois assim se passavam os dias.	'pojz a'si~ si pa'sa.va~w~ us 'Di.as
O cantar de galo na aurora sanguinolenta dava um sentido fresco à sua vida murcha.	u ka~'taR Di 'ga.lu na aw'rO.ra sa~.gi~.no'le~.ta 'da.va u~ se~'Ti.du 'fres.ku a 'su.a 'vi.da 'muX.Sa
Havia de madrugada uma passarinhada buliçosa na rua do Acre: é que a vida brotava no chão, alegre por entre pedras.	a'vi.a Di ma.dru'ga.da u~.ma pa.sa.ri~'Ja.da bu.li'sO.za na 'Ru.a du 'a.kri, E ki a 'vi.da bro'ta.va nu 'Sa~w~, a'lE.gri pur 'e~.tri 'pE.dras
Rua do Acre para morar, rua do Lavradio para trabalhar, cais do porto para ir espiar no domingo, um ou outro prolongado apito de navio cargueiro que não se sabe por que dava aperto no coração, um ou outro ,delicioso embora um pouco doloroso cantar de galo.	'Ru.a du 'a.kri 'pa.ra mo'raX, 'Ru.a du la.vra'Di.u 'pa.ra tra.ba'LaX, 'kajs du 'poX.tu 'pa.ra 'ir es.pi'aR nu do~'mi~.gu, 'u~ ow 'ow.tru pro.lo~'ga.du a'pi.tu Di na'vi.u kaR'gej.ru ki 'na~w~ si 'sa.bi puX 'ke 'da.va a'peX.tu nu ko.ra'sa~w~, 'u~ ow 'ow.tru, de.li.si'o.zu e~'bO.ra u~ 'pow.ku do.lo'ro.zu ka~'taR Di 'ga.lu
Era do nunca que vinha o galo.	'E.ra du 'nu~.ka ki 'vi~.Ja u 'ga.lu
Vinha do infinito até a sua cama, dando-lhe gratidão.	'vi~.Ja du i~.fi~'ni.tu a'tE a 'su.a 'ka~.ma, 'da~.du Li gra.Ti'da~w~
Sono superficial porque estava há quase um ano resfriada.	'so~.nu su.peX.fi.si'aw puX'ke es'ta.va 'a 'kwa.zi 'u~ 'a~.nu Res.fri'a.da
Tinha acesso de tosse seca de madrugada: abafava-a com o travesseiro ralo.	'Ti~.Ja a'sE.su Di 'tO.si 'se.ka Di ma.dru'ga.da, a.ba'fa.va a ko~ u tra.ve'sej.ru 'Ra.lu
Estavam cansadas demais pelo trabalho que nem por ser anônimo era menos árduo.	es'ta.va~w~ ka~'sa.das de~'majs 'pe.lu tra'ba.Lu ki ne~j~ puX 'ser a~'no~.ni~.mu 'E.ra 'me~.nuz 'aR.dwu
Uma vendia pó-de-arroz Coty, mas que idéia.	u~.ma ve~'Di.a 'pO Di a'Rojs ko'Ti, majs ki i'dEj.a
Elas viravam para o outro lado e readormeciam.	'E.las vi'ra.va~w~ 'pa.ra u 'ow.tru 'la.du i Re.a.doR.me'si.a~w~
A tosse da outra até que as embalava em sono mais profundo.	a 'tO.si da 'ow.tra a'tE ki az e~.ba'la.va e~j~ 'so~.nu 'majs pro'fu~.du
O céu é para baixo ou para cima?	u 'sEw E 'pa.ra 'baj.Su ow 'pa.ra 'si~.ma
Pensava a nordestina.	pe~'sa.va a noR.des'Ti~.na
Deitada, não sabia.	dej'ta.da, 'na~w~ sa'bi.a
Às vezes antes de dormir sentia fome e ficava meio alucinada pensando em coxa de vaca.	as 've.ziz 'a~.Tis Di doR'miX se~'Ti.a 'fo~.mi i fi'ka.va 'mej.u a.lu.si~'na.da pe~'sa~.du e~j~ 'ko.Sa Di 'va.ka
O remédio então era mastigar papel bem mastigadinho e engolir.	u Re~'mE.Dju e~'ta~w~ 'E.ra mas.Ti'gaX pa'pEw 'be~j~ mas.Ti.ga'Di~.Ju i e~.go'liX
Eu me acostumo mas não amanso.	ew mi a.kos'tu~.mu majs 'na~w~ a~'ma~.su
Por Deus!	puR 'dews
eu me dou melhor com os bichos do que com gente.	ew mi 'dow me'LOX ko~ us 'bi.Sus du ki ko~ 'Ze~.Ti
Quando vejo o meu cavalo livre e solto no prado, tenho vontade de encostar meu rosto no seu vigoroso e aveludado pescoço e contar-lhe a minha vida.	'kwa~.du 've.Zu u 'mew ka'va.lu 'li.vri i 'sow.tu nu 'pra.du, 'te~.Ju vo~'ta.Di Di e~.kos'taR 'mew 'Ros.tu nu 'sew vi.go'ro.zu i a.ve.lu'da.du pes'ko.su i ko~'taX Li a 'mi~.Ja 'vi.da
E quando acaricio a cabeça de meu cão, sei que ele não exige que eu faça sentido ou me explique.	i 'kwa~.du a.ka.ri'si.u a ka'be.sa Di 'mew 'ka~w~, 'sej ki 'e.li 'na~w~ e'zi.Zi ki ew 'fa.sa se~'Ti.du ow mi es'pli.ki
Talvez a nordestina já tivesse chegado à conclusão de que vida incomoda bastante, alma que não cabe bem no corpo, mesmo alma rala como a sua.	taw'vejz a noR.des'Ti~.na 'Za Ti'vE.si Se'ga.du a ko~.klu'za~w~ Di ki 'vi.da i~.ko~'mO.da bas'ta~.Ti, 'aw.ma ki 'na~w~ 'ka.bi 'be~j~ nu 'koX.pu, 'mez.mu 'aw.ma 'Ra.la 'ko~.mu a 'su.a
Imaginavazinha, toda supersticiosa, que se por acaso viesse alguma vez a sentir um gosto bem bom de viver, se desencantaria de súbito de princesa que era e se transformaria em bicho rasteiro.	i~.ma.Zi~.na.va'zi~.Ja, 'to.da su.peXs.Ti.si'O.za, ki si pur a'ka.zu vi'E.si aw'gu~.ma 'vejz a se~'Tir u~ 'gos.tu 'be~j~ 'bo~ Di vi'veX, si de.ze~.ka~.ta'ri.a Di 'su.bi.tu Di pri~'se.za ki 'E.ra i si tra~s.foR.ma'ri.a e~j~ 'bi.Su Ras'tej.ru
Porque, por pior que fosse sua situação, não queria ser privada de si, ela queria ser ela mesma.	puX'ke, puX pi'OX ki 'fo.si 'su.a si.tu.a'sa~w~, 'na~w~ ke'ri.a 'seX pri'va.da Di 'si, 'E.la ke'ri.a 'ser 'E.la 'mez.ma
Achava que cairia em grave castigo e até risco de morrer se tivesse gosto.	a'Sa.va ki kaj'ri.a e~j~ 'gra.vi kas'Ti.gu i a'tE 'Ris.ku Di mo'ReX si Ti'vE.si 'gos.tu
Então defendia-se da morte por intermédio de um viver de menos, gastando pouco de sua vida para esta não acabar.	e~'ta~w~ de.fe~'Di.a si da 'mOX.Ti pur i~.teR'mE.Dju Di u~ vi'veR Di 'me~.nus, gas'ta~.du 'pow.ku Di 'su.a 'vi.da 'pa.ra 'Es.ta 'na~w~ a.ka'baX
Essa economia lhe dava alguma segurança pois, quem cai, do chão não passa.	'E.sa e.ko~.no~'mi.a Li 'da.va aw'gu~.ma se.gu'ra~.sa 'pojs, 'ke~j~ 'kaj, du 'Sa~w~ 'na~w~ 'pa.sa
Teria ela a sensação de que vivia para nada?	te'ri.a 'E.la a se~.sa'sa~w~ Di ki vi'vi.a 'pa.ra 'na.da
Nem posso saber, mas acho que não.	ne~j~ 'pO.su sa'beX, majz 'a.Su ki 'na~w~
Assustou-se tanto que parou completamente de pensar.	a.sus'tow si 'ta~.tu ki pa'row ko~.plE.ta~'me~.Ti Di pe~'saX
Mas eu; que não chego a ser ela, sinto que vivo para nada.	majz ew, ki 'na~w~ 'Se.gu a 'ser 'E.la, 'si~.tu ki 'vi.vu 'pa.ra 'na.da
Sou gratuito e pago as contas de luz, gás e telefone.	'sow gra'tuj.tu i 'pa.gu as 'ko~.tas Di 'lujs, 'gajz i te.le'fo~.ni
Quanto a ela, até mesmo de vez em quando ao receber o salário comprava uma rosa.	'kwa~.tu a 'E.la, a'tE 'mez.mu Di 'vejz e~j~ 'kwa~.du aw Re.se'ber u sa'la.rju ko~'pra.va u~.ma 'RO.za
Tudo isso acontece no ano este que passa e só acabarei esta história difícil quando eu ficar exausto da luta, não sou um desertor.	'tu.du 'i.su a.ko~'tE.si nu 'a~.nu 'es.Ti ki 'pa.sa i 'sO a.ka.ba'rej 'Es.ta is'tO.rja Di'fi.siw 'kwa~.du ew fi'kar e'zaws.tu da 'lu.ta, 'na~w~ 'sow u~ de.zeX'toX
As vezes lembrava-se de uma assustadora canção desafinada de meninas brincando de roda de mãos dadas, ela só ouvia sem participar porque a tia a queria para varrer o chão.	as 've.zis le~'bra.va si Di u~.ma a.sus.ta'do.ra ka~'sa~w~ de.za.fi~'na.da Di me~'ni~.nas bri~'ka~.du Di 'RO.da Di 'ma~w~s 'da.das, 'E.la 'sO ow'vi.a se~j~ paX.Ti.si'paX puX'ke a 'Ti.a a ke'ri.a 'pa.ra va'Rer u 'Sa~w~
As meninas de cabelos ondulados com laço de fita cor-de-rosa.	as me~'ni~.nas Di ka'be.luz o~.du'la.dus ko~ 'la.su Di 'fi.ta 'koX Di 'RO.za
Quero uma de vossas filhas de marré-marré-deci.	'kE.ru u~.ma Di 'vO.sas 'fi.Las Di ma'RE ma'RE de'si
Escolhei a qual quiser de marré.	es.ko'Lej a 'kwaw ki'zER Di ma'RE
A música era um fantasma pálido como uma rosa que é louca de beleza mas mortal: pálida e mortal a moça era hoje o fantasma suave e terrificante de uma infância sem bola nem boneca.	a 'mu.zi.ka 'E.ra u~ fa~'taz.ma 'pa.li.du 'ko~.mu u~.ma 'RO.za ki E 'low.ka Di be'le.za majs moX'taw, 'pa.li.da i moX'taw a 'mo.sa 'E.ra 'o.Zi u fa~'taz.ma su'a.vi i te.Ri.fi'ka~.Ti Di u~.ma i~'fa~.sja se~j~ 'bO.la ne~j~ bo~'nE.ka
Então costumava fingir que corria pelos corredores de boneca na mão atrás de uma bola e rindo muito.	e~'ta~w~ kos.tu~'ma.va fi~'ZiX ki ko'Ri.a 'pe.lus ko.Re'do.ris Di bo~'nE.ka na 'ma~w~ a'trajs Di u~.ma 'bO.la i 'Ri~.du 'mu~j~.tu
Eu bem avisei que era literatura de cordel embora eu me recuse a ter qualquer piedade.	ew 'be~j~ a.vi'zej ki 'E.ra li.te.ra'tu.ra Di koR'dEw e~'bO.ra ew mi Re'ku.zi a 'teX kwaw'kEX pi.e'da.Di
Devo dizer que essa moça não tem consciência de mim, se tivesse teria para quem rezar e seria a salvação.	'de.vu Di'zeX ki 'E.sa 'mo.sa 'na~w~ te~j~ ko~.si'e~.sja Di 'mi~, si Ti'vE.si te'ri.a 'pa.ra 'ke~j~ Re'zar i se'ri.a a saw.va'sa~w~
Mas eu tenho plena consciência dela: através dessa jovem dou o meu grito de horror à vida.	majz ew 'te~.Ju 'ple~.na ko~.si'e~.sja 'dE.la, a.tra'vEjs 'dE.sa 'ZO.ve~j~ 'dow u 'mew 'gri.tu Di o'Ror a 'vi.da
A vida que tanto amo.	a 'vi.da ki 'ta~.tu 'a~.mu
Volto à moça: o luxo que se dava era tomar um gole frio de café antes de dormir.	'vOw.tu a 'mo.sa, u 'lu.Su ki si 'da.va 'E.ra to~'mar u~ 'gO.li 'fri.u Di ka'fE 'a~.Tis Di doR'miX
Pagava o luxo tendo azia ao acordar.	pa'ga.va u 'lu.Su 'te~.du a'zi.a aw a.koR'daX
Um amor de gato	u~ a~'moR Di 'ga.tu
Lições de quem sabe viver a vida	li'so~j~s Di 'ke~j~ 'sa.bi vi'ver a 'vi.da
Glenn Dromgoole	'gle~ dro~'gu.li
Seja muito rigoroso com a higiene pessoal	'se.Za 'mu~j~.tu Ri.go'ro.zu ko~ a i.Zi'e~.ni pe.so'aw
Dê uma boa espreguiçada ao acordar e sempre que puder	'de u~.ma 'bo.a es.pre.gi'sa.da aw a.koR'dar i 'se~.pri ki pu'dEX
Se você tem um tempinho para descansar ao sol, aproveite.	si vo'se te~j~ u~ te~'pi~.Ju 'pa.ra des.ka~'sar aw 'sOw, a.pro'vej.Ti
Observe o mundo pela janela.	ob'sER.vi u 'mu~.du 'pe.la Za~'nE.la
Saber se cuidar é um trunfo.	sa'beX si kuj'dar E u~ 'tru~.fu
Não tenha mais bebês do que você possa dar conta.	'na~w~ 'te~.Ja 'majs be'bejs du ki vo'se 'pO.sa 'daX 'ko~.ta
Depois de um dia difícil, um carinho gostoso sempre ajuda.	de'pojs Di u~ 'Di.a Di'fi.siw, u~ ka'ri~.Ju gos'to.zu 'se~.pri a'Zu.da
O melhor momento para tirar uma sonequinha é agora.	u me'LOR mo~'me~.tu 'pa.ra Ti'rar u~.ma so~.ne'ki~.Ja E a'gO.ra
Guarde sua energia para quando ela for necessária.	'gwaR.Di 'su.a e~.neR'Zi.a 'pa.ra 'kwa~.du 'E.la 'foR ne.se'sa.rja
Faça uma avaliação física pelo menos uma vez por ano.	'fa.sa u~.ma a.va.li.a'sa~w~ 'fi.zi.ka 'pe.lu 'me~.nuz u~.ma 'vejs pur 'a~.nu
Siga seus instintos.	'si.ga 'sewz i~s'Ti~.tus
A melhor cura para insonia é dormir.	a me'LOX 'ku.ra 'pa.ra i~.so~'ni.a E doR'miX
Beba bastante água.	'be.ba bas'ta~.Ti 'a.gwa
Coce onde estiver incomodando.	'kO.si 'o~.Di es.Ti'vEr i~.ko~.mo'da~.du
Quando tiver de fazer alguma coisa, faça.	'kwa~.du Ti'vER Di fa'zer aw'gu~.ma 'koj.za, 'fa.sa
Tome cuidado no trânsito!	'to~.mi kuj'da.du nu 'tra~.zi.tu
Siga uma dieta balanceada.	'si.ga u~.ma Di'E.ta ba.la~.se'a.da
Muitas vezes a gente só precisa de um pouco de confiança.	'mu~j~.tas 've.ziz a 'Ze~.Ti 'sO pre'si.za Di u~ 'pow.ku Di ko~.fi'a~.sa
Mostre-se feliz ao ser bem-tratado.	'mOs.tri si fe'liz aw 'seR 'be~j~ tra'ta.du
Não dá para ficar em cima do muro o tempo todo.	'na~w~ 'da 'pa.ra fi'kar e~j~ 'si~.ma du 'mu.ru u 'te~.pu 'to.du
Lave as Mãos antes de jantar.	'la.vi as 'ma~w~z 'a~.Tis Di Za~'taX
A Convivência com os Outros	a ko~.vi've~.sja ko~ uz 'ow.trus
Não hesite em demonstrar carinho a quem você ama.	'na~w~ e'zi.Ti e~j~ de~.mo~s'traX ka'ri~.Ju a 'ke~j~ vo'se 'a~.ma
É bom ser mimado.	E 'bo~ 'seR mi~'ma.du
Nunca subestime o poder de um ronrom.	'nu~.ka su.bes'Ti~.mi u po'deR Di u~ Ro~'Ro~
O mundo poderia ser um pouco mais gentil.	u 'mu~.du po.de'ri.a 'ser u~ 'pow.ku 'maj.Ze~'Tiw
Reserve algum tempo para brincar com aqueles a quem você ama.	Re'zER.vi aw'gu~ 'te~.pu 'pa.ra bri~'kaX ko~ a'ke.liz a 'ke~j~ vo'se 'a~.ma
Dê atenção a uma pessoa de cada vez.	'de a.te~'sa~w~ a u~.ma pe'so.a Di 'ka.da 'vejs
Se alguém se oferecer para coçar suas costas, aceite.	si aw'ge~j~ si o.fe.re'seX 'pa.ra ko'saX 'su.as 'kOs.tas, a'sej.Ti
Agradeça o fato de que tomaram conta de você quando era pequeno demais para se defender sozinho.	a.gra'de.sa u 'fa.tu Di ki to~'ma.ra~w~ 'ko~.ta Di vo'se 'kwa~.du 'E.ra pe'ke~.nu de~'majs 'pa.ra si de.fe~'deX sO'zi~.Ju
Faça alguem se sentir melhor mostrando receptividade.	'fa.sa aw'ge~j~ si se~'TiR me'LOR mos'tra~.du Re.sep.Ti.vi'da.Di
Olhe direto nos olhos quando quiser alguma coisa.	'O.Li Di'rE.tu nuz 'O.Lus 'kwa~.du ki'zEr aw'gu~.ma 'koj.za
Não é preciso um amplo vocabulário para expor suas ideias.	'na~w~ E pre'si.zu u~ 'a~.plu vo.ka.bu'la.rju 'pa.ra es'poX 'su.az i'dEj.as
Temos de aprender a confiar nos outros.	'te~.mus Di a.pre~'der a ko~.fi'aR nuz 'ow.trus
Não tenha paciência com pessoas enfadonhas.	'na~w~ 'te~.Ja pa.si'e~.sja ko~ pe'so.az e~.fa'do~.Jas
Deixe claro que você não é propriedade de ninguém.	'dej.Si 'kla.ru ki vo'se 'na~w~ E pro.pri.e'da.Di Di ni~'ge~j~
Você não precisa ser rico, famoso ou poderoso para ser amado.	vo'se 'na~w~ pre'si.za 'se'Ri.ku, fa~'mo.zu ow po.de'ro.zu 'pa.ra 'ser a~'ma.du
Aguarde com expectativa a chegada de alguém que você ama.	a'gwaR.Di ko~ es.pek.ta'Ti.va a Se'ga.da Di aw'ge~j~ ki vo'se 'a~.ma
Não seja muito crítico com os colegas.	'na~w~ 'se.Za 'mu~j~.tu 'kri.Ti.ku ko~ us ko'lE.gas
Partilhe o que você possui com os outros.	paX'Ti.Li u ki vo'se po'suj ko~ uz 'ow.trus
Valorize quem sabe ouvir.	va.lo'ri.zi 'ke~j~ 'sa.bi ow'viX
Sinta-se reconfortado com as gentilezas de estranhos.	'si~.ta si Re.ko~.foX'ta.du ko~ a.Ze~.Ti'le.zas Di es'tra~.Jus
A confiança é ingrediente básico numa relação de amor.	a ko~.fi'a~.sa E i~.gre.Di'e~.Ti 'ba.zi.ku 'nu~.ma Re.la'sa~w~ Di a~'moX
Faça do companheirismo uma prioridade.	'fa.sa du ko~.pa~.Jej'riz.mu u~.ma pri.o.ri'da.Di
Não mexa com quem não pode se defender.	'na~w~ 'me.Sa ko~ 'ke~j~ 'na~w~ 'pO.Di si de.fe~'deX
Ninguém é tão compreensivo quanto sua mãe.	ni~'ge~j~ E 'ta~w~ ko~.pre.e~'si.vu 'kwa~.tu 'su.a 'ma~j~
Peça licença antes de mexer nas coisas dos outros.	'pE.sa li'se~.sa 'a~.Tis Di me'SeR nas 'koj.zas duz 'ow.trus
A Auto-Estima	a 'aw.tu es'Ti~.ma
Sua reputaçao vai melhorar se você for um pouco misterioso.	'su.a Re.pu.ta'saw 'vaj me.Lo'raX si vo'se 'for u~ 'pow.ku mis.te.ri'o.zu
Se você souber recuar sem sair do lugar, os valentões deixarão de incomodá-lo.	si vo'se sow'bE.Re.ku'aX se~j~ sa'iR du lu'gaX, us va.le~'to~j~s dej.Sa'ra~w~ Di i~.ko~.mo'da lu
Fugir de uma luta pode ser sinal de inteligência, não de covardia.	fu'ZiR Di u~.ma 'lu.ta 'pO.Di 'seX si~'naw Di i~.te.li'Ze~.sja, 'na~w~ Di ko.vaR'Di.a
Se quiser atingir um lugar mais alto, acredite em sua capacidade de alcançá-lo.	si ki'zEr a.Ti~'Zir u~ lu'gaR 'majz 'aw.tu, a.kre'Di.Ti e~j~ 'su.a ka.pa.si'da.Di Di aw.ka~'sa lu
O ócio sofisticado não ocorre naturalmente;  é necessário saber cultivá-lo.	u 'O.sju so.fis.Ti'ka.du 'na~w~ o'kO.Ri na.tu.raw'me~.Ti, E ne.se'sa.rju sa'beX kuw.Ti'va lu
Mesmo que você saiba que é superior a todos que o cercam, não se vanglorie.	'mez.mu ki vo'se 'saj.ba ki E su.pe.ri'or a 'to.dus ki u 'sEX.ka~w~, 'na~w~ si va~.glo'ri.i
Você não chegara a lugar nenhum correndo em círculos.	vo'se 'na~w~ Se'ga.ra a lu'gaR ne~'Ju~ ko'Re~.du e~j~ 'siX.ku.lus
Orgulhe-se de suas peculiaridades.	oR'gu.Li si Di 'su.as pe.ku.li.a.ri'da.Dis
Cante, mesmo que seja desafinado.	'ka~.Ti, 'mez.mu ki 'se.Za de.za.fi~'na.du
Todo mundo fica chateado de vez em quando.	'to.du 'mu~.du 'fi.ka Sa.te'a.du Di 'vejz e~j~ 'kwa~.du
Seja feliz com seu jeito de ser.	'se.Za fe'lis ko~ 'sew 'Zej.tu Di 'seX
A capacidade de rir de si próprio não tem preço.	a ka.pa.si'da.Di Di 'RiR Di 'si 'prO.prju 'na~w~ te~j~ 'pre.su
Ser gentil é mais importante do que ser importante.	'seR Ze~'Tiw E 'majz i~.poX'ta~.Ti du ki 'ser i~.poX'ta~.Ti
Às vezes é melhor segurar a língua.	as 've.ziz E me'LOX se.gu'rar a 'li~.gwa
Conte até dez antes de criticar.	'ko~.Ti a'tE 'dEjz 'a~.Tis Di kri.Ti'kaX
A auto-satisfação é um dos objetos mais elevados da existência.	a 'aw.tu sa.Tis.fa'sa~w~ E u~ duz ob'ZE.tus 'majz e.le'va.dus da e.zis'te~.sja
Um pouco de paz e quietude vai acalmar sua alma.	u~ 'pow.ku Di 'pajz i ki.e'tu.Di 'vaj a.kaw'maX 'su.a 'aw.ma
O Desenvolvimento Pessoal	u de.ze~.vow.vi~'me~.tu pe.so'aw
Aprenda a manter a calma nas situações difíceis.	a'pre~.da a ma~'ter a 'kaw.ma nas si.tu.a'so~j~s Di'fi.sejs
Agarre as oportunidades que aparecem.	a'ga.Ri az o.poX.tu~.ni'da.Dis ki a.pa'rE.se~j~
Você pode aprender muito se souber manter-se calado e ouvir.	vo'se 'pO.Di a.pre~'deR 'mu~j~.tu si sow'beR ma~'teX si ka'la.du i ow'viX
Alimente a independência de espírito.	a.li~'me~.Ti a i~.de.pe~'de~.sja Di es'pi.ri.tu
Expresse a sua individualidade.	es'prE.si a 'su.a i~.Di.vi.du.a.li'da.Di
Não reprima a curiosidade.	'na~w~ Re'pri~.ma a ku.ri.o.zi'da.Di
Não se meta em apuros à toa.	'na~w~ si 'me.ta e~j~ a'pu.ruz a 'to.a
Cuide da aparência.	'kuj.Di da a.pa're~.sja
Não importa quantas vidas possamos pensar que temos, é nesta que devemos dar o máximo de nós.	'na~w~ i~'pOX.ta 'kwa~.tas 'vi.das po'sa~.mus pe~'saX ki 'te~.mus, E 'nEs.ta ki de've~.mus 'dar u 'ma.si~.mu Di 'nOjs
Se você passar tempo demais só observando o mundo girar, ele vai continuar girando.	si vo'se pa'saX 'te~.pu de~'majs 'sO ob.seR'va~.du u 'mu~.du Zi'raX, 'e.li 'vaj ko~.Ti~.nu'aR Zi'ra~.du
Só beba água filtrada.	'sO 'be.ba 'a.gwa fiw'tra.da
Seja curiosa a respeito do que está do outro lado da cerca, mas evite ser invejosa.	'se.Za ku.ri'O.za a Res'pej.tu du ki es'ta du 'ow.tru 'la.du da 'seX.ka, majz e'vi.Ti 'ser i~.ve'ZO.za
Concentre-se silenciosamente em sua tarefa.	ko~'se~.tri si si.le~.si.O.za~'me~.Ti e~j~ 'su.a ta'rE.fa
Todas as criaturas do planeta devem ser respeitadas.	'to.daz as kri.a'tu.ras du pla~'ne.ta 'dE.ve~j~ 'se.Res.pej'ta.das
Divirta-se, onde quer que você esteja.	Di'viX.ta si, 'o~.Di 'kEX ki vo'se es'te.Za
Arriscar-se pode trazer belas e inesperadas perspectivas.	a.Ris'kaX si 'pO.Di tra'zeR 'bE.laz i i~.nes.pe'ra.das peXs.pek'Ti.vas
Saboreie os momentos em que estiver sozinho.	sa.bo'rej.i us mo~'me~.tuz e~j~ ki es.Ti'vEX sO'zi~.Ju
As Atividades do Cotidiano.	az a.Ti.vi'da.Dis du ko.Ti.Di'a~.nu
Evite brigas.	e'vi.Ti 'bri.gas
É importante conhecer o caminho de casa.	E i~.poX'ta~.Ti ko~.Je'ser u ka~'mi~.Ju Di 'ka.za
Um gato no colo é muito mais aconchegante do que um laptop.	u~ 'ga.tu nu 'kO.lu E 'mu~j~.tu 'majz a.ko~.Se'ga~.Ti du ki u~ 'lap.top
Encontre um lugarzinho especial e passe bastante tempo nele.	e~'ko~.tri u~ lu.gaR'zi~.Ju es.pe.si'aw i 'pa.si bas'ta~.Ti 'te~.pu 'ne.li
Se você não pode se deitar no sofá, qual é a utilidade dele?	si vo'se 'na~w~ 'pO.Di si dej'taR nu so'fa, 'kwaw E a u.Ti.li'da.Di 'de.li
Apoie causas humanitárias - principalmente se forem a favor dos gatos.	a'pOj.i 'kaw.zas u~.ma~.ni'ta.rjas, pri~.si.paw'me~.Ti si 'fo.re~j~ a fa'voR dus 'ga.tus
É difícil arranjar problemas quando estamos dormindo.	E Di'fi.siw a.Ra~'ZaX pro'ble~.mas 'kwa~.du es'ta~.mus doR'mi~.du
Não aceite imitações.	'na~w~ a'sej.Ti i~.mi.ta'so~j~s
Nem sempre conseguimos aquilo que queremos.	ne~j~ 'se~.pri ko~.se'gi~.muz a'ki.lu ki ke're~.mus
Na maioria das vezes, os problemas são criados por nós mesmos.	na maj.o'ri.a das 've.zis, us pro'ble~.mas 'sa~w~ kri'a.dus puR 'nOjs 'mez.mus
Todos nós precisamos passar algum tempo sozinhos.	'to.dus 'nOjs pre.si'za~.mus pa'sar aw'gu~ 'te~.pu sO'zi~.Jus
Seja rápido: nem sempre você consegue as coisas assim, de mão beijada!	'se.Za 'Ra.pi.du, ne~j~ 'se~.pri vo'se ko~'sE.gi as 'koj.zaz a'si~, Di 'ma~w~ bej'Za.da
Esconder-se debaixo das cobertas não vai acabar com os problemas.	es.ko~'deX si de'baj.Su das ko'bEX.tas 'na~w~ 'vaj a.ka'baX ko~ us pro'ble~.mas
Ofereça e aceite ajuda em situações extremas.	o.fe're.sa i a'sej.Ti a'Zu.da e~j~ si.tu.a'so~j~z es'tre~.mas
Não tenha medo do mundo lá fora; ele não é tão grande quanto parece!	'na~w~ 'te~.Ja 'me.du du 'mu~.du 'la 'fO.ra, 'e.li 'na~w~ E 'ta~w~ 'gra~.Di 'kwa~.tu pa'rE.si
Ouça seus pais, e você não se meterá em tantas encrencas.	'ow.sa 'sews 'pajs, i vo'se 'na~w~ si me.te'ra e~j~ 'ta~.taz e~'kre~.kas
Aqueça-se ao sol, em meio a beleza do mundo a sua volta.	a'ke.sa si aw 'sOw, e~j~ 'mej.u a be'le.za du 'mu~.du a 'su.a 'vOw.ta
Dai-me um ponto de apoio e levantarei o mundo.	'daj mi u~ 'po~.tu Di a'poj.u i le.va~.ta'rej u 'mu~.du
Um ateu é um homem que não possui meios invisíveis de apoio.	u~ a'tew E u~ 'o~.me~j~ ki 'na~w~ po.suj 'mej.uz i~.vi'zi.vejs Di a'poj.u
Ironia da vida: a mulher dá-se como prêmio ao fraco e apoio ao forte, e nunca ninguém tem o que precisa.	i.ro~'ni.a da 'vi.da, a mu'LEX 'da si 'ko~.mu 'pre~.mju aw 'fra.ku i a'poj.u aw 'fOX.Ti, i 'nu~.ka ni~'ge~j~ te~j~ u ki pre'si.za
Dê-me uma alavanca e um ponto de apoio e levantarei o mundo	'de mi u~.ma a.la'va~.ka i u~ 'po~.tu Di a'poj.u i le.va~.ta'rej u mu~.du
Um governo que precisa de juramentos não merece apoio, nem deve ser apoiado.	u~ go'veR.nu ki pre'si.za Di Zu.ra~'me~.tus 'na~w~ me'rE.si a'poj.u, ne~j~ 'dE.vi 'ser a.poj'a.du
O ser, o ter e o fazer são como triângulo, no qual cada lado serve de apoio para os demais. Não há conflito entre eles.	u 'seX, u 'ter i u fa'zeX 'sa~w~ 'ko~.mu tri'a~.gu.lu, nu 'kwaw 'ka.da 'la.du 'sER.vi Di a'poj.u 'pa.ra us de~'majs, 'na~w~ 'a ko~'fli.tu 'e~.tri 'e.lis
Urge prevení-los do muito que se poderia fazer, com apoio no saber científico, e do descalabro e pequenez do que se está fazendo	'uR.Zi pre.ve~'ni lus du 'mu~j~.tu ki si po.de'ri.a fa'zeX, ko~ a'poj.u nu sa'beX si.e~'Ti.fi.ku, i du des.ka'la.bru i pe.ke~'nejz du ki si es'ta fa'ze~.du
Não existe problema com a Bíblia, o erro está nos seus intérpretes que buscam nela apoio para suas ideias.	'na~w~ e'zis.Ti pro'ble~.ma ko~ a 'bi.blja, u 'e.Ru es'ta nus 'sewz i~'tEX.pre.Tis ki 'bus.ka~w~ 'nE.la a'poj.u 'pa.ra 'su.az i'dEj.as
Você foi lindo comigo. E distante. Me deu apoio, não o ombro.	vo'se 'foj 'li~.du ko~'mi.gu, i Dis'ta~.Ti, mi 'dew a'poj.u, 'na~w~ u 'o~.bru
Os seres aos quais servimos de amparo são para nós um apoio na vida.	us 'se.riz aws 'kwajs seR'vi~.mus Di a~'pa.ru 'sa~w~ 'pa.ra 'nOjz u~ a'poj.u na 'vi.da
O princípio do modelo constitui o mais forte apoio das modificações que se verificam no mundo.	u pri~'si.pju du mo'de.lu ko~s.Ti'tuj u 'majs 'fOX.Ti a'poj.u das mo.Di.fi.ka'so~j~s ki si ve.ri'fi.ka~w~ nu 'mu~.du
Não apoio o fascismo, ou qualquer outro ismo. Na minha opinião, os ismos não prestam. Não se deve acreditar neles, mas sim em nós mesmo.	'na~w~ a'pOj.u u fa'siz.mu, ow kwaw'kEr 'ow.tru 'iz.mu, na 'mi~.Ja o.pi~.ni'a~w~, uz 'iz.mus 'na~w~ 'prEs.ta~w~, 'na~w~ si 'dE.vi a.kre.Di'taR 'ne.lis, majs 'si~ e~j~ 'nOjs 'mez.mu
A amizade verdadeira é aquela que mesmos distante você sabe que pode contar, como um apoio que mesmo que você não use fica lá guardadinho!	a a~.mi'za.Di veR.da'dej.ra E a'kE.la ki 'mez.mus Dis'ta~.Ti vo'se 'sa.bi ki 'pO.Di ko~'taX, 'ko~.mu u~ a'poj.u ki 'mez.mu ki vo'se 'na~w~ 'u.zi 'fi.ka 'la gwaR.da'Di~.Ju
É perdendo o apoio que a gente descobre que o resto do mundo não para só porque nosso mundo parou. A gente vai aprendendo a viver assim, na marra, no grito, no sufoco, no impulso.	E peR'de~.du u a'poj.u ki a 'Ze~.Ti des'kO.bri ki u 'REs.tu du 'mu~.du 'na~w~ 'pa.ra 'sO puX'ke 'nO.su 'mu~.du pa'row, a 'Ze~.Ti 'vaj a.pre~'de~.du a vi'ver a'si~, na 'ma.Ra, nu 'gri.tu, nu su'fo.ku, nu i~'puw.su
Um governo que rouba de Pedro para dar a Paulo, pode sempre contar com o apoio de Paulo	u~ go'veR.nu ki 'Row.ba Di 'pe.dru 'pa.ra 'dar a 'paw.lu, 'pO.Di 'se~.pri ko~'taX ko~ u a'poj.u Di 'paw.lu
Que Jesus seja sempre e em tudo seu apoio, seu consolo e sua vida!	ki Ze'zujs 'se.Za 'se~.pri i e~j~ 'tu.du 'sew a'poj.u, 'sew ko~'so.lu i 'su.a 'vi.da
Ninguém daria o menor apoio, nem teria a menor devoção por uma pessoa real	ni~'ge~j~ da'ri.a u me~'nOr a'poj.u, ne~j~ te'ri.a a me~'nOR de.vo'sa~w~ pur u~.ma pe'so.a Re'aw
Lily: Eu não preciso de objetividade. Você é minha melhor amiga, eu só preciso do seu apoio.	'li.li, ew 'na~w~ pre'si.zu Di ob.Ze.Ti.vi'da.Di, vo'se E 'mi~.Ja me'LOr a~'mi.ga, ew 'sO pre'si.zu du 'sew a'poj.u
Cuidado com quem você compartilha seus sonhos. Ao invés de apoio, você poderá receber inveja...	kuj'da.du ko~ 'ke~j~ vo'se ko~.paX'Ti.La 'sews 'so~.Jus, aw i~'vEjs Di a'poj.u, vo'se po.de'ra Re.se'ber i~'vE.Za
A vitória demora, mas com muito trabalho, perseverança, tombos, desafios e apoio de pessoas valiosas, ela chega e chega com tudo.	a vi'tO.rja de~'mO.ra, majs ko~ 'mu~j~.tu tra'ba.Lu, peX.se.ve'ra~.sa, 'to~.bus, de.za'fi.uz i a'poj.u Di pe'so.as va.li'O.zas, 'E.la 'Se.ga i 'Se.ga ko~ 'tu.du
Agora me apoio sobre minha janela e me debruço sobre meus erros extravagantes e comuns. Eu me encaro no espelho, eu cresci, e ninguém me perguntou se era isso que eu queria.	a'gO.ra mi a'pOj.u 'so.bri 'mi~.Ja Za~'nE.la i mi de'bru.su 'so.bri 'mewz 'e.Ruz es.tra.va'ga~.Tiz i ko~'mu~s, ew mi e~'ka.ru nu es'pe.Lu, ew kre'si, i ni~'ge~j~ mi peR.gu~'tow si 'E.ra 'i.su ki ew ke'ri.a
A escravidão não consentiu que nos organizássemos e sem povo as instituições não tem apoio, a sociedade não tem alicerce.	a es.kra.vi'da~w~ 'na~w~ ko~.se~'Tiw ki nuz oR.ga~.ni'za.se~.muz i se~j~ 'po.vu az i~s.Ti.tuj'so~j~s 'na~w~ te~j~ a'poj.u, a so.si.e'da.Di 'na~w~ te~j~ a.li'sEX.si
Não conte com o apoio dos famintos em uma disputa judicial. O estômago fala mais alto e eles abrirão a boca para dizer mentiras, mesmo sabendo da verdade.	'na~w~ 'ko~.Ti ko~ u a'poj.u dus fa~'mi~.tuz e~j~ u~.ma Dis'pu.ta Zu.Di.si'aw, u es'to~.ma.gu 'fa.la 'majz 'aw.tu i 'e.liz a.bri'ra~w~ a 'bo.ka 'pa.ra Di'zeR me~'Ti.ras, 'mez.mu sa'be~.du da veR'da.Di
O  estímulo, o apoio, o incentivo, a motivação, o reforço e o investimento são indispensáveis aos trabalhos e aos estudos.	u es'Ti~.mu.lu, u a'poj.u, u i~.se~'Ti.vu, a mo.Ti.va'sa~w~, u Re'foX.su i u i~.ves.Ti~'me~.tu 'sa~w~ i~.Dis.pe~'sa.vejz aws tra'ba.Luz i awz es'tu.dus
Se você quer perdoar, ceder, conceder, eu dou o maior apoio. MAS FAÇA ISSO POR VOCÊ, NÃO PELA OUTRA PESSOA...	si vo'se 'kEX peR.do'aX, se'deX, ko~.se'deX, ew 'dow u maj'Or a'poj.u, majs 'fa.sa 'i.su puR vo'se, 'na~w~ 'pe.la 'ow.tra pe'so.a
O mundo não quer a verdade, quer adulações, apoio ao erro e aplausos ao pecado.	u 'mu~.du 'na~w~ 'kEr a veR'da.Di, 'kEr a.du.la'so~j~s, a'poj.u aw 'e.Ru i a'plaw.zuz aw pe'ka.du
O silêncio de muitos diante de uma crise política demonstra complacência ou apoio por haver similitudes diante do ato imoral político.	u si'le~.sju Di 'mu~j~.tus Di'a~.Ti Di u~.ma 'kri.zi po'li.Ti.ka de~'mo~s.tra ko~.pla'se~.sja ow a'poj.u pur a'veX si~.mi.li'tu.Dis Di'a~.Ti du 'a.tu i~.mo'raw po'li.Ti.ku
A bicicleta da vida não tem rodinhas de apoio, se parar de pedalar, é queda na certa.	a bi.si'klE.ta da 'vi.da 'na~w~ te~j~ RO'Di~.Jas Di a'poj.u, si pa'raR Di pe.da'laX, E 'kE.da na 'sEX.ta
A oposição do homem instruído é melhor que o apoio do tolo.	a o.po.zi'sa~w~ du 'o~.me~j~ i~s.tru'i.du E me'LOX ki u a'poj.u du 'to.lu
Seja o melhor que você possa ser em tudo. Não espere recompensa por isso, espere crescimento pessoal!	'se.Za u me'LOX ki vo'se 'pO.sa 'ser e~j~ 'tu.du, 'na~w~ es'pE.ri Re.ko~'pe~.sa pur 'i.su, es'pE.ri kre.si~'me~.tu pe.so'aw
Sempre haverá amor, sempre haverá o bem, numa via de mão dupla com a força de um trem. Alguém ajuda você e você ajuda alguém.	'se~.pri a.ve'ra a~'moX, 'se~.pri a.ve'ra u 'be~j~, 'nu~.ma 'vi.a Di 'ma~w~ 'du.pla ko~ a 'foX.sa Di u~ 'tre~j~, aw'ge~j~ a'Zu.da vo'se i vo'se a'Zu.da aw'ge~j~
Patriotismo significa apoiar o país. Não significa apoiar o presidente nem nenhum outro funcionário público.	pa.tri.o'Tiz.mu si.gi~.ni'fi.ka a.poj'ar u pa'is, 'na~w~ si.gi~.ni'fi.ka a.poj'ar u pre.zi'de~.Ti ne~j~ ne~'Ju~ 'ow.tru fu~.si.o~'na.rju 'pu.bli.ku
Nunca diga: É bom demais para ser verdade. Se almejamos somente a média, seremos medíocres. Se almejamos a excelência, seremos excelentes!	'nu~.ka 'Di.ga, E 'bo~ de~'majs 'pa.ra 'seR veR'da.Di, si aw.me'Za~.mus sO~'me~.Ti a 'mE.Dja, se're~.mus me'Di.o.kris, si aw.me'Za~.muz a e.se'le~.sja, se're~.muz e.se'le~.Tis
Se você está vivo pode recomeçar. Ninguém tem o direito de te tirar isso	si vo'se es'ta 'vi.vu 'pO.Di Re.ko~.me'saX, ni~'ge~j~ te~j~ u Di'rej.tu Di Ti Ti'rar 'i.su
O sucesso de cada mulher deveria ser uma inspiração para outra mulher. Somos mais fortes quando nos apoiamos.	u su'sE.su Di 'ka.da mu'LER de.ve'ri.a 'ser u~.ma i~s.pi.ra'sa~w~ 'pa.ra 'ow.tra mu'LEX, 'so~.mus 'majs 'fOX.Tis 'kwa~.du nuz a.poj'a~.mus
Quando eu estava passando por um momento difícil, você estava lá. Isto é o que mais importa. Estar lá para os outros quando ninguém mais está.	'kwa~.du ew es'ta.va pa'sa~.du pur u~ mo~'me~.tu Di'fi.siw, vo'se es'ta.va 'la, 'is.tu E u ki 'majz i~'pOX.ta, es'taR 'la 'pa.ra uz 'ow.trus 'kwa~.du ni~'ge~j~ 'majz es'ta
Se por acaso você  não conseguir caminhar, se seus pés enfraquecerem, se a estrada se alongar, Sempre haverá um alguém capaz de lhe carregar.	si pur a'ka.zu vo'se 'na~w~ ko~.se'giX ka~.mi~'JaX, si 'sews 'pEjz e~.fra.ke'se.re~j~, si a es'tra.da si a.lo~'gaX, 'se~.pri a.ve'ra u~ aw'ge~j~ ka'pajz Di Li ka.Re'gaX
De tantas tempestades, uma hora a gente aprende a equilibrar-se na tormenta.	Di 'ta~.tas te~.pes'ta.Dis, u~.ma 'O.ra a 'Ze~.Ti a'pre~.Di a e.ki.li'braX si na toR'me~.ta
O que me faz querido e abençoado  é ter um coração do bem, que cabe gratidão e oferta para o próximo.	u ki mi 'fajs ke'ri.du i a.be~.so'a.du E 'ter u~ ko.ra'sa~w~ du 'be~j~, ki 'ka.bi gra.Ti'da~w~ i o'fEX.ta 'pa.ra u 'prO.si~.mu
Não desconte sua raiva em pessoas inocentes, principalmente nas mais próximas. Elas não têm culpa, e você pode acabar ferindo as pessoas que mais te amam e te apoiam.	'na~w~ des'ko~.Ti 'su.a 'Raj.va e~j~ pe'so.az i~.no'se~.Tis, pri~.si.paw'me~.Ti nas 'majs 'prO.si~.mas, 'E.las 'na~w~ 'te~j~ 'kuw.pa, i vo'se 'pO.Di a.ka'baX fe'ri~.du as pe'so.as ki 'majs Ti 'a~.ma~w~ i Ti a'pOj.a~w~
Amigo verdadeiro é aquele que mesmo nas dificuldades, está ao seu lado.	a~'mi.gu veR.da'dej.ru E a'ke.li ki 'mez.mu nas Di.fi.kuw'da.Dis, es'ta aw 'sew 'la.du
Olhar pra trás e extrair o positivo de cada momento.	o'LaX pra 'trajz i es.tra'ir u po.zi'Ti.vu Di 'ka.da mo~'me~.tu
Meus irmãos e irmãs têm todo o meu amor e apoio. Nós com certeza dividimos muitas experiências ótimas, mas no momento eu não tenho planos de gravar ou fazer uma turnê com eles.	'mewz iR'ma~w~z i iR'ma~j~s 'te~j~ 'to.du u 'mew a~'mor i a'poj.u, 'nOjs ko~ seX'te.za Di.vi'Di~.mus 'mu~j~.taz es.pe.ri'e~.sjaz 'O.Ti~.mas, majs nu mo~'me~.tu ew 'na~w~ 'te~.Ju 'pla~.nus Di gra'var ow fa'zer u~.ma tuR'ne ko~ 'e.lis
Vi sumir meu apoio ao se erguer quem apoiei.	'vi su~'miR 'mew a'poj.u aw si eR'geX 'ke~j~ a.poj'ej
Apoio, biscoito cookie, porque come cookie é bom.	a'poj.u, bis'koj.tu 'ku.ki, puX'ke 'ko~.mi 'ku.ki E 'bo~
Me apóio nos ombros de gigantes, e me espelho em mentes poderosas... .	mi a'pOj.u nuz 'o~.brus Di Zi'ga~.Tis, i mi es'pe.Lu e~j~ 'me~.Tis po.de'rO.zas
Em alguns momentos eu percebi que eu precisava de apoio, incentivo e elogios para conseguir ! Mas eu percebi que alguns momentos era necessário eu cair para subir mas alto.	e~j~ aw'gu~s mo~'me~.tuz ew peX.se'bi ki ew pre.si'za.va Di a'poj.u, i~.se~'Ti.vu i e.lo'Zi.us 'pa.ra ko~.se'giX, majz ew peX.se'bi ki aw'gu~s mo~'me~.tuz 'E.ra ne.se'sa.rju ew ka'iX 'pa.ra su'biR majz 'aw.tu
De perto só sirvo para ser teu apoio moral ou para preencher teu ego, nada mais.	Di 'pEX.tu 'sO 'siR.vu 'pa.ra 'seX 'tew a'poj.u mo'raw ow 'pa.ra pre.e~'SeX 'tew 'E.gu, 'na.da 'majs
Nunca ache que as palavras mais tristes são as mais tristes, pois um dia elas serviram de apoio à você!	'nu~.ka 'a.Si ki as pa'la.vras 'majs 'tris.Tis 'sa~w~ as 'majs 'tris.Tis, 'pojz u~ 'Di.a 'E.las seR'vi.ra~w~ Di a'poj.u a vo'se
Não espere receber apoio maciço de pessoas. Apóie a si mesmo, mas com Divina ajuda para seus problemas humanos!	'na~w~ es'pE.ri Re.se'ber a'poj.u ma'si.su Di pe'so.as, a'pOj.i a 'si 'mez.mu, majs ko~ Di'vi~.na a'Zu.da 'pa.ra 'sews pro'ble~.maz u~'ma~.nus
Meu verdadeiro Amigo é aquele que sabendo que estou errado não me dá nenhum apoio e tenta me corrigir.	'mew veR.da'dej.ru a~'mi.gu E a'ke.li ki sa'be~.du ki es'tow e'Ra.du 'na~w~ mi 'da ne~'Ju~ a'poj.u i 'te~.ta mi ko.Ri'ZiX
Falar francamente com seus pais, de modo humilde, é conseguir deles a compreensão, o apoio e a sabedoria.	fa'laX fra~.ka~'me~.Ti ko~ 'sews 'pajs, Di 'mO.du u~'miw.Di, E ko~.se'giR 'de.liz a ko~.pre.e~'sa~w~, u a'poj.u i a sa.be.do'ri.a
Agradeço minha família pelo apoio e incentivo dedicados em todos os momentos de minha vida, em especial àquele que me fez digno de ser seu filho.	a.gra'de.su 'mi~.Ja fa~'mi.lja 'pe.lu a'poj.u i i~.se~'Ti.vu de.Di'ka.duz e~j~ 'to.duz us mo~'me~.tus Di 'mi~.Ja 'vi.da, e~j~ es.pe.si'aw a'ke.li ki mi 'fejz 'Di.gi~.nu Di 'seX 'sew 'fi.Lu
As marcas em meus joelhos não são de subserviência, e sim de apoio para me levantar!	as 'maX.kaz e~j~ 'mew.Zu'e.Lus 'na~w~ 'sa~w~ Di sub.seR.vi'e~.sja, i 'si~ Di a'poj.u 'pa.ra mi le.va~'taX
Muitos precisam de um apoio de uma palavra amiga somente de um pequeno incentivo num mundo em que quase todos viram as costas	'mu~j~.tus pre'si.za~w~ Di u~ a'poj.u Di u~.ma pa'la.vra a~'mi.ga sO~'me~.Ti Di u~ pe'ke~.nu i~.se~'Ti.vu nu~ 'mu~.du e~j~ ki 'kwa.zi 'to.dus 'vi.ra~w~ as 'kOs.tas
Valorize a verdadeira amizade, pois é ela que lhe dará apoio na necessidade.	va.lo'ri.zi a veR.da'dej.ra a~.mi'za.Di, 'pojz E 'E.la ki Li da'ra a'poj.u na ne.se.si'da.Di
Você me deu apoio  Quando precisei Você me fez sorrir Enquanto chorei Você me fez insistir Quando fracassei Você me fez esquecer De tudo que passei E é por isso que Eu sempre te amarei	vo'se mi 'dew a'poj.u 'kwa~.du pre.si'zej vo'se mi 'fejs so'Rir e~'kwa~.tu So'rej vo'se mi 'fejz i~.sis'TiX 'kwa~.du fra.ka'sej vo'se mi 'fejz es.ke'seR Di 'tu.du ki pa'sej i E pur 'i.su ki ew 'se~.pri Ti a~.ma'rej
Busca o apoio de quem mais te ama, nos momentos em que a dor reclama.	'bus.ka u a'poj.u Di 'ke~j~ 'majs Ti 'a~.ma, nus mo~'me~.tuz e~j~ ki a 'do.Re'kla~.ma
Não use os obstáculos da vida como motivo de desistência, e sim como apoio para o sucesso.	'na~w~ 'u.zi uz obs'ta.ku.lus da 'vi.da 'ko~.mu mo'Ti.vu Di de.zis'te~.sja, i 'si~ 'ko~.mu a'poj.u 'pa.ra u su'sE.su
Eu detesto dramas fúteis! Eu gosto mesmo é de futilidades felizes e apoio demais os dramas úteis.	ew de'tEs.tu 'dra~.mas 'fu.tejs, ew 'gOs.tu 'mez.mu E Di fu.Ti.li'da.Dis fe'li.ziz i a'pOj.u de~'majz us 'dra~.maz 'u.tejs
Uma palavra de apoio, um sorriso e um afago são mais eficientes que quaisquer lições.	u~.ma pa'la.vra Di a'poj.u, u~ so'Ri.zu i u~ a'fa.gu 'sa~w~ 'majz e.fi.si'e~.Tis ki kwajs'kER li'so~j~s
Apoio todos os seus direitos desde que não interfiram nos meus.	a'pOj.u 'to.duz us 'sews Di'rej.tus 'dez.Di ki 'na~w~ i~.teX'fi.ra~w~ nus 'mews
Quando a pessoa que amamos nos oferece alicerce e apoio para sustentação de nossa relação, fica mais fácil aprendermos a amá-la, pois estamos sendo amado e querido pelo nosso amor.	'kwa~.du a pe'so.a ki a~'ma~.mus nuz o.fe'rE.si a.li'sEX.si i a'poj.u 'pa.ra sus.te~.ta'sa~w~ Di 'nO.sa Re.la'sa~w~, 'fi.ka 'majs 'fa.siw a.pre~'deR.muz a a~'ma la, 'pojz es'ta~.mus 'se~.du a~'ma.du i ke'ri.du 'pe.lu 'nO.su a~'moX
Nos momentos de crise, evite fazer críticas e reforce o seu apoio.	nus mo~'me~.tus Di 'kri.zi, e'vi.Ti fa'zeX 'kri.Ti.kaz i Re'fOX.si u 'sew a'poj.u
Entendo os  teus motivos Mas Não apoio  as tuas atitudes. Entre entender  e apoiar tem grande  diferença!	e~'te~.du us 'tews mo'Ti.vus majs 'na~w~ a'pOj.u as 'tu.az a.Ti'tu.Dis, 'e~.tri e~.te~'der i a.poj'aX te~j~ 'gra~.Di Di.fe're~.sa
A co-dependência é inadequada, uma dose exagerada de lealdade, carinho e apoio.	a ko.de.pe~'de~.sja E i~.na.de'kwa.da, u~.ma 'dO.zi e.za.Ze'ra.da Di le.aw'da.Di, ka'ri~.Ju i a'poj.u
Escolho falar. Escolho defender os outros. Escolho aceitar o apoio de pessoas do mundo todo.	es'ko.Lu fa'laX, es'ko.Lu de.fe~'der uz 'ow.trus, es'ko.Lu a.sej'tar u a'poj.u Di pe'so.as du 'mu~.du 'to.du
A Amizade é um pacto velado de Trocas. Apoio, Compreensão, Bem Estar, Bom  Ambiente e Bons Momentos.	a a~.mi'za.Di E u~ 'pak.tu ve'la.du Di 'trO.kas, a'poj.u, ko~.pre.e~'sa~w~, 'be~j~ es'taX, 'bo~ a~.bi'e~.Ti i 'bo~s mo~'me~.tus
Amigo de verdade é aquele que te ouve e te dá apoio, mesmo quando você pisa na bola.	a~'mi.gu Di veR'da.Di E a'ke.li ki Ti 'ow.vi i Ti 'da a'poj.u, 'mez.mu 'kwa~.du vo'se 'pi.za na 'bO.la
O líder egoísta é rapidamente destronado e  proscrito, pois não há liderança sem o apoio dos liderados.	u 'li.der e.go'is.ta E Ra.pi.da~'me~.Ti des.tro~'na.du i pros'kri.tu, 'pojs 'na~w~ 'a li.de'ra~.sa se~j~ u a'poj.u dus li.de'ra.dus
Não espere o apoio de ninguém se você resolveu ser diferente.	'na~w~ es'pE.ri u a'poj.u Di ni~'ge~j~ si vo'se Re.zow'vew 'seR Di.fe're~.Ti
Com apoio ou sem apoio, lute por seus objetivos e não desista por nada.	ko~ a'poj.u ow se~j~ a'poj.u, 'lu.Ti puX 'sewz ob.Ze'Ti.vuz i 'na~w~ de'zis.ta puR 'na.da
Toda palavra serve para demonstrar todos os sentimentos do mundo, apenas uma serve de apoio para que você tenha os sentimentos : JESUS.	'to.da pa'la.vra 'sER.vi 'pa.ra de~.mo~s'traX 'to.duz us se~.Ti~'me~.tus du 'mu~.du, a'pe~.naz u~.ma 'sER.vi Di a'poj.u 'pa.ra ki vo'se 'te~.Ja us se~.Ti~'me~.tus, Ze'zujs
O apoio de quem menos podemos prescindir é o do nosso próprio esforço.	u a'poj.u Di 'ke~j~ 'me~.nus po'de~.mus pre.si~'Dir E u du 'nO.su 'prO.prju es'foX.su
Apoio, padaria do chu, se você quiser pão vá no chu padeiro.	a'poj.u, pa.da'ri.a du 'Su, si vo'se ki'zEX 'pa~w~ 'va nu 'Su pa'dej.ru
Apoio, papel higienico quero-quero, cada passada é um berro.	a'pOj.u, pa'pEw i.Zi.e~'ni.ku 'kE.ru 'kE.ru, 'ka.da pa'sa.da E u~ 'bE.Ru
Me ajude a ver onde errei, não sou autossuficiente, preciso, sim, de apoio, me ajude a traçar um caminho melhor.	mi a'Zu.Di a 'ver 'o~.Di e'Rej, 'na~w~ 'sow aw.tu.su.fi.si'e~.Ti, pre'si.zu, 'si~, Di a'poj.u, mi a'Zu.Di a tra'sar u~ ka~'mi~.Ju me'LOX
Ganhou apoio dos menos informados, Por ser menos todavia era a grande maioria, O tempo passa e o bolso dele vai enchendo, E ele assim vai esquecendo do povo A quem estendeu a mão.	ga~'Jow a'poj.u dus 'me~.nuz i~.foR'ma.dus, puX 'seR 'me~.nus to.da'vi.a 'E.ra a 'gra~.Di maj.o'ri.a, u 'te~.pu 'pa.sa i u 'bow.su 'de.li 'vaj e~'Se~.du, i 'e.li a'si~ 'vaj es.ke'se~.du du 'po.vu a 'ke~j~ es.te~'dew a 'ma~w~
A congregação deveria ser o lugar de repouso (apoio) para os cansados, onde encontrar amigos, irmãos, e conselhos. Mas tem sido motivo de fuga dos fracos...	a ko~.gre.ga'sa~w~ de.ve'ri.a 'ser u lu'gaR Di Re'pow.zu, a'poj.u, 'pa.ra us ka~'sa.dus, 'o~.Di e~.ko~'trar a~'mi.gus, iR'ma~w~s, i ko~'se.Lus, majs te~j~ 'si.du mo'Ti.vu Di 'fu.ga dus 'fra.kus
Eu queria estar ao seu lado  todos dias da sua vida. Pra que nos dias ruins eu seja seu apoio. E nos de felicidade ser o motivo dela.	ew ke'ri.a es'tar aw 'sew 'la.du 'to.dus 'Di.as da 'su.a 'vi.da, pra ki nus 'Di.as Ru'i~z ew 'se.Za 'sew a'poj.u, i nus Di fe.li.si'da.Di 'ser u mo'Ti.vu 'dE.la
Palavras de apoio e de carinho, não ditas na hora de um sofrimento ferem tanto quanto as mal ditas.	pa'la.vras Di a'poj.u i Di ka'ri~.Ju, 'na~w~ 'Di.tas na 'O.ra Di u~ so.fri~'me~.tu 'fE.re~j~ 'ta~.tu 'kwa~.tu as 'maw 'Di.tas
Quando menos se espera, aparece uma mão do lugar mais inusitado para te dar apoio.	'kwa~.du 'me~.nus si es'pE.ra, a.pa'rE.si u~.ma 'ma~w~ du lu'gaR 'majz i~.nu.zi'ta.du 'pa.ra Ti 'dar a'poj.u
Pode ser três letras para humilhar um ser que precisa de um simples apoio.	'pO.Di 'seX 'trejs 'le.tras 'pa.ra u~.mi'Lar u~ 'seX ki pre'si.za Di u~ 'si~.pliz a'poj.u
Ouço todas as opiniões, depois contesto em primeiro lugar as que apoio e concordo, afinal, quem procura ter resultados excelentes, precisa por a prova até mesmo as suas próprias convicções!	'ow.su 'to.daz az o.pi~.ni'o~j~s, de'pojs ko~'tEs.tu e~j~ pri~'mej.ru lu'gar as ki a'pOj.u i ko~'kOR.du, a.fi~'naw, 'ke~j~ pro'ku.ra 'te.Re.zuw'ta.duz e.se'le~.Tis, pre'si.za 'por a 'prO.va a'tE 'mez.mu as 'su.as 'prO.prjas ko~.vik'so~j~s
Não se engane achando que uma pessoa que sempre se mostra forte jamais vai precisar de seu apoio. Ela pode apenas ser do tipo que, mesmo nos momentos mais críticos, não sai gritando por socorro.	'na~w~ si e~'ga~.ni a'Sa~.du ki u~.ma pe'so.a ki 'se~.pri si 'mOs.tra 'fOX.Ti Za~'majs 'vaj pre.si'zaR Di 'sew a'poj.u, 'E.la 'pO.Di a'pe~.nas 'seR du 'Ti.pu ki, 'mez.mu nus mo~'me~.tus 'majs 'kri.Ti.kus, 'na~w~ 'saj gri'ta~.du puX so'ko.Ru
pior coisa dentro de uma crise é não ter o apoio de quem imaginávamos	pi'OX 'koj.za 'de~.tru Di u~.ma 'kri.zi E 'na~w~ 'ter u a'poj.u Di 'ke~j~ i~.ma.Zi~'na.va~.mus
Talentos são desperdiçados na juventude por falta de apoio ou conhecimento de gente profissional que não conseguem cooperar ou orientar o futuro brilhante deles.	ta'le~.tus 'sa~w~ des.peR.Di'sa.dus na Zu.ve~'tu.Di puX 'faw.ta Di a'poj.u ow ko~.Je.si~'me~.tu Di 'Ze~.Ti pro.fi.si.o~'naw ki 'na~w~ ko~'sE.ge~j~ ko.o.pe'rar ow o.ri.e~'tar u fu'tu.ru bri'La~.Ti 'de.lis
De nada adianta se tornar mestres nos púlpitos, se no mesmo piso seus irmãos carecem de apoio, compreensão e amor recíprocos.	Di 'na.da a.Di'a~.ta si toR'naR 'mEs.tris nus 'puw.pi.tus, si nu 'mez.mu 'pi.zu 'sewz iR'ma~w~s ka'rE.se~j~ Di a'poj.u, ko~.pre.e~'sa~w~ i a~'mo.Re'si.pro.kus
O papel dos pais e da sociedade não é dizer às crianças o que elas devem se tornar, mas dar apoio para que elas descubram quem realmente são.	u pa'pEw dus 'pajz i da so.si.e'da.Di 'na~w~ E Di'zer as kri'a~.saz u ki 'E.las 'dE.ve~j~ si toR'naX, majs 'dar a'poj.u 'pa.ra ki 'E.las des'ku.bra~w~ 'ke~j~ Re.aw'me~.Ti 'sa~w~
Eles nos ensinaram a dar os primeiros passos. E estarão sempre nos dando apoio pra que cheguemos cada vez mais longe. Dia dos Pais	'e.lis nuz e~.si~'na.ra~w~ a 'dar us pri~'mej.rus 'pa.sus, i es.ta'ra~w~ 'se~.pri nus 'da~.du a'poj.u pra ki Se'ge~.mus 'ka.da 'vejz 'majs 'lo~.Zi, 'Di.a dus 'pajs
Amizades não se resumem a catar mulher, mas no apoio mútuo sem cobranças.	a~.mi'za.Dis 'na~w~ si Re'zu~.me~j~ a ka'taR mu'LEX, majs nu a'poj.u 'mu.twu se~j~ ko'bra~.sas
O apoio à cultura começa em casa, quando incluímos em nossa lista de compras, a aquisição de um bom livro.	u a'poj.u a kuw'tu.ra ko~'mE.sa e~j~ 'ka.za, 'kwa~.du i~.klu'i~.muz e~j~ 'nO.sa 'lis.ta Di 'ko~.pras, a a.ki.zi'sa~w~ Di u~ 'bo~ 'li.vru
O que faria um narrador se às vezes não encontrasse um pouco de apoio no silêncio?	u ki fa'ri.a u~ na.Ra'doX si as 've.zis 'na~w~ e~.ko~'tra.si u~ 'pow.ku Di a'poj.u nu si'le~.sju
Não dependa de ninguém, mas não deixe de fazer alguém seu apoio.	'na~w~ de'pe~.da Di ni~'ge~j~, majs 'na~w~ 'dej.Si Di fa'zer aw'ge~j~ 'sew a'poj.u
Sem oposição o comodismo é geral e não há apoio de execução ou implementação por parte de ninguém, apenas conformismo e cobranças generalizadas.	se~j~ o.po.zi'sa~w~ u ko~.mo'Diz.mu E Ze'raw i 'na~w~ 'a a'poj.u Di e.ze.ku'sa~w~ ow i~.ple~.me~.ta'sa~w~ puX 'paX.Ti Di ni~'ge~j~, a'pe~.nas ko~.foR'miz.mu i ko'bra~.sa.Ze~.ne.ra.li'za.das
Eu seguro na zaga e vocês soltam o grito na torcida! O apoio de vocês vai ser muito importante daqui pra frente!	ew se'gu.ru na 'za.ga i vo'sejs 'sOw.ta~w~ u 'gri.tu na toX'si.da, u a'poj.u Di vo'sejs 'vaj 'seR 'mu~j~.tu i~.poX'ta~.Ti da'ki pra 'fre~.Ti
Com tanto apoio, alguém duvida que o futuro tende a ser generoso com quem merece.	ko~ 'ta~.tu a'poj.u, aw'ge~j~ du'vi.da ki u fu'tu.ru 'te~.Di a 'seR Ze~.ne'ro.zu ko~ 'ke~j~ me'rE.si
Na motivação, é como ter o apoio de seu melhor amigo. Então valorize, porque amigos é importante um dia, e sempre	na mo.Ti.va'sa~w~, E 'ko~.mu 'ter u a'poj.u Di 'sew me'LOr a~'mi.gu, e~'ta~w~ va.lo'ri.zi, puX'ke a~'mi.guz E i~.poX'ta~.Ti u~ 'Di.a, i 'se~.pri
O apoio judiciário divide-se em três grandes áreas: informação jurídica, consulta jurídica e patrocínio judiciário	u a'poj.u Zu.Di.si'a.rju Di'vi.Di si e~j~ 'trejs 'gra~.Diz 'a.rjas, i~.foR.ma'sa~w~ Zu'ri.Di.ka, ko~'suw.ta Zu'ri.Di.ka i pa.tro'si~.nju Zu.Di.si'a.rju
A falta de apoio, de algum modo, faz com que nos tornemos mais fortes	a 'faw.ta Di a'poj.u, Di aw'gu~ 'mO.du, 'fajs ko~ ki nus toR'ne~.mus 'majs 'fOX.Tis
Me deixa cair Estende a mão e me levanta Carinhosamente me empurra  Não caio, me apoio Me segura, mas me solta  Poderia ser um tango argentino Mas era você maltratando meu coração!	mi 'dej.Sa ka'ir es'te~.Di a 'ma~w~ i mi le'va~.ta ka.ri~.JO.za~'me~.Ti mi e~'pu.Ra 'na~w~ 'kaj.u, mi a'pOj.u mi se'gu.ra, majs mi 'sOw.ta po.de'ri.a 'ser u~ 'ta~.gu aR.Ze~'Ti~.nu majz 'E.ra vo'se maw.tra'ta~.du 'mew ko.ra'sa~w~
Então eu acho que nós dois somos ex-seres sobrenaturais. Devemos começar um grupo de apoio?	e~'ta~w~ ew 'a.Su ki 'nOjs 'dojs 'so~.muz 'ejs 'se.ris so.bre~.na.tu'rajs, de've~.mus ko~.me'sar u~ 'gru.pu Di a'poj.u
Ódio, racismo, intolerância, partidarismo cego, apoio a torturadores ladrão julgando ladrão estamos involuindo, quando vamos evoluir?	'O.Dju, Ra'siz.mu, i~.to.le'ra~.sja, paX.Ti.da'riz.mu 'sE.gu, a'poj.u a toX.tu.ra'do.ris la'dra~w~ Zuw'ga~.du la'dra~w~ es'ta~.muz i~.vo.lu'i~.du, 'kwa~.du 'va~.muz e.vo.lu'iX
Quando Deus não está no negócio pouco importa o apoio da parte do homem. Não confie na força do seu braço.	'kwa~.du 'dews 'na~w~ es'ta nu ne'gO.sju 'pow.ku i~'pOX.ta u a'poj.u da 'paX.Ti du 'o~.me~j~, 'na~w~ ko~'fi.i na 'foX.sa du 'sew 'bra.su
Testemunho diariamente uma aguerrida batalha cerebral. Nem sempre sai vencedor mas apoio insistentemente o lado direito.	tes.te~'mu~.Ju Di.a.ri.a~'me~.Ti u~.ma a.ge'Ri.da ba'ta.La se.re'braw, ne~j~ 'se~.pri 'saj ve~.se'doR majz a'pOj.u i~.sis.te~.Ti~'me~.Ti u 'la.du Di'rej.tu
Podemos afirmar, sem receio de ferir a verdade, que a força do casamento existe unicamente no apoio dos costumes.	po'de~.muz a.fiR'maX, se~j~ Re'sej.u Di fe'rir a veR'da.Di, ki a 'foX.sa du ka.za~'me~.tu e'zis.Ti u~.ni.ka~'me~.Ti nu a'poj.u dus kos'tu~.mis
Aceite o meu carinho, a minha amizade, atenção e todo apoio possível, mas não exija de mim o que eu não posso te dar.	a'sej.Ti u 'mew ka'ri~.Ju, a 'mi~.Ja a~.mi'za.Di, a.te~'sa~w~ i 'to.du a'poj.u po'si.vew, majs 'na~w~ e'zi.Za Di 'mi~ u ki ew 'na~w~ 'pO.su Ti 'daX
Esses lapsos de memória já se tornaram amigos, nos momentos de discórdia apoio-me tal e coisa e coisa e tal, por fim nas angústias nada mal...	'e.sis 'lap.sus Di me~'mO.rja 'Za si toR'na.ra~w~ a~'mi.gus, nus mo~'me~.tus Di Dis'kOR.Dja a'pOj.u mi 'taw i 'koj.za i 'koj.za i 'taw, puX 'fi~ naz a~'gus.Tjas 'na.da 'maw
Amor é isso: é segurança, é apoio, é solo, é firmeza e é ponte quando o abismo permanece aberto.	a~'mor E 'i.su, E se.gu'ra~.sa, E a'poj.u, E 'sO.lu, E fiR'me.za i E 'po~.Ti 'kwa~.du u a'biz.mu peR.ma~'nE.si a'bEX.tu
Interesse, cuidado e apoio são premissas do verdadeiro amar.	i~.te're.si, kuj'da.du i a'poj.u 'sa~w~ pre~'mi.sas du veR.da'dej.ru a~'maX
Me dê uma alavanca e um ponto de apoio no universo, que eu transportarei a Terra	mi 'de u~.ma a.la'va~.ka i u~ 'po~.tu Di a'poj.u nu u~.ni'vEX.su, ki ew tra~s.poX.ta'rej a 'tE.Ra
A arrogância é o apoio dos amedrontados.	a a.Ro'ga~.sja E u a'poj.u duz a~.me.dro~'ta.dus
Seja chão para quem não o tem. Não para que o pisem, mas para que tu sejas o apoio para um novo levantar.	'se.Za 'Sa~w~ 'pa.ra 'ke~j~ 'na~w~ u te~j~, 'na~w~ 'pa.ra ki u 'pi.ze~j~, majs 'pa.ra ki 'tu 'se.Zaz u a'poj.u 'pa.ra u~ 'no.vu le.va~'taX
Jamais me esquece rei do apoio dos amigos e jamais me esquecerei das punhaladas dos inimigos!	Za~'majs mi es'kE.se 'Rej du a'poj.u. duz a~'mi.guz i Za~'majs mi es.ke.se'rej das pu~.Ja'la.das duz i~.ni~'mi.gus
Troque a sua tentação pelo apoio ou comboio da orações.	'trO.ki a 'su.a te~.ta'sa~w~ 'pe.lu a'poj.u ow ko~'boj.u da o.ra'so~j~s
O teu olhar puro e manso me dão apoio e descanso, me encaminhando a te conquistar	u 'tew o'LaX 'pu.ru i 'ma~.su mi 'da~w~ a'poj.u i des'ka~.su, mi e~.ka~.mi~'Ja~.du a Ti ko~.kis'taX
O fundamento da justiça não é a o de pedir apoio público, mas o de dar apoio a população.	u fu~.da~'me~.tu da Zus'Ti.sa 'na~w~ E a u Di pe'Dir a'poj.u 'pu.bli.ku, majz u Di 'dar a'poj.u a po.pu.la'sa~w~
Assim como as estrelas necessitam do sol para brilhar, as pessoas precisam do apoio e carinho uma das outras para evoluir e brilhar juntas.	a'si~ 'ko~.mu az es'tre.las ne.se'si.ta~w~ du 'sOw 'pa.ra bri'LaX, as pe'so.as pre'si.za~w~ du a'poj.u i ka'ri~.Ju u~.ma daz 'ow.tras 'pa.ra e.vo.lu'ir i bri'LaR 'Zu~.tas
Que nunca nos falte: vontade de fazer diferente, força para recomeçar, apoio para nossas decisões, motivos para seguir em frente.	ki 'nu~.ka nus 'faw.Ti, vo~'ta.Di Di fa'zeR Di.fe're~.Ti, 'foX.sa 'pa.ra Re.ko~.me'saX, a'poj.u 'pa.ra 'nO.sas de.si'zo~j~s, mo'Ti.vus 'pa.ra se'gir e~j~ 'fre~.Ti
Um mundo com mais amor, eu apoio.	u~ 'mu~.du ko~ 'majz a~'moX, ew a'pOj.u
Eu, muitas e muitas vezes, não ficaria de pé se não fosse o apoio dos amigos.	ew, 'mu~j~.taz i 'mu~j~.tas 've.zis, 'na~w~ fi.ka'ri.a Di 'pE si 'na~w~ 'fo.si u a'poj.u duz a~'mi.gus
Ter uma mente aberta aos interesses de um grupo social é a melhor meta para se conquistar apoio e simpatia do mesmo.	'ter u~.ma 'me~.Ti a'bEX.ta awz i~.te're.sis Di u~ 'gru.pu so.si'aw E a me'LOR 'mE.ta 'pa.ra si ko~.kis'tar a'poj.u i si~.pa'Ti.a du 'mez.mu
Fica mais fácil quando tem alguém do seu lado te dando forças, te dando apoio, te motivando prosseguir.	'fi.ka 'majs 'fa.siw 'kwa~.du te~j~ aw'ge~j~ du 'sew 'la.du Ti 'da~.du 'foX.sas, Ti 'da~.du a'poj.u, Ti mo.Ti'va~.du pro.se'giX
Tem horas que você só precisa de uma palavra de apoio, um ombro pra desabafar.	te~j~ 'O.ras ki vo'se 'sO pre'si.za Di u~.ma pa'la.vra Di a'poj.u, u~ 'o~.bru pra de.za.ba'faX
Reconheçam!   Desconheço um só Homem vencedor! Sem ter da sua Mulher apoio e Amor!	Re.ko~'Je.sa~w~, des.ko~'Je.su 'u~ 'sO 'o~.me~j~ ve~.se'doX, se~j~ 'teR da 'su.a mu'LEr a'poj.u i a~'moX
Dependendo do amigo, fico do lado que me apoio melhor a perna, para poder me defender com os braços!	de.pe~'de~.du du a~'mi.gu, 'fi.ku du 'la.du ki mi a'pOj.u me'LOr a 'pER.na, 'pa.ra po'deR mi de.fe~'deX ko~ us 'bra.sus
Na escalada até a rosa, use os espinhos como apoio.	na es.ka'la.da a'tE a 'RO.za, 'u.zi uz es'pi~.Jus 'ko~.mu a'poj.u
Ser da alegria é o apoio da misericórdia eterna.	'seR da a.le'gri.a E u a'poj.u da mi.ze.ri'kOR.Dja e'tER.na
Mãe não queria um abraço seu, na verdade queria mesmo era seu apoio, pelo menos uma vez escutar: Eu te apoiarei no que for preciso.	'ma~j~ 'na~w~ ke'ri.a u~ a'bra.su 'sew, na veR'da.Di ke'ri.a 'mez.mu 'E.ra 'sew a'poj.u, 'pe.lu 'me~.nuz u~.ma 'vejz es.ku'taX, ew Ti a.poj.a'rej nu ki 'foX pre'si.zu
Minha revolução silenciosa não precisa de líderes ou apoio de quem quer que seja. somente eu e minha consciência	'mi~.Ja Re.vo.lu'sa~w~ si.le~.si'O.za 'na~w~ pre'si.za Di 'li.de.riz ow a'poj.u Di 'ke~j~ 'kEX ki 'se.Za, sO~'me~.Ti ew i 'mi~.Ja ko~.si'e~.sja
Há momentos na vida, em que o que mais precisamos é apenas um abraço, ou qualquer palavra de apoio.	'a mo~'me~.tus na 'vi.da, e~j~ ki u ki 'majs pre.si'za~.muz E a'pe~.naz u~ a'bra.su, ow kwaw'kEX pa'la.vra Di a'poj.u
O amor verdadeiro é aquele que nada promete, e consegue vencer com apoio mutuo das duas partes.	u a~'moR veR.da'dej.ru E a'ke.li ki 'na.da pro~'mE.Ti, i ko~'sE.gi ve~'seX ko~ a'poj.u 'mu.twu das 'du.as 'paX.Tis
As vezes o apoio e conforto que você precisa vem de onde você menos espera.	as 've.ziz u a'poj.u i ko~'foX.tu ki vo'se pre'si.za 've~j~ Di 'o~.Di vo'se 'me~.nuz es'pE.ra
Eu apoio as religiões , crenças e costumes ! Mas eu pessoalmente Somente Creio em Deus e minha vida dei a ele !	ew a'pOj.u as Re.li.Zi'o~j~s, 'kre~.saz i kos'tu~.mis, majz ew pe.so.aw'me~.Ti sO~'me~.Ti 'krej.u e~j~ 'dewz i 'mi~.Ja 'vi.da 'dej a 'e.li
Sonhe grande! Sonho pequeno não merece apoio.	'so~.Ji 'gra~.Di, 'so~.Ju pe'ke~.nu 'na~w~ me'rE.si a'poj.u
Existe dois modos de ser forte: Ser julgado por pessoas ignorantes; Ou ter apoio de pessoas inteligentes;	e'zis.Ti 'dojs 'mO.dus Di 'seX 'fOX.Ti, 'seR Zuw'ga.du puX pe'so.az i.gi~.no'ra~.Tis, ow 'ter a'poj.u Di pe'so.az i~.te.li'Ze~.Tis
Buscar o sucesso, é sempre algo almejado, mas sem planejamento, e sem o  apoio dos amigos, nunca venceremos.	bus'kar u su'sE.su, E 'se~.pri 'aw.gu aw.me'Za.du, majs se~j~ pla~.ne.Za~'me~.tu, i se~j~ u a'poj.u duz a~'mi.gus, 'nu~.ka ve~.se're~.mus
A justiça é o apoio do mundo: a injustiça, pelo contrário, a origem e fonte de todas as calamidades que o afligem.	a Zus'Ti.sa E u a'poj.u du 'mu~.du, a i~.Zus'Ti.sa, 'pe.lu ko~'tra.rju, a o'ri.Ze~j~ i 'fo~.Ti Di 'to.daz as ka.la~.mi'da.Dis ki u a'fli.Ze~j~
De um necessitado eu passei a ser necessário, de necessário pedi apoio a um missionário porque pensei que nada iria além na minha vida, sem ter feito primeiro este cenário.	Di u~ ne.se.si'ta.du ew pa'sej a 'seR ne.se'sa.rju, Di ne.se'sa.rju pe'Di a'poj.u a u~ mi.si.o~'na.rju puX'ke pe~'sej ki 'na.da i'ri.a a'le~j~ na 'mi~.Ja 'vi.da, se~j~ 'teX 'fej.tu pri~'mej.ru 'es.Ti se~'na.rju
Não quero apoio moral, quero apoio financeiro !	'na~w~ 'kE.ru a'poj.u mo'raw, 'kE.ru a'poj.u fi~.na~'sej.ru
Niguém sobe na vida sem apoio.	ni'ge~j~ 'sO.bi na 'vi.da se~j~ a'poj.u
Algums fazem ideias. Eu as critico. Quando não, as apoio...	'aw.gu~s 'fa.ze~j~ i'dEj.as, ew as kri'Ti.ku, 'kwa~.du 'na~w~, az a'pOj.u
Não use as pessoas como apoio, um dias elas vão embora e você cai!	'na~w~ 'u.zi as pe'so.as 'ko~.mu a'poj.u, u~ 'Di.az 'E.las 'va~w~ e~'bO.ra i vo'se 'kaj
Espere respeito e não apoio.	es'pE.ri Res'pej.tu i 'na~w~ a'poj.u
Faça sempre o bem e acumule riqueza de apoio durante toda vida.	'fa.sa 'se~.pri u 'be~j~ i a.ku~'mu.li Ri'ke.za Di a'poj.u du'ra~.Ti 'to.da 'vi.da
É bom saber que tenho o apoio de crianças meso sabendo que os mais velhos me atoleimam.	E 'bo~ sa'beX ki 'te~.Ju u a'poj.u Di kri'a~.sas 'me.zu sa'be~.du ki us 'majs 'vE.Lus mi a.to'lej.ma~w~
