Devo acreditar que Deus é uma negra gorda com um senso de humor questionável?	'de.vu a.kre.Di'taX ki 'dewz E u~.ma 'ne.gra 'goR.da ko~ u~ 'se~.su Di u~'moX kes.Ti.o~'na.vew
Jesus riu.	Ze'zujs 'Riw
Ela é uma piada! Adora surpresas e tem uma noção de tempo sempre perfeita.	'E.la E u~.ma pi'a.da, a'dO.ra suX'pre.zaz i te~j~ u~.ma no'sa~w~ Di 'te~.pu 'se~.pri peX'fej.ta
Verdade? disse Mack, ainda balançando a cabeça e sem saber se realmente acreditava.	veR'da.Di, 'Di.si 'mE.ki, a'i~.da ba.la~'sa~.du a ka'be.sa i se~j~ sa'beX si Re.aw'me~.Ti a.kre.Di'ta.va
Então o que devo fazer agora?	e~'ta~w~ u ki 'de.vu fa'zer a'gO.ra
Você não deve fazer nada.	vo'se 'na~w~ 'dE.vi fa'zeR 'na.da
Está livre para o que quiser.	es'ta 'li.vri 'pa.ra u ki ki'zEX
Jesus fez uma pausa e continuou, dando algumas sugestões: Estou trabalhando num projeto em madeira no barracão e Sarayu está no jardim.	Ze'zujs 'fejz u~.ma 'paw.za i ko~.Ti~.nu'ow, 'da~.du aw'gu~.mas su.Zes'to~j~s, es'tow tra.ba'La~.du nu~ pro'ZE.tu e~j~ ma'dej.ra nu ba.Ra'ka~w~ i sa.ra'ju es'ta nu ZaR'Di~
Você pode ir pescar, passear de canoa ou entrar e conversar com Papai.	vo'se 'pO.Di 'iX pes'kaX, pa.se'aR Di ka~'no.a ow e~'trar i ko~.veX'saX ko~ pa'paj
Ah! Agora Jesus estava sério.	'a, a'gO.ra Ze'zujz es'ta.va 'sE.rju
Não se sinta obrigado.	'na~w~ si 'si~.ta o.bri'ga.du
Vá se for isso o que você quer fazer.	'va si 'for 'i.su u ki vo'se 'kEX fa'zeX
Mack pensou um momento e decidiu que entrar no chalé era o que realmente desejava.	'mE.ki pe~'sow u~ mo~'me~.tu i de.si'Diw ki e~'traR nu Sa'lE 'E.ra u ki Re.aw'me~.Ti de.ze'Za.va
Agradeceu a Jesus, que, sorrindo, foi para a sua oficina.	a.gra.de'sew a Ze'zujs, ki, so'Ri~.du, 'foj 'pa.ra a 'su.a o.fi'si~.na
Mack atravessou a varanda e chegou à porta.	'mE.ki a.tra.ve'sow a va'ra~.da i Se'gow a 'pOX.ta
Depois de olhar rapidamente em volta, abriu-a.	de'pojs Di o'La.Ra.pi.da~'me~.Ti e~j~ 'vOw.ta, a'briw a
Enfiou a cabeça para dentro, hesitou e decidiu mergulhar.	e~.fi'ow a ka'be.sa 'pa.ra 'de~.tru, e.zi'tow i de.si'Diw meR.gu'LaX
Deus? chamou timidamente, sentindo-se bastante idiota.	'dews, Sa~'mow Ti~.mi.da~'me~.Ti, se~'Ti~.du si bas'ta~.Ti i.Di'O.ta
Estou na cozinha, Mackenzie. Basta seguir minha voz.	es'tow na ko'zi~.Ja, ma'ke~.zi, 'bas.ta se'giR 'mi~.Ja 'vOjs
Ele entrou e examinou a sala.	'e.li e~'trow i e.za~.mi~'now a 'sa.la
Será que este era o mesmo lugar?	se'ra ki 'es.Ti 'E.ra u 'mez.mu lu'gaX
Estremeceu diante do sussurro dos pensamentos sombrios à espreita e trancou-os de novo.	es.tre~.me'sew Di'a~.Ti du su'su.Ru dus pe~.sa~'me~.tus so~'bri.uz a es'prej.ta i tra~'kow us Di 'no.vu
Olhou para a sala de estar procurando o local perto da lareira, mas não encontrou nenhuma mancha.	o'Low 'pa.ra a 'sa.la Di es'taX pro.ku'ra~.du u lo'kaw 'pEX.tu da la'rej.ra, majs 'na~w~ e~.ko~'trow ne~'Ju~.ma 'ma~.Sa
Notou que a sala era decorada com figuras que pareciam ter sido desenhadas ou feitas por crianças.	no'tow ki a 'sa.la 'E.ra de.ko'ra.da ko~ fi'gu.ras ki pa.re'si.a~w~ 'teX 'si.du de.ze~'Ja.daz ow 'fej.tas puX kri'a~.sas
Imaginou se aquela mulher guardava com carinho cada uma daquelas peças, como qualquer pai ou mãe que ama os filhos.	i~.ma.Zi~'now si a'kE.la mu'LER gwaR'da.va ko~ ka'ri~.Ju 'ka.da u~.ma da'kE.las 'pE.sas, 'ko~.mu kwaw'kEX 'paj ow 'ma~j~ ki 'a~.ma us 'fi.Lus
Talvez fosse assim que ela valorizava as coisas que lhe eram dadas de coração, como as crianças em geral fazem.	taw'vejs 'fo.si a'si~ ki 'E.la va.lo.ri'za.va as 'koj.zas ki Li 'E.ra~w~ 'da.das Di ko.ra'sa~w~, 'ko~.mu as kri'a~.saz e~j~ Ze'raw 'fa.ze~j~
Mack foi em direção ao cantarolar baixo e chegou a uma copa-cozinha onde havia uma mesa com quatro lugares e cadeiras de encosto de vime.	'mE.ki 'foj e~j~ Di.re'sa~w~ aw ka~.ta.ro'laR 'baj.Su i Se'gow a u~.ma 'kO.pa ko'zi~.Ja 'o~.Di a'vi.a u~.ma 'me.za ko~ 'kwa.tru lu'ga.riz i ka'dej.ras Di e~'kos.tu Di 'vi~.mi
O interior do chalé era mais espaçoso do que ele havia imaginado.	u i~.te.ri'oR du Sa'lE 'E.ra 'majz es.pa'so.zu du ki 'e.li a'vi.a i~.ma.Zi~'na.du
Papai estava trabalhando em alguma coisa, de costas para ele, com farinha voando enquanto se balançava ao ritmo da música ou do que quer que estivesse escutando.	pa'paj es'ta.va tra.ba'La~.du e~j~ aw'gu~.ma 'koj.za, Di 'kOs.tas 'pa.ra 'e.li, ko~ fa'ri~.Ja vo'a~.du e~'kwa~.tu si ba.la~'sa.va aw 'Ri.Ti~.mu da 'mu.zi.ka ow du ki 'kEX ki es.Ti'vE.si es.ku'ta~.du
A canção obviamente acabou, marcada por duas últimas sacudidas de ombros e quadris.	a ka~'sa~w~ Ob.vi.a~'me~.Ti a.ka'bow, maX'ka.da puR 'du.az 'uw.Ti~.mas sa.ku'Di.das Di 'o~.bruz i kwa'dris
Virando-se para encará-lo, a negra tirou os fones de ouvido.	vi'ra~.du si 'pa.ra e~.ka'ra lu, a 'ne.gra Ti'row us 'fo~.nis Di ow'vi.du
De repente Mack quis fazer mil perguntas ou dizer mil coisas, algumas terríveis.	Di Re'pe~.Ti 'mE.ki 'kis fa'zeR 'miw peR'gu~.taz ow Di'zeR 'miw 'koj.zas, aw'gu~.mas te'Ri.vejs
Tinha a certeza de que seu rosto traía as emoções que ele lutava para controlar e então enfiou tudo de volta no coração sofrido.	'Ti~.Ja a seX'te.za Di ki 'sew 'Ros.tu tra'i.a az e~.mo'so~j~s ki 'e.li lu'ta.va 'pa.ra ko~.tro'lar i e~'ta~w~ e~.fi'ow 'tu.du Di 'vOw.ta nu ko.ra'sa~w~ so'fri.du
Se ela conhecia seu conflito interno, não demonstrou nada pela expressão, ainda aberta, cheia de vida e convidativa.	si 'E.la ko~.Je'si.a 'sew ko~'fli.tu i~'tER.nu, 'na~w~ de~.mo~s'trow 'na.da 'pe.la es.pre'sa~w~, a'i~.da a'bEX.ta, 'Sej.a Di 'vi.da i ko~.vi.da'Ti.va
Ele quis saber: Posso perguntar o que você está escutando?	'e.li 'kis sa'beX, 'pO.su peR.gu~'tar u ki vo'se es'ta es.ku'ta~.du
Um barato da Costa Oeste. É um disco que ainda nem foi lançado, chamado Viagens do coração, tocado por uma banda chamada Diatribe.	u~ ba'ra.tu da 'kOs.ta o'Es.Ti, E u~ 'Dis.ku ki a'i~.da ne~j~ 'foj la~'sa.du, Sa~'ma.du vi'a.Ze~s du ko.ra'sa~w~, to'ka.du pur u~.ma 'ba~.da Sa~'ma.da Di.a'tri.bi
Na verdade, ela piscou para Mack, esses garotos ainda nem nasceram.	na veR'da.Di, 'E.la pis'kow 'pa.ra 'mE.ki, 'e.sis ga'ro.tuz a'i~.da ne~j~ na'se.ra~w~
É mesmo? reagiu Mack bastante incrédulo.	E 'mez.mu, Re.a'Ziw 'mE.ki bas'ta~.Ti i~'krE.du.lu
Um barato da Costa Oeste, hein?	u~ ba'ra.tu da 'kOs.ta o'Es.Ti, 'e~j~
Não parece muito religioso.	'na~w~ pa'rE.si 'mu~j~.tu Re.li.Zi'o.zu
Ah, acredite: não é.	'a, a.kre'Di.Ti, 'na~w~ E
É mais tipo funk e blues eurasiano, com uma mensagem fantástica.	E 'majs 'Ti.pu 'fa~.ki i 'bluz ew.ra.zi'a~.nu, ko~ u~.ma me~'sa.Ze~j~ fa~'tas.Ti.ka
Ela veio bamboleando na direção de Mack, como se estivesse dançando, e bateu palmas.	'E.la 'vej.u ba~.bo.le'a~.du na Di.re'sa~w~ Di 'mE.ki, 'ko~.mu si es.Ti'vE.si da~'sa~.du, i ba'tew 'paw.mas
Mack recuou.	'mE.ki Re.ku'ow
Então Deus ouve funk? Mack nunca ouvira a palavra funk em qualquer contexto religioso.	e~'ta~w~ 'dewz 'ow.vi 'fa~.ki, 'mE.ki 'nu~.ka ow'vi.ra a pa'la.vra 'fa~.ki e~j~ kwaw'kEX ko~'tes.tu Re.li.Zi'o.zu
Achei que você estaria ouvindo uma música mais de igreja.	a'Sej ki vo'se es.ta'ri.a ow'vi~.du u~.ma 'mu.zi.ka 'majs Di i'gre.Za
Ora, veja bem, Mackenzie.	'O.ra, 've.Za 'be~j~, ma'ke~.zi
Você não precisa ficar me rotulando. Eu ouço tudo e não somente a música propriamente dita, mas os corações que estão por trás dela.	vo'se 'na~w~ pre'si.za fi'kaR mi Ro.tu'la~.du, ew 'ow.su 'tu.du i 'na~w~ sO~'me~.Ti a 'mu.zi.ka prO.pri.a~'me~.Ti 'Di.ta, majz us ko.ra'so~j~s ki es'ta~w~ puX 'trajs 'dE.la
Não se lembra de suas aulas na escola dominical?	'na~w~ si 'le~.bra Di 'su.az 'aw.las na es'kO.la do~.mi~.ni'kaw
Esses garotos não estão dizendo nada que eu já não tenha ouvido antes.	'e.sis ga'ro.tus 'na~w~ es'ta~w~ Di'ze~.du 'na.da ki ew 'Za 'na~w~ 'te~.Ja ow'vi.du 'a~.Tis
Simplesmente são cheios de vinagre e gás.	si~.pliz'me~.Ti 'sa~w~ 'Sej.us Di vi~'na.gri i 'gajs
Muita raiva, e, devo dizer, com um bocado de razão.	'mu~j~.ta 'Raj.va, i, 'de.vu Di'zeX, ko~ u~ bo'ka.du Di Ra'za~w~
São apenas alguns dos meus meninos se mostrando e fazendo beicinho.	'sa~w~ a'pe~.naz aw'gu~s dus 'mews me~'ni~.nus si mos'tra~.du i fa'ze~.du bej'si~.Ju
Gosto especialmente desses garotos.	'gOs.tu es.pe.si.aw'me~.Ti 'de.sis ga'ro.tus
É, vou ficar de olho neles.	E, 'vow fi'kaR Di 'o.Lu 'ne.lis
Mack lutou para encontrar algum sentido no que acontecia.	'mE.ki lu'tow 'pa.ra e~.ko~'trar aw'gu~ se~'Ti.du nu ki a.ko~.te'si.a
Nada do que estudara na escola dominical da igreja estava ajudando.	'na.da du ki es.tu'da.ra na es'kO.la do~.mi~.ni'kaw da i'gre.Za es'ta.va a.Zu'da~.du
Por isso declarou o óbvio: Você deve saber que chamá-la de Papai é meio complicado para mim.	pur 'i.su de.kla'row u 'Ob.vju, vo'se 'dE.vi sa'beX ki Sa~'ma la Di pa'paj E 'mej.u ko~.pli'ka.du 'pa.ra 'mi~
Ah, verdade? Ela olhou-o fingindo surpresa.	'a, veR'da.Di, 'E.la o'Low u fi~'Zi~.du suX'pre.za
Claro que sei. Sempre sei. Ela deu um risinho.	'kla.ru ki 'sej, 'se~.pri 'sej, 'E.la 'dew u~ Ri'zi~.Ju
Mas diga, por que você acha que é difícil?	majs 'Di.ga, puX 'ke vo'se 'a.Sa ki E Di'fi.siw
Porque é uma palavra familiar demais ou talvez porque estou me mostrando como mulher, mãe ou...	puX'ke E u~.ma pa'la.vra fa~.mi.li'aR de~'majz ow taw'vejs puX'ke es'tow mi mos'tra~.du 'ko~.mu mu'LEX, 'ma~j~ ow
Tudo isso é complicado, interrompeu Mack com um risinho sem jeito.	'tu.du 'i.su E ko~.pli'ka.du, i~.te.Ro~'pew 'mE.ki ko~ u~ Ri'zi~.Ju se~j~ 'Zej.tu
Ou talvez por causa dos fracassos do seu pai?	ow taw'vejs puX 'kaw.za dus fra'ka.sus du 'sew 'paj
Mack ofegou involuntariamente.	'mE.ki o.fe'gow i~.vo.lu~.ta.ri.a~'me~.Ti
Não estava acostumado a ver seus segredos mais profundos virem à superfície de modo tão rápido e explícito.	'na~w~ es'ta.va a.kos.tu~'ma.du a 'veX 'sews se'gre.dus 'majs pro'fu~.dus 'vi.re~j~ a su.peX'fi.si Di 'mO.du 'ta~w~ 'Ra.pi.du i es'pli.si.tu
A culpa e a raiva cresceram instantaneamente, e ele quis reagir com uma resposta sarcástica.	a 'kuw.pa i a 'Raj.va kre'se.ra~w~ i~s.ta~.ta~.ne.a~'me~.Ti, i 'e.li 'kis Re.a'ZiX ko~ u~.ma Res'pOs.ta saX'kas.Ti.ka
Sentia que estava pendurado sobre um abismo sem fundo e teve medo de que, se deixasse algo daquilo sair, perderia o controle de tudo.	se~'Ti.a ki es'ta.va pe~.du'ra.du 'so.bri u~ a'biz.mu se~j~ 'fu~.du i 'te.vi 'me.du Di ki, si dej'Sa.si 'aw.gu da'ki.lu sa'iX, peR.de'ri.a u ko~'tro.li Di 'tu.du
Procurou uma base segura, mas finalmente só conseguiu responder com os dentes trincados: Talvez porque nunca conheci ninguém a quem pudesse realmente chamar de papai.	pro.ku'row u~.ma 'ba.zi se'gu.ra, majs fi~.naw'me~.Ti 'sO ko~.se'giw Res.po~'deX ko~ us 'de~.Tis tri~'ka.dus, taw'vejs puX'ke 'nu~.ka ko~.Je'si ni~'ge~j~ a 'ke~j~ pu'dE.si Re.aw'me~.Ti Sa~'maR Di pa'paj
Diante disso, ela pousou a tigela que estava aninhada em seu braço e, deixando dentro a colher de pau, virou-se para Mack com olhos gentis.	Di'a~.Ti 'Di.su, 'E.la pow'zow a Ti'ZE.la ki es'ta.va a~.ni~'Ja.da e~j~ 'sew 'bra.su i, dej'Sa~.du 'de~.tru a ko'LER Di 'paw, vi'row si 'pa.ra 'mE.ki ko~ 'O.Lus Ze~'Tis
Não precisava dizer coisa alguma.	'na~w~ pre.si'za.va Di'zeX 'koj.za aw'gu~.ma
Ele viu imediatamente que ela entendia o que lhe ia na alma e de algum modo soube que ela gostava mais dele do que de qualquer pessoa.	'e.li 'viw i~.me.Di.a.ta~'me~.Ti ki 'E.la e~.te~'Di.a u ki Li 'i.a na 'aw.ma i Di aw'gu~ 'mO.du 'sow.bi ki 'E.la gos'ta.va 'majs 'de.li du ki Di kwaw'kEX pe'so.a
Se você deixar, Mack, serei o pai que você nunca teve.	si vo'se dej'SaX, 'mE.ki, se'rej u 'paj ki vo'se 'nu~.ka 'te.vi
A oferta era ao mesmo tempo convidativa e repulsiva.	a o'fEX.ta 'E.ra aw 'mez.mu 'te~.pu ko~.vi.da'Ti.va i Re.puw'si.va
Ele sempre quisera um pai em quem pudesse confiar, mas não sabia se iria encontrá-lo ali, logo com alguém que não pudera proteger sua Missy.	'e.li 'se~.pri ki'zE.ra u~ 'paj e~j~ 'ke~j~ pu'dE.si ko~.fi'aX, majs 'na~w~ sa'bi.a si i'ri.a e~.ko~'tra lu a'li, 'lO.gu ko~ aw'ge~j~ ki 'na~w~ pu'dE.ra pro.te'ZeX 'su.a 'mi.si
Um longo silêncio pairou entre eles.	u~ 'lo~.gu si'le~.sju paj'row 'e~.tri 'e.lis
Mack não sabia direito o que dizer e ela parecia não ter pressa.	'mE.ki 'na~w~ sa'bi.a Di'rej.tu u ki Di'zer i 'E.la pa.re'si.a 'na~w~ 'teX 'prE.sa
Se você não foi capaz de cuidar de Missy, como posso confiar que cuide de mim?	si vo'se 'na~w~ 'foj ka'pajz Di kuj'daR Di 'mi.si, 'ko~.mu 'pO.su ko~.fi'aX ki 'kuj.Di Di 'mi~
Pronto, havia feito a pergunta que o atormentara em todos os dias da Grande Tristeza.	'pro~.tu, a'vi.a 'fej.tu a peR'gu~.ta ki u a.toR.me~'ta.ra e~j~ 'to.duz us 'Di.as da 'gra~.Di tris'te.za
Mack sentiu o rosto se encher de um vermelhidão de raiva, enquanto olhava para o que agora considerava uma caracterização estranha de Deus, e percebeu que fechara os punhos com força.	'mE.ki se~'Tiw u 'Ros.tu si e~'SeR Di u~ veR.me.Li'da~w~ Di 'Raj.va, e~'kwa~.tu o'La.va 'pa.ra u ki a'gO.ra ko~.si.de'ra.va u~.ma ka.rak.te.ri.za'sa~w~ es'tra~.Ja Di 'dews, i peX.se'bew ki fe'Sa.ra us 'pu~.Jus ko~ 'foX.sa
Mack, sinto muito. Lágrimas começaram a descer pelo rosto dela.	'mE.ki, 'si~.tu 'mu~j~.tu, 'la.gri~.mas ko~.me'sa.ra~w~ a de'seX 'pe.lu 'Ros.tu 'dE.la
Sei o tamanho do abismo que isso abriu entre nós.	'sej u ta~'ma~.Ju du a'biz.mu ki 'i.su a'briw 'e~.tri 'nOjs
Sei que você ainda não entende, mas gosto especialmente de Missy e de você também.	'sej ki vo'se a'i~.da 'na~w~ e~'te~.Di, majs 'gOs.tu es.pe.si.aw'me~.Ti Di 'mi.si i Di vo'se ta~'be~j~
Mack adorou o modo como ela disse o nome de Missy, mas odiou ouvi-lo dito por ela.	'mE.ki a.do'row u 'mO.du 'ko~.mu 'E.la 'Di.si u 'no~.mi Di 'mi.si, majz o.Di'ow ow'vi lu 'Di.tu pur 'E.la
Mack desejava acreditar, e lentamente parte da raiva começou a diminuir.	'mE.ki de.ze'Za.va a.kre.Di'taX, i le~.ta~'me~.Ti 'paX.Ti da 'Raj.va ko~.me'sow a Di~.mi~.nu'iX
É por isso que você está aqui, Mack, continuou ela.	E pur 'i.su ki vo'se es'ta a'ki, 'mE.ki, ko~.Ti~.nu'ow 'E.la
Quero curar a ferida que cresceu dentro de você e entre nós.	'kE.ru ku'rar a fe'ri.da ki kre'sew 'de~.tru Di vo'se i 'e~.tri 'nOjs
Para ganhar algum controle, ele voltou os olhos para o chão.	'pa.ra ga~'Jar aw'gu~ ko~'tro.li, 'e.li vow'tow uz 'O.Lus 'pa.ra u 'Sa~w~
Passou-se um minuto inteiro antes que tivesse energia suficiente para sussurrar sem levantar a cabeça: Acho que eu gostaria disso, admitiu, mas não vejo como.	pa'sow si 'u~ mi~'nu.tu i~'tej.ru 'a~.Tis ki Ti'vE.si e~.neR'Zi.a su.fi.si'e~.Ti 'pa.ra su.su'RaX se~j~ le.va~'tar a ka'be.sa, 'a.Su ki ew gos.ta'ri.a 'Di.su, a.Di~.mi'Tiw, majs 'na~w~ 've.Zu 'ko~.mu
Querido, não existe resposta fácil para a sua dor.	ke'ri.du, 'na~w~ e'zis.Ti Res'pOs.ta 'fa.siw 'pa.ra a 'su.a 'doX
Acredite, se eu tivesse uma, usaria agora.	a.kre'Di.Ti, si ew Ti'vE.si u~.ma, u.za'ri.a a'gO.ra
Não tenho varinha mágica para fazer com que tudo fique bem.	'na~w~ 'te~.Ju va'ri~.Ja 'ma.Zi.ka 'pa.ra fa'zeX ko~ ki 'tu.du 'fi.ki 'be~j~
A vida custa um bocado de tempo e um monte de relacionamentos.	a 'vi.da 'kus.ta u~ bo'ka.du Di 'te~.pu i u~ 'mo~.Ti Di Re.la.si.o~.na~'me~.tus
Mack ficou satisfeito porque estavam se afastando de sua acusação medonha.	'mE.ki fi'kow sa.Tis'fej.tu puX'ke es'ta.va~w~ si a.fas'ta~.du Di 'su.a a.ku.za'sa~w~ me'do~.Ja
Ficara apavorado com a intensidade da própria raiva.	fi'ka.ra a.pa.vo'ra.du ko~ a i~.te~.si'da.Di da 'prO.prja 'Raj.va
Acho que seria mais fácil ter esta conversa se você não estivesse usando um vestido,  ele sugeriu, tentando sorrir debilmente.	'a.Su ki se'ri.a 'majs 'fa.siw 'ter 'Es.ta ko~'vEX.sa si vo'se 'na~w~ es.Ti'vE.si u'za~.du u~ ves'Ti.du, 'e.li su.Ze'riw, te~'ta~.du so'RiR dE.biw'me~.Ti
Se fosse mais fácil, eu não estaria assim, ela disse com um risinho.	si 'fo.si 'majs 'fa.siw, ew 'na~w~ es.ta'ri.a a'si~, 'E.la 'Di.si ko~ u~ Ri'zi~.Ju
Não estou tentando tornar isso mais difícil para nenhum de nós dois.	'na~w~ es'tow te~'ta~.du toR'nar 'i.su 'majs Di'fi.siw 'pa.ra ne~'Ju~ Di 'nOjs 'dojs
Mas este é um bom lugar para começar.	majz 'es.Ti E u~ 'bo~ lu'gaX 'pa.ra ko~.me'saX
Ela pegou de novo a colher de pau, de onde pingava algum tipo de massa.	'E.la pe'gow Di 'no.vu a ko'LeR Di 'paw, Di 'o~.Di pi~'ga.va aw'gu~ 'Ti.pu Di 'ma.sa
Mackenzie, eu não sou masculino nem feminina, ainda que os dois gêneros derivem da minha natureza.	ma'ke~.zi, ew 'na~w~ 'sow mas.ku'li~.nu ne~j~ fe~.mi~'ni~.na, a'i~.da ki us 'dojs 'Ze~.ne.rus de'ri.ve~j~ da 'mi~.Ja na.tu're.za
Se eu escolho aparecer para você como homem ou mulher, é porque o amo.	si ew es'ko.Lu a.pa.re'seX 'pa.ra vo'se 'ko~.mu 'o~.me~j~ ow mu'LEX, E puX'ke u 'a~.mu
Para mim, aparecer como mulher e sugerir que você me chame de Papai é simplesmente para ajudá-lo a não sucumbir tão facilmente aos seus condicionamentos religiosos.	'pa.ra 'mi~, a.pa.re'seX 'ko~.mu mu'LEr i su.Ze'riX ki vo'se mi 'Sa~.mi Di pa'paj E si~.pliz'me~.Ti 'pa.ra a.Zu'da lu a 'na~w~ su.ku~'biX 'ta~w~ fa.siw'me~.Ti aws 'sews ko~.Di.si.o~.na~'me~.tus Re.li.Zi'O.zus
Ela se inclinou, como se quisesse compartilhar um segredo.	'E.la si i~.kli~'now, 'ko~.mu si ki'zE.si ko~.paX.Ti'Lar u~ se'gre.du
Se eu me revelasse a você como uma figura muito grande, branca e com aparência de avô com uma barba comprida, simplesmente reforçaria seus estereótipos religiosos.	si ew mi Re.ve'la.si a vo'se 'ko~.mu u~.ma fi'gu.ra 'mu~j~.tu 'gra~.Di, 'bra~.ka i ko~ a.pa're~.sja Di a'vo ko~ u~.ma 'baR.ba ko~'pri.da, si~.pliz'me~.Ti Re.foX.sa'ri.a 'sewz es.te.re'O.Ti.pus Re.li.Zi'O.zus
É importante você saber que o objetivo deste fim de semana não é reforçar esses estereótipos.	E i~.poX'ta~.Ti vo'se sa'beX ki u ob.Ze'Ti.vu 'des.Ti 'fi~ Di se~'ma~.na 'na~w~ E Re.foX'sar 'e.siz es.te.re'O.Ti.pus
Mack quase riu alto, ironizando, mas, em vez disso, concentrou-se no que ela acabara de dizer e recuperou a compostura.	'mE.ki 'kwa.zi 'Riw 'aw.tu, i.ro~.ni'za~.du, majs, e~j~ 'vejz 'Di.su, ko~.se~'trow si nu ki 'E.la a.ka'ba.ra Di Di'zer i Re.ku.pe'row a ko~.pos'tu.ra
Ela parou de falar enquanto guardava alguns condimentos numa prateleira de temperos e depois virou-se para encará-lo de novo.	'E.la pa'row Di fa'lar e~'kwa~.tu gwaR'da.va aw'gu~s ko~.Di~'me~.tus 'nu~.ma pra.te'lej.ra Di te~'pe.ruz i de'pojs vi'row si 'pa.ra e~.ka'ra lu Di 'no.vu
Olhou para Mack com intensidade.	o'Low 'pa.ra 'mE.ki ko~ i~.te~.si'da.Di
Não é verdade que você sempre teve dificuldade para me ver como um pai?	'na~w~ E veR'da.Di ki vo'se 'se~.pri 'te.vi Di.fi.kuw'da.Di 'pa.ra mi 'veX 'ko~.mu u~ 'paj
Depois do que passou, não fica nada fácil lidar com um pai, não é?	de'pojs du ki pa'sow, 'na~w~ 'fi.ka 'na.da 'fa.siw li'daX ko~ u~ 'paj, 'na~w~ E
Ele sabia que ela estava certa e percebeu a gentileza e a compaixão de sua atitude.	'e.li sa'bi.a ki 'E.la es'ta.va 'sEX.ta i peX.se'bew a Ze~.Ti'le.za i a ko~.paj'Sa~w~ Di 'su.a a.Ti'tu.Di
De algum modo, a maneira como ela havia se aproximado dele diminuíra sua resistência a receber o amor oferecido.	Di aw'gu~ 'mO.du, a ma~'nej.ra 'ko~.mu 'E.la a'vi.a si a.pro.si~'ma.du 'de.li Di~.mi~.nu'i.ra 'su.a Re.zis'te~.sja a Re.se'ber u a~'mor o.fe.re'si.du
Mas então, ele parou, esforçando-se para se manter racional, por que tanta ênfase em você ser um pai?	majz e~'ta~w~, 'e.li pa'row, es.foX'sa~.du si 'pa.ra si ma~'te.Ra.si.o~'naw, puX 'ke 'ta~.ta 'e~.fa.zi e~j~ vo'se 'ser u~ 'paj
Quero dizer, este parece o modo como você mais se revela.	'kE.ru Di'zeX, 'es.Ti pa'rE.si u 'mO.du 'ko~.mu vo'se 'majs si Re'vE.la
Bem, respondeu Papai dando-lhe as costas e ocupando-se na cozinha, há muitos motivos para isso, e alguns são muito profundos.	'be~j~, Res.po~'dew pa'paj 'da~.du Li as 'kOs.taz i o.ku'pa~.du si na ko'zi~.Ja, 'a 'mu~j~.tus mo'Ti.vus 'pa.ra 'i.su, i aw'gu~s 'sa~w~ 'mu~j~.tu pro'fu~.dus
Por enquanto, deixe-me dizer que, assim que a Criação se degradou, nós soubemos que a verdadeira paternidade faria muito mais falta do que a maternidade.	pur e~'kwa~.tu, 'dej.Si mi Di'zeX ki, a'si~ ki a kri.a'sa~w~ si de.gra'dow, 'nOjs sow'be~.mus ki a veR.da'dej.ra pa.teR.ni'da.Di fa'ri.a 'mu~j~.tu 'majs 'faw.ta du ki a ma.teR.ni'da.Di
Não me entenda mal, as duas coisas são necessárias, mas é essencial uma ênfase na paternidade por causa da enormidade das consequências da ausência da função paterna.	'na~w~ mi e~'te~.da 'maw, as 'du.as 'koj.zas 'sa~w~ ne.se'sa.rjas, majz E e.se~.si'aw u~.ma 'e~.fa.zi na pa.teR.ni'da.Di puX 'kaw.za da e~.noR.mi'da.Di das ko~.se'kwe~.sjas da aw'ze~.sja da fu~'sa~w~ pa'tER.na
Mack se virou, meio perplexo, sentindo que aquilo já estava indo longe demais.	'mE.ki si vi'row, 'mej.u peX'plEk.su, se~'Ti~.du ki a'ki.lu 'Za es'ta.va 'i~.du 'lo~.Zi de~'majs
Enquanto refletia, olhou pela janela para um jardim de aparência selvagem.	e~'kwa~.tu Re.fle'Ti.a, o'Low 'pe.la Za~'nE.la 'pa.ra u~ ZaR'Di~ Di a.pa're~.sja sew'va.Ze~j~
Você sabia que eu viria, não é? disse finalmente, baixinho.	vo'se sa'bi.a ki ew vi'ri.a, 'na~w~ E, 'Di.si fi~.naw'me~.Ti, baj'Si~.Ju
Claro que sabia. Ela estava ocupada de novo, de costas para ele.	'kla.ru ki sa'bi.a, 'E.la es'ta.va o.ku'pa.da Di 'no.vu, Di 'kOs.tas 'pa.ra 'e.li
Então eu não estava livre para deixar de vir?	e~'ta~w~ ew 'na~w~ es'ta.va 'li.vri 'pa.ra dej'SaR Di 'viX
Eu não tinha opção?	ew 'na~w~ 'Ti~.Ja op'sa~w~
Papai se virou de novo para encará-lo, agora com farinha e massa nas mãos.	pa'paj si vi'row Di 'no.vu 'pa.ra e~.ka'ra lu, a'gO.ra ko~ fa'ri~.Ja i 'ma.sa nas 'ma~w~s
Ela não esperou resposta, sabendo que Mack não tinha.	'E.la 'na~w~ es.pe'row Res'pOs.ta, sa'be~.du ki 'mE.ki 'na~w~ 'Ti~.Ja
Em vez disso, perguntou: Você acredita que está livre para ir embora?	e~j~ 'vejz 'Di.su, peR.gu~'tow, vo'se a.kre'Di.ta ki es'ta 'li.vri 'pa.ra 'ir e~'bO.ra
Claro que está!	'kla.ru ki es'ta
Não gosto de prisioneiros.	'na~w~ 'gOs.tu Di pri.zi.o~'nej.rus
Você está livre para sair por essa porta agora mesmo e voltar para a sua casa vazia.	vo'se es'ta 'li.vri 'pa.ra sa'iX pur 'E.sa 'pOX.ta a'gO.ra 'mez.mu i vow'taX 'pa.ra a 'su.a 'ka.za va'zi.a
Mas eu sei que você é curioso demais para ir.	majz ew 'sej ki vo'se E ku.ri'o.zu de~'majs 'pa.ra 'iX
Ela parou apenas brevemente e depois voltou para sua tarefa, falando com ele por cima do ombro.	'E.la pa'row a'pe~.nas brE.ve~'me~.Ti i de'pojs vow'tow 'pa.ra 'su.a ta'rE.fa, fa'la~.du ko~ 'e.li puX 'si~.ma du 'o~.bru
Será que liberdade significa que você tem permissão para fazer o que quer?	se'ra ki li.beR'da.Di si.gi~.ni'fi.ka ki vo'se te~j~ peR.mi'sa~w~ 'pa.ra fa'zer u ki 'kEX
Ou poderíamos falar sobre tudo o que limita a sua liberdade.	ow po.de'ri.a~.mus fa'laX 'so.bri 'tu.du u ki li~'mi.ta a 'su.a li.beR'da.Di
A herança genética de sua família, seu DNA específico, seu metabolismo, as questões quânticas que acontecem num nível subatômico onde só eu sou a observadora sempre presente.	a e'ra~.sa Ze~'nE.Ti.ka Di 'su.a fa~'mi.lja, 'sew 'de 'e~.ni 'a es.pe'si.fi.ku, 'sew me.ta.bo'liz.mu, as kes'to~j~s 'kwa~.Ti.kas ki a.ko~'tE.se~j~ nu~ 'ni.vew su.ba'to~.mi.ku 'o~.Di 'sO ew 'sow a ob.seR.va'do.ra 'se~.pri pre'ze~.Ti
Existem as doenças de sua alma que o inibem e amarram, as influências sociais externas, os hábitos que criaram elos e caminhos sinápticos no seu cérebro.	e'zis.te~j~ as do'e~.sas Di 'su.a 'aw.ma ki u i~'ni.be~j~ i a~'ma.Ra~w~, az i~.flu'e~.sjas so.si'ajz es'tER.nas, uz 'a.bi.tus ki kri'a.ra~w~ 'E.luz i ka~'mi~.Jus si~'nap.Ti.kus nu 'sew 'sE.re.bru
E há os anúncios, as propagandas e os paradigmas.	i 'a uz a~'nu~.sjus, as pro.pa'ga~.daz i us pa.ra'Di.gi~.mas
Diante dessa confluência de inibidores multifacetados, ela suspirou, o que é de fato a liberdade?	Di'a~.Ti 'dE.sa ko~.flu'e~.sja Di i~.ni.bi'do.ris muw.Ti.fa.se'ta.dus, 'E.la sus.pi'row, u ki E Di 'fa.tu a li.beR'da.Di
Mack ficou ali parado, sem saber o que dizer.	'mE.ki fi'kow a'li pa'ra.du, se~j~ sa'ber u ki Di'zeX
Só eu posso libertá-lo, Mackenzie, mas a liberdade jamais pode ser forçada.	'sO ew 'pO.su li.beX'ta lu, ma'ke~.zi, majz a li.beR'da.Di Za~'majs 'pO.Di 'seX foX'sa.da
Não entendo. Não estou entendendo o que você acaba de dizer.	'na~w~ e~'te~.du, 'na~w~ es'tow e~.te~'de~.du u ki vo'se a'ka.ba Di Di'zeX
Ela se virou e sorriu.	'E.la si vi'row i so'Riw
Eu sei.	ew 'sej
Não falei para que você entendesse agora.	'na~w~ fa'lej 'pa.ra ki vo'se e~.te~'de.si a'gO.ra
Falei para mais tarde.	fa'lej 'pa.ra 'majs 'taR.Di
No ponto em que estamos, você ainda não compreende que a liberdade é um processo de crescimento.	nu 'po~.tu e~j~ ki es'ta~.mus, vo'se a'i~.da 'na~w~ ko~.pre'e~.Di ki a li.beR'da.Di E u~ pro'sE.su Di kre.si~'me~.tu
Estendendo gentilmente as mãos sujas de farinha, ela segurou as de Mack e, olhando-o direto nos olhos, continuou: Mackenzie, a Verdade irá libertá-lo, e a Verdade tem nome.	es.te~'de~.du Ze~.Tiw'me~.Ti as 'ma~w~s 'su.Zas Di fa'ri~.Ja, 'E.la se.gu'row as Di 'mE.ki i, o'La~.du u Di'rE.tu nuz 'O.Lus, ko~.Ti~.nu'ow, ma'ke~.zi, a veR'da.Di i'ra li.beX'ta lu, i a veR'da.Di te~j~ 'no~.mi
Neste momento ele está na carpintaria, coberto de serragem.	'nes.Ti mo~'me~.tu 'e.li es'ta na kaX.pi~.ta'ri.a, ko'bEX.tu Di se'Ra.Ze~j~
Tudo tem a ver com ele.	'tu.du te~j~ a 'veX ko~ 'e.li
E a liberdade é um processo que acontece dentro de um relacionamento com ele.	i a li.beR'da.Di E u~ pro'sE.su ki a.ko~'tE.si 'de~.tru Di u~ Re.la.si.o~.na~'me~.tu ko~ 'e.li
Como você pode realmente saber como me sinto? perguntou Mack, encarando-a de volta.	'ko~.mu vo'se 'pO.Di Re.aw'me~.Ti sa'beX 'ko~.mu mi 'si~.tu, peR.gu~'tow 'mE.ki, e~.ka'ra~.du a Di 'vOw.ta
Papai não respondeu, apenas olhou para as mãos dos dois.	pa'paj 'na~w~ Res.po~'dew, a'pe~.naz o'Low 'pa.ra as 'ma~w~s dus 'dojs
O olhar de Mack seguiu o dela, e pela primeira vez ele notou as cicatrizes nos punhos da negra, como as que agora presumia que Jesus também tinha nos dele.	u o'LaR Di 'mE.ki se'giw u 'dE.la, i 'pe.la pri~'mej.ra 'vejz 'e.li no'tow as si.ka'tri.zis nus 'pu~.Jus da 'ne.gra, 'ko~.mu as ki a'gO.ra pre.zu~'mi.a ki Ze'zujs ta~'be~j~ 'Ti~.Ja nus 'de.li
Ela permitiu que ele tocasse com ternura as cicatrizes, marcas de furos fundos, e finalmente Mack ergueu os olhos para os dela.	'E.la peR.mi'Tiw ki 'e.li to'ka.si ko~ teR'nu.ra as si.ka'tri.zis, 'maX.kas Di 'fu.rus 'fu~.dus, i fi~.naw'me~.Ti 'mE.ki eR'gew uz 'O.Lus 'pa.ra us 'dE.la
Lágrimas desciam lentamente pelo rosto de Papai, pequenos caminhos através da farinha que empoava suas faces.	'la.gri~.mas de'si.a~w~ le~.ta~'me~.Ti 'pe.lu 'Ros.tu Di pa'paj, pe'ke~.nus ka~'mi~.Juz a.tra'vEjs da fa'ri~.Ja ki e~.po'a.va 'su.as 'fa.sis
Jamais pense que o que meu filho optou por fazer não nos custou caro.	Za~'majs 'pe~.si ki u ki 'mew 'fi.Lu op'tow puX fa'zeR 'na~w~ nus kus'tow 'ka.ru
O amor sempre deixa uma marca significativa, ela declarou, baixinho e gentilmente.	u a~'moX 'se~.pri 'dej.Sa u~.ma 'maX.ka si.gi~.ni.fi.ka'Ti.va, 'E.la de.kla'row, baj'Si~.Ju i Ze~.Tiw'me~.Ti
Nós estávamos lá, juntos.	'nOjz es'ta.va~.mus 'la, 'Zu~.tus
Mack ficou surpreso.	'mE.ki fi'kow suX'pre.zu
Na cruz?	na 'krujs
Espere aí, eu pensei que você o tinha abandonado.	es'pE.ri a'i, ew pe~'sej ki vo'se u 'Ti~.Ja a.ba~.do~'na.du
Você não entendeu o mistério naquilo.	vo'se 'na~w~ e~.te~'dew u mis'tE.rju na'ki.lu
Independentemente do que ele sentiu no momento, eu nunca o deixei.	i~.de.pe~.de~.Ti~'me~.Ti du ki 'e.li se~'Tiw nu mo~'me~.tu, ew 'nu~.ka u dej'Sej
Como pode dizer isso?	'ko~.mu 'pO.Di Di'zer 'i.su
Você o abandonou, exatamente como me abandonou!	vo'se u a.ba~.do~'now, e.za.ta~'me~.Ti 'ko~.mu mi a.ba~.do~'now
Mackenzie, eu nunca o abandonei e nunca deixei você.	ma'ke~.zi, ew 'nu~.ka u a.ba~.do~'nej i 'nu~.ka dej'Sej vo'se
Isso não faz nenhum sentido, reagiu ele rispidamente.	'i.su 'na~w~ 'fajz ne~'Ju~ se~'Ti.du, Re.a'Ziw 'e.li Ris.pi.da~'me~.Ti
Sei que não, pelo menos por enquanto.	'sej ki 'na~w~, 'pe.lu 'me~.nus pur e~'kwa~.tu
Mas pense nisto: quando tudo que consegue ver é sua dor, talvez você perca a visão de mim, não é?	majs 'pe~.si 'nis.tu, 'kwa~.du 'tu.du ki ko~'sE.gi 'ver E 'su.a 'doX, taw'vejz vo'se 'peX.ka a vi'za~w~ Di 'mi~, 'na~w~ E
Quando Mack não respondeu, ela retornou ao trabalho na cozinha, como se quisesse lhe oferecer um pouco de um necessário espaço.	'kwa~.du 'mE.ki 'na~w~ Res.po~'dew, 'E.la Re.toR'now aw tra'ba.Lu na ko'zi~.Ja, 'ko~.mu si ki'zE.si Li o.fe.re'ser u~ 'pow.ku Di u~ ne.se'sa.rju es'pa.su
Parecia estar preparando vários pratos ao mesmo tempo, acrescentando temperos e ingredientes.	pa.re'si.a es'taX pre.pa'ra~.du 'va.rjus 'pra.tuz aw 'mez.mu 'te~.pu, a.kre.se~'ta~.du te~'pe.ruz i i~.gre.Di'e~.Tis
Cantarolando uma musiquinha repetitiva, deu os últimos retoques na torta que estava fazendo e enfiou-a no forno.	ka~.ta.ro'la~.du u~.ma mu.zi'ki~.Ja Re.pe.Ti'Ti.va, 'dew uz 'uw.Ti~.mus Re'tO.kis na 'tOX.ta ki es'ta.va fa'ze~.du i e~.fi'ow a nu 'foR.nu
Não se esqueça, a história não terminou no sentimento de abandono de Jesus.	'na~w~ si es'ke.sa, a is'tO.rja 'na~w~ teR.mi~'now nu se~.Ti~'me~.tu Di a.ba~'do~.nu Di Ze'zujs
Ele encontrou a saída para se colocar inteiramente nas minhas mãos.	'e.li e~.ko~'trow a sa'i.da 'pa.ra si ko.lo'kar i~.tej.ra~'me~.Ti nas 'mi~.Jas 'ma~w~s
Ah, que momento foi aquele!	'a, ki mo~'me~.tu 'foj a'ke.li
Mack se encostou na bancada um tanto perplexo.	'mE.ki si e~.kos'tow na ba~'ka.da u~ 'ta~.tu peX'plEk.su
Parte dele queria acreditar em tudo que Papai dizia. Seria ótimo!	'paX.Ti 'de.li ke'ri.a a.kre.Di'tar e~j~ 'tu.du ki pa'paj Di'zi.a, se'ri.a 'O.Ti~.mu
Mas outra parte questionava ruidosamente: Isso não pode ser verdade!	majz 'ow.tra 'paX.Ti kes.Ti.o~'na.va Ruj.dO.za~'me~.Ti, 'i.su 'na~w~ 'pO.Di 'seR veR'da.Di
Papai pegou o cronômetro da cozinha, girou-o de leve e colocou-o na mesa diante deles.	pa'paj pe'gow u kro~'no~.me.tru da ko'zi~.Ja, Zi'row u Di 'lE.vi i ko.lo'kow u na 'me.za Di'a~.Ti 'de.lis
Não sou quem você acha, Mackenzie. As palavras dela não eram raivosas nem defensivas.	'na~w~ 'sow 'ke~j~ vo'se 'a.Sa, ma'ke~.zi, as pa'la.vras 'dE.la 'na~w~ 'E.ra~w~ Raj'vO.zas ne~j~ de.fe~'si.vas
Mack olhou para ela, olhou para o cronômetro e suspirou.	'mE.ki o'Low 'pa.ra 'E.la, o'Low 'pa.ra u kro~'no~.me.tru i sus.pi'row
Estou me sentindo totalmente perdido.	es'tow mi se~'Ti~.du to.taw'me~.Ti peR'Di.du
Então vejamos se podemos encontrá-lo no meio dessa confusão.	e~'ta~w~ ve'Za~.mus si po'de~.mus e~.ko~'tra lu nu 'mej.u 'dE.sa ko~.fu'za~w~
Quase como se tivesse recebido a deixa, um pássaro azul pousou no parapeito da janela e começou a pular para trás e para a frente.	'kwa.zi 'ko~.mu si Ti'vE.si Re.se'bi.du a 'dej.Sa, u~ 'pa.sa.ru a'zuw pow'zow nu pa.ra'pej.tu da Za~'nE.la i ko~.me'sow a pu'laX 'pa.ra 'trajz i 'pa.ra a 'fre~.Ti
Papai enfiou a mão numa lata sobre a bancada e, abrindo a janela, ofereceu ao pássaro uma mistura de grãos que ela devia guardar exatamente para isso.	pa'paj e~.fi'ow a 'ma~w~ 'nu~.ma 'la.ta 'so.bri a ba~'ka.da i, a'bri~.du a Za~'nE.la, o.fe.re'sew aw 'pa.sa.ru u~.ma mis'tu.ra Di 'gra~w~s ki 'E.la de'vi.a gwaR'dar e.za.ta~'me~.Ti 'pa.ra 'i.su
Sem qualquer hesitação e com aparente ar de humildade e gratidão, o pássaro foi direto para a mão dela e começou a comer.	se~j~ kwaw'kEr e.zi.ta'sa~w~ i ko~ a.pa're~.Ti 'aR Di u~.miw'da.Di i gra.Ti'da~w~, u 'pa.sa.ru 'foj Di'rE.tu 'pa.ra a 'ma~w~ 'dE.la i ko~.me'sow a ko~'meX
Considere nosso amiguinho aqui, começou ela.	ko~.si'dE.ri 'nO.su a~.mi'gi~.Ju a'ki, ko~.me'sow 'E.la
A maioria dos pássaros foi criada para voar.	a maj.o'ri.a dus 'pa.sa.rus 'foj kri'a.da 'pa.ra vo'aX
Para eles, ficar no solo é uma limitação de sua capacidade de voar, e não o contrário.	'pa.ra 'e.lis, fi'kaR nu 'sO.lu E u~.ma li~.mi.ta'sa~w~ Di 'su.a ka.pa.si'da.Di Di vo'aX, i 'na~w~ u ko~'tra.rju
Ela parou para deixar que Mack pensasse nisso.	'E.la pa'row 'pa.ra dej'SaX ki 'mE.ki pe~'sa.si 'ni.su
Você, por outro lado, foi criado para ser amado.	vo'se, pur 'ow.tru 'la.du, 'foj kri'a.du 'pa.ra 'ser a~'ma.du
Assim, para você, viver como se não fosse amado é uma limitação, e não o contrário.	a'si~, 'pa.ra vo'se, vi'veX 'ko~.mu si 'na~w~ 'fo.si a~'ma.du E u~.ma li~.mi.ta'sa~w~, i 'na~w~ u ko~'tra.rju
Mack assentiu, não porque concordasse completamente, mas sinalizando que entendia e estava acompanhando.	'mE.ki a.se~'Tiw, 'na~w~ puX'ke ko~.koR'da.si ko~.plE.ta~'me~.Ti, majs si~.na.li'za~.du ki e~.te~'Di.a i es'ta.va a.ko~.pa~'Ja~.du
O que ela dizia era bastante simples.	u ki 'E.la Di'zi.a 'E.ra bas'ta~.Ti 'si~.plis
Viver sem ser amado é como cortar as asas de um pássaro e tirar sua capacidade de voar.	vi'veX se~j~ 'ser a~'ma.du E 'ko~.mu koX'tar az 'a.zas Di u~ 'pa.sa.ru i Ti'raX 'su.a ka.pa.si'da.Di Di vo'aX
Não é algo que eu queira para você.	'na~w~ E 'aw.gu ki ew 'kej.ra 'pa.ra vo'se
Aí é que estava.	a'i E ki es'ta.va
No momento ele não se sentia particularmente amado.	nu mo~'me~.tu 'e.li 'na~w~ si se~'Ti.a paX.Ti.ku.laR'me~.Ti a~'ma.du
Mack, a dor tem a capacidade de cortar nossas asas e nos impedir de voar. Ela esperou um momento, permitindo que suas palavras se assentassem.	'mE.ki, a 'doX te~j~ a ka.pa.si'da.Di Di koX'taR 'nO.saz 'a.zaz i nuz i~.pe'DiR Di vo'aX, 'E.la es.pe'row u~ mo~'me~.tu, peR.mi'Ti~.du ki 'su.as pa'la.vras si a.se~'ta.se~j~
E, se essa situação persistir por muito tempo, você quase pode esquecer que foi criado originalmente para voar.	i, si 'E.sa si.tu.a'sa~w~ peX.sis'TiX puR 'mu~j~.tu 'te~.pu, vo'se 'kwa.zi 'pO.Di es.ke'seX ki 'foj kri'a.du o.ri.Zi~.naw'me~.Ti 'pa.ra vo'aX
Mack ficou quieto.	'mE.ki fi'kow ki'E.tu
Estranhamente, o silêncio não era tão desconfortável assim.	es.tra~.Ja~'me~.Ti, u si'le~.sju 'na~w~ 'E.ra 'ta~w~ des.ko~.foX'ta.vew a'si~
Olhou o pássaro.	o'Low u 'pa.sa.ru
O pássaro olhou de volta para Mack.	u 'pa.sa.ru o'Low Di 'vOw.ta 'pa.ra 'mE.ki
Ele imaginou se seria possível os pássaros sorrirem.	'e.li i~.ma.Zi~'now si se'ri.a po'si.vew us 'pa.sa.rus so'Ri.re~j~
Pelo menos aquele parecia capaz.	'pe.lu 'me~.nuz a'ke.li pa.re'si.a ka'pajs
Não sou como você, Mack.	'na~w~ 'sow 'ko~.mu vo'se, 'mE.ki
Não era uma repreensão, e sim a simples declaração de um fato.	'na~w~ 'E.ra u~.ma Re.pre.e~'sa~w~, i 'si~ a 'si~.plis de.kla.ra'sa~w~ Di u~ 'fa.tu
Mas para Mack foi como um banho de água gelada.	majs 'pa.ra 'mE.ki 'foj 'ko~.mu u~ 'ba~.Ju Di 'a.gwa Ze'la.da
Sou Deus.	'sow 'dews
Sou quem sou.	'sow 'ke~j~ 'sow
E, ao contrário de você, minhas asas não podem ser cortadas.	i, aw ko~'tra.rju Di vo'se, 'mi~.Jaz 'a.zas 'na~w~ 'pO.de~j~ 'seX koX'ta.das
Bom, é maravilhoso para você, mas onde, exatamente, isso me deixa? reagiu Mack, parecendo mais irritado do que gostaria.	'bo~, E ma.ra.vi'Lo.zu 'pa.ra vo'se, majz 'o~.Di, e.za.ta~'me~.Ti, 'i.su mi 'dej.Sa, Re.a'Ziw 'mE.ki, pa.re'se~.du 'majz i.Ri'ta.du du ki gos.ta'ri.a
Papai começou a acariciar o pássaro, aproximou-o do rosto e disse: Exatamente no centro do meu amor!	pa'paj ko~.me'sow a a.ka.ri.si'ar u 'pa.sa.ru, a.pro.si~'mow u du 'Ros.tu i 'Di.si, e.za.ta~'me~.Ti nu 'se~.tru du 'mew a~'moX
Estou achando que esse pássaro provavelmente entende isso melhor do que eu, foi o máximo que Mack conseguiu dizer.	es'tow a'Sa~.du ki 'e.si 'pa.sa.ru pro.va.vew'me~.Ti e~'te~.Di 'i.su me'LOR du ki ew, 'foj u 'ma.si~.mu ki 'mE.ki ko~.se'giw Di'zeX
Eu sei, querido.	ew 'sej, ke'ri.du
Por isso estamos aqui.	pur 'i.su es'ta~.muz a'ki
Por que você acha que eu disse que não sou como você?	puX 'ke vo'se 'a.Sa ki ew 'Di.si ki 'na~w~ 'sow 'ko~.mu vo'se
Bom, realmente não faço idéia.	'bo~, Re.aw'me~.Ti 'na~w~ 'fa.su i'dEj.a
Quer dizer, você é Deus e eu não sou. Ele não conseguiu afastar o sarcasmo da voz, mas ela o ignorou completamente.	'kER Di'zeX, vo'se E 'dewz i ew 'na~w~ 'sow, 'e.li 'na~w~ ko~.se'giw a.fas'tar u saX'kaz.mu da 'vOjs, majz 'E.la u i.gi~.no'row ko~.plE.ta~'me~.Ti
É, mas não exatamente.	E, majs 'na~w~ e.za.ta~'me~.Ti
Pelo menos não do modo como você está pensando.	'pe.lu 'me~.nus 'na~w~ du 'mO.du 'ko~.mu vo'se es'ta pe~'sa~.du
Mackenzie, eu sou o que alguns chamariam de sagrado e totalmente diferente de você.	ma'ke~.zi, ew 'sow u ki aw'gu~.Sa~.ma'ri.a~w~ Di sa'gra.du i to.taw'me~.Ti Di.fe're~.Ti Di vo'se
E, embora possa parecer um esforço nobre, a verdade é que fica lamentavelmente distante do que realmente sou.	i, e~'bO.ra 'pO.sa pa.re'ser u~ es'foX.su 'nO.bri, a veR'da.Di E ki 'fi.ka la~.me~.ta.vew'me~.Ti Dis'ta~.Ti du ki Re.aw'me~.Ti 'sow
Sou muito mais do que isso, sou acima e além de tudo o que você possa perguntar ou pensar.	'sow 'mu~j~.tu 'majs du ki 'i.su, 'sow a'si~.ma i a'le~j~ Di 'tu.du u ki vo'se 'pO.sa peR.gu~'tar ow pe~'saX
Lamento, mas para mim isso não passa de palavras.	la~'me~.tu, majs 'pa.ra 'mi~ 'i.su 'na~w~ 'pa.sa Di pa'la.vras
E elas não fazem muito sentido. Mack deu de ombros.	i 'E.las 'na~w~ 'fa.ze~j~ 'mu~j~.tu se~'Ti.du, 'mE.ki 'dew Di 'o~.brus
Mesmo que você não consiga finalmente me compreender, sabe de uma coisa?	'mez.mu ki vo'se 'na~w~ ko~'si.ga fi~.naw'me~.Ti mi ko~.pre.e~'deX, 'sa.bi Di u~.ma 'koj.za
Ainda quero ser conhecido.	a'i~.da 'kE.ru 'seX ko~.Je'si.du
Você está falando de Jesus, não é verdade?	vo'se es'ta fa'la~.du Di Ze'zujs, 'na~w~ E veR'da.Di
Está me lembrando as aulas de catecismo: Vamos tentar entender a Trindade?	es'ta mi le~'bra~.du az 'aw.las Di ka.te'siz.mu, 'va~.mus te~'tar e~.te~'der a tri~'da.Di
Ela deu um risinho.	'E.la 'dew u~ Ri'zi~.Ju
Mais ou menos, mas aqui não é a escola dominical.	'majz ow 'me~.nus, majz a'ki 'na~w~ E a es'kO.la do~.mi~.ni'kaw
Por natureza, sou completamente ilimitada, sem amarras.	puR na.tu're.za, 'sow ko~.plE.ta~'me~.Ti i.li~.mi'ta.da, se~j~ a~'ma.Ras
Sempre conheci a plenitude.	'se~.pri ko~.Je'si a ple~.ni'tu.Di
Minha condição normal de existência é um estado de satisfação perpétua, disse ela, bastante satisfeita.	'mi~.Ja ko~.Di'sa~w~ noR'maw Di e.zis'te~.sja E u~ es'ta.du Di sa.Tis.fa'sa~w~ peX'pE.twa, 'Di.si 'E.la, bas'ta~.Ti sa.Tis'fej.ta
É apenas uma das vantagens de Eu ser Eu.	E a'pe~.naz u~.ma das va~'ta.Ze~s Di ew 'ser ew
Isso fez Mack sorrir.	'i.su 'fejz 'mE.ki so'RiX
A mulher estava se divertindo muito com ela mesma e não havia um pingo de arrogância para estragar aquilo.	a mu'LEr es'ta.va si Di.veX'Ti~.du 'mu~j~.tu ko~ 'E.la 'mez.ma i 'na~w~ a'vi.a u~ 'pi~.gu Di a.Ro'ga~.sja 'pa.ra es.tra'gar a'ki.lu
Nós criamos vocês para compartilhar isso.	'nOjs kri'a~.mus vo'sejs 'pa.ra ko~.paX.Ti'Lar 'i.su
Mas então Adão optou por ficar sozinho, como sabíamos que iria acontecer, e tudo se estragou.	majz e~'ta~w~ a'da~w~ op'tow puX fi'kaX sO'zi~.Ju, 'ko~.mu sa'bi.a~.mus ki i'ri.a a.ko~.te'seX, i 'tu.du si es.tra'gow
Foi o que fizemos em Jesus.	'foj u ki fi'ze~.muz e~j~ Ze'zujs
Mack estava parado, esforçando-se ao máximo para acompanhar o fio dos pensamentos dela.	'mE.ki es'ta.va pa'ra.du, es.foX'sa~.du si aw 'ma.si~.mu 'pa.ra a.ko~.pa~'Jar u 'fi.u dus pe~.sa~'me~.tus 'dE.la
Quando nós três penetramos na existência humana sob a forma do Filho de Deus, nos tornamos totalmente humanos.	'kwa~.du 'nOjs 'trejs pe~.ne'tra~.mus na e.zis'te~.sja u~'ma~.na sob a 'fOR.ma du 'fi.Lu Di 'dews, nus toR'na~.mus to.taw'me~.Ti u~'ma~.nus
Mesmo que tenhamos estado sempre presentes nesse universo criado, então nos tornamos carne e sangue.	'mez.mu ki te~'Ja~.muz es'ta.du 'se~.pri pre'ze~.Tis 'ne.si u~.ni'vEX.su kri'a.du, e~'ta~w~ nus toR'na~.mus 'kaR.ni i 'sa~.gi
Seria como se este pássaro, cuja natureza é voar, optasse somente por andar e permanecer no chão.	se'ri.a 'ko~.mu si 'es.Ti 'pa.sa.ru, 'ku.Za na.tu're.za E vo'aX, op'ta.si sO~'me~.Ti pur a~'dar i peR.ma~.ne'seR nu 'Sa~w~
Ele não deixa de ser pássaro, mas isso altera significativamente sua experiência de vida.	'e.li 'na~w~ 'dej.Sa Di 'seX 'pa.sa.ru, majz 'i.su aw'tE.ra si.gi~.ni.fi.ka.Ti.va~'me~.Ti 'su.a es.pe.ri'e~.sja Di 'vi.da
Ela parou para se certificar de que Mack ainda estava acompanhando seu raciocínio.	'E.la pa'row 'pa.ra si seX.Ti.fi'kaR Di ki 'mE.ki a'i~.da es'ta.va a.ko~.pa~'Ja~.du 'sew Ra.si.o'si~.nju
Ainda que por natureza Jesus seja totalmente Deus, ele é totalmente humano e vive como tal.	a'i~.da ki puR na.tu're.za Ze'zujs 'se.Za to.taw'me~.Ti 'dews, 'e.li E to.taw'me~.Ti u~'ma~.nu i 'vi.vi 'ko~.mu 'taw
Ainda que jamais tenha perdido sua capacidade inata de voar, ele opta, momento a momento, por ficar no chão.	a'i~.da ki Za~'majs 'te~.Ja peR'Di.du 'su.a ka.pa.si'da.Di i~'na.ta Di vo'aX, 'e.li 'Op.ta, mo~'me~.tu a mo~'me~.tu, puX fi'kaR nu 'Sa~w~
Por isso seu nome é Emanuel, Deus conosco, ou Deus com vocês, para ser mais exata.	pur 'i.su 'sew 'no~.mi E e~.ma~.nu'Ew, 'dews ko~'nos.ku, ow 'dews ko~ vo'sejs, 'pa.ra 'seR 'majz e'za.ta
Ressuscitar os mortos?	Re.su.si'tar us 'mOX.tus
Isso não prova que Jesus era Deus... você sabe, mais do que humano?	'i.su 'na~w~ 'prO.va ki Ze'zujz 'E.ra 'dews, vo'se 'sa.bi, 'majs du ki u~'ma~.nu
Não, isso prova que Jesus é realmente humano.	'na~w~, 'i.su 'prO.va ki Ze'zujz E Re.aw'me~.Ti u~'ma~.nu
Mackenzie, eu posso voar, mas os humanos, não.	ma'ke~.zi, ew 'pO.su vo'aX, majz uz u~'ma~.nus, 'na~w~
Jesus é totalmente humano.	Ze'zujz E to.taw'me~.Ti u~'ma~.nu
Apesar de ele ser também totalmente Deus, nunca aproveitou sua natureza divina para fazer nada.	a.pe'zaR Di 'e.li 'seX ta~'be~j~ to.taw'me~.Ti 'dews, 'nu~.ka a.pro.vej'tow 'su.a na.tu're.za Di'vi~.na 'pa.ra fa'zeR 'na.da
Apenas viveu seu relacionamento comigo do modo como eu desejo que cada ser humano viva.	a'pe~.nas vi'vew 'sew Re.la.si.o~.na~'me~.tu ko~'mi.gu du 'mO.du 'ko~.mu ew de'ze.Zu ki 'ka.da 'ser u~'ma~.nu 'vi.va
E quando ele curava os cegos?	i 'kwa~.du 'e.li ku'ra.va us 'sE.gus
Fez isso como um ser humano dependente e limitado que confia na minha vida e no meu poder de trabalhar com ele e através dele.	'fejz 'i.su 'ko~.mu u~ 'ser u~'ma~.nu de.pe~'de~.Ti i li~.mi'ta.du ki ko~'fi.a na 'mi~.Ja 'vi.da i nu 'mew po'deR Di tra.ba'LaX ko~ 'e.li i a.tra'vEjs 'de.li
Jesus, como ser humano, não tinha poder para curar ninguém.	Ze'zujs, 'ko~.mu 'ser u~'ma~.nu, 'na~w~ 'Ti~.Ja po'deX 'pa.ra ku'raR ni~'ge~j~
Isso foi um choque para as crenças religiosas de Mack.	'i.su 'foj u~ 'SO.ki 'pa.ra as 'kre~.sas Re.li.Zi'O.zas Di 'mE.ki
Só enquanto ele repousava em seu relacionamento comigo e em nossa comunhão, nossa comum-união, ele se tornava capaz de expressar meu coração e minha vontade em qualquer circunstância determinada.	'sO e~'kwa~.tu 'e.li Re.pow'za.va e~j~ 'sew Re.la.si.o~.na~'me~.tu ko~'mi.gu i e~j~ 'nO.sa ko~.mu~'Ja~w~, 'nO.sa ko~'mu~ u~.ni'a~w~, 'e.li si toR'na.va ka'pajz Di es.pre'saR 'mew ko.ra'sa~w~ i 'mi~.Ja vo~'ta.Di e~j~ kwaw'kEX siX.ku~s'ta~.sja de.teR.mi~'na.da
Mas o que você está realmente vendo sou eu, minha vida nele.	majz u ki vo'se es'ta Re.aw'me~.Ti 've~.du 'sow ew, 'mi~.Ja 'vi.da 'ne.li
É assim que ele vive e age como um verdadeiro ser humano, como cada humano está destinado a viver: a partir da minha vida.	E a'si~ ki 'e.li 'vi.vi i 'a.Zi 'ko~.mu u~ veR.da'dej.ru 'ser u~'ma~.nu, 'ko~.mu 'ka.da u~'ma~.nu es'ta des.Ti~'na.du a vi'veX, a paX'TiR da 'mi~.Ja 'vi.da
E continuou: Um pássaro não é definido por estar preso ao chão, mas por sua capacidade de voar.	i ko~.Ti~.nu'ow, u~ 'pa.sa.ru 'na~w~ E de.fi~'ni.du pur es'taX 'pre.zu aw 'Sa~w~, majs puX 'su.a ka.pa.si'da.Di Di vo'aX
Lembre-se disso: os seres humanos não são definidos por suas limitações, e sim pelas intenções que tenho para eles.	'le~.bri si 'Di.su, us 'se.riz u~'ma~.nus 'na~w~ 'sa~w~ de.fi~'ni.dus puX 'su.as li~.mi.ta'so~j~s, i 'si~ 'pe.laz i~.te~'so~j~s ki 'te~.Ju 'pa.ra 'e.lis
Não pelo que parecem ser, mas por tudo que significa ser criado à minha imagem.	'na~w~ 'pe.lu ki pa'rE.se~j~ 'seX, majs puX 'tu.du ki si.gi~.ni'fi.ka 'seX kri'a.du a 'mi~.Ja i~'ma.Ze~j~
Mack sentiu necessidade de sentar-se.	'mE.ki se~'Tiw ne.se.si'da.Di Di se~'taX si
Papai colocou o pássaro sobre a mesa, perto de Mack, virou-se para abrir o forno e deu uma olhadinha na torta que estava assando.	pa'paj ko.lo'kow u 'pa.sa.ru 'so.bri a 'me.za, 'pEX.tu Di 'mE.ki, vi'row si 'pa.ra a'brir u 'foR.nu i 'dew u~.ma o.La'Di~.Ja na 'tOX.ta ki es'ta.va a'sa~.du
Satisfeita porque tudo ia bem, puxou uma cadeira para perto.	sa.Tis'fej.ta puX'ke 'tu.du 'i.a 'be~j~, pu'Sow u~.ma ka'dej.ra 'pa.ra 'pEX.tu
Mack olhou o pássaro que, espantosamente, parecia contente em apenas ficar ali com eles.	'mE.ki o'Low u 'pa.sa.ru ki, es.pa~.tO.za~'me~.Ti, pa.re'si.a ko~'te~.Ti e~j~ a'pe~.nas fi'kar a'li ko~ 'e.lis
O absurdo daquilo fez Mack dar um risinho.	u ab'suR.du da'ki.lu 'fejz 'mE.ki 'dar u~ Ri'zi~.Ju
Para começar, é bom que você não consiga entender a maravilha da minha natureza.	'pa.ra ko~.me'saX, E 'bo~ ki vo'se 'na~w~ ko~'si.ga e~.te~'der a ma.ra'vi.La da 'mi~.Ja na.tu're.za
Quem quer adorar um Deus que pode ser totalmente compreendido, hein?	'ke~j~ 'kEr a.do'rar u~ 'dews ki 'pO.Di 'seX to.taw'me~.Ti ko~.pre.e~'Di.du, 'e~j~
Não há muito mistério nisso.	'na~w~ 'a 'mu~j~.tu mis'tE.rju 'ni.su
É isso mesmo?	E 'i.su 'mez.mu
É, sim. Ela riu.	E, 'si~, 'E.la 'Riw
Ela parecia estar gostando daquilo.	'E.la pa.re'si.a es'taR gos'ta~.du da'ki.lu
Não somos três deuses e não estamos falando de um deus com três atitudes, como um homem que é marido, pai e trabalhador.	'na~w~ 'so~.mus 'trejs 'dew.ziz i 'na~w~ es'ta~.mus fa'la~.du Di u~ 'dews ko~ 'trejz a.Ti'tu.Dis, 'ko~.mu u~ 'o~.me~j~ ki E ma'ri.du, 'paj i tra.ba.La'doX
Sou um só Deus e sou três pessoas, e cada uma das três é total e inteiramente o um.	'sow 'u~ 'sO 'dewz i 'sow 'trejs pe'so.as, i 'ka.da u~.ma das 'trejz E to'taw i i~.tej.ra~'me~.Ti u 'u~
Não importa, continuou a mulher.	'na~w~ i~'pOX.ta, ko~.Ti~.nu'ow a mu'LEX
O importante é o seguinte: se eu fosse simplesmente Um Deus e Uma Pessoa, você iria se encontrar nesta Criação sem algo maravilhoso, sem algo que é essencial.	u i~.poX'ta~.Ti E u se'gi~.Ti, si ew 'fo.si si~.pliz'me~.Ti 'u~ 'dewz i u~.ma pe'so.a, vo'se i'ri.a si e~.ko~'traR 'nEs.ta kri.a'sa~w~ se~j~ 'aw.gu ma.ra.vi'Lo.zu, se~j~ 'aw.gu ki E e.se~.si'aw
E eu seria absolutamente diferente do que sou.	i ew se'ri.a ab.so.lu.ta~'me~.Ti Di.fe're~.Ti du ki 'sow
Amor e relacionamento.	a~'mor i Re.la.si.o~.na~'me~.tu
O amor não é a limitação.	u a~'moR 'na~w~ E a li~.mi.ta'sa~w~
Como que em resposta à declaração dela, o pássaro partiu voando pela janela.	'ko~.mu ki e~j~ Res'pOs.ta a de.kla.ra'sa~w~ 'dE.la, u 'pa.sa.ru paX'Tiw vo'a~.du 'pe.la Za~'nE.la
olhá lo voando causou um intenso deleite.	o'La lu vo'a~.du kaw'zow u~ i~'te~.su de'lej.Ti
Mack virou-se de volta para Papai e olhou-a maravilhado.	'mE.ki vi'row si Di 'vOw.ta 'pa.ra pa'paj i o'Low a ma.ra.vi'La.du
Ela era muito linda e espantosa e, apesar de estar se sentindo meio perdido e de a Grande Tristeza ainda o acompanhar, percebeu crescendo dentro dele um pouco de segurança por estar perto dela.	'E.la 'E.ra 'mu~j~.tu 'li~.da i es.pa~'tO.za i, a.pe'zaR Di es'taX si se~'Ti~.du 'mej.u peR'Di.du i Di a 'gra~.Di tris'te.za a'i~.da u a.ko~.pa~'JaX, peX.se'bew kre'se~.du 'de~.tru 'de.li u~ 'pow.ku Di se.gu'ra~.sa pur es'taX 'pEX.tu 'dE.la
Entenda o seguinte, continuou Papai.	e~'te~.da u se'gi~.Ti, ko~.Ti~.nu'ow pa'paj
Para que eu tenha um objeto para amar ou, mais exatamente, um alguém para amar, é preciso que exista esse relacionamento dentro de mim.	'pa.ra ki ew 'te~.Ja u~ ob'ZE.tu 'pa.ra a~'mar ow, 'majz e.za.ta~'me~.Ti, u~ aw'ge~j~ 'pa.ra a~'maX, E pre'si.zu ki e'zis.ta 'e.si Re.la.si.o~.na~'me~.tu 'de~.tru Di 'mi~
Caso contrário, eu não seria capaz de amar.	'ka.zu ko~'tra.rju, ew 'na~w~ se'ri.a ka'pajz Di a~'maX
Você teria um deus incapaz de amar.	vo'se te'ri.a u~ 'dewz i~.ka'pajz Di a~'maX
Ou, talvez pior, você teria um deus que, quando escolhesse amar, só poderia fazê-lo como uma limitação de sua natureza.	ow, taw'vejs pi'OX, vo'se te'ri.a u~ 'dews ki, 'kwa~.du es.ko'Le.si a~'maX, 'sO po.de'ri.a fa'ze lu 'ko~.mu u~.ma li~.mi.ta'sa~w~ Di 'su.a na.tu're.za
Esse tipo de deus possívelmente poderia agir sem amor e seria um desastre.	'e.si 'Ti.pu Di 'dews po'si.vew.me~.Ti po.de'ri.a a'ZiX se~j~ a~'mor i se'ri.a u~ de'zas.tri
E isso certamente não sou eu.	i 'i.su sEX.ta~'me~.Ti 'na~w~ 'sow ew
Papai se levantou, foi até a porta do forno, tirou a torta recém-assada, colocou-a na bancada e, virando-se como se fosse se apresentar, disse: O Deus que é, o eu sou quem eu sou, não pode agir fora do amor!	pa'paj si le.va~'tow, 'foj a'tE a 'pOX.ta du 'foR.nu, Ti'row a 'tOX.ta Re'se~j~ a'sa.da, ko.lo'kow a na ba~'ka.da i, vi'ra~.du si 'ko~.mu si 'fo.si si a.pre.ze~'taX, 'Di.si, u 'dews ki E, u ew 'sow 'ke~j~ ew 'sow, 'na~w~ 'pO.Di a'ZiX 'fO.ra du a~'moX
Mack soube que, por mais difícil de entender que fosse, o que estava escutando era algo espantoso e incrível.	'mE.ki 'sow.bi ki, puR 'majs Di'fi.siw Di e~.te~'deX ki 'fo.si, u ki es'ta.va es.ku'ta~.du 'E.ra 'aw.gu es.pa~'to.zu i i~'kri.vew
Como se as palavras dela estivessem se enrolando nele, envolvendo-o e falando com ele de maneiras que iam além do que ele poderia ouvir.	'ko~.mu si as pa'la.vras 'dE.la es.Ti'vE.se~j~ si e~.Ro'la~.du 'ne.li, e~.vow've~.du u i fa'la~.du ko~ 'e.li Di ma~'nej.ras ki 'i.a~w~ a'le~j~ du ki 'e.li po.de'ri.a ow'viX
Não que acreditasse de fato em nada daquilo.	'na~w~ ki a.kre.Di'ta.si Di 'fa.tu e~j~ 'na.da da'ki.lu
Se ao menos fosse verdade!	si aw 'me~.nus 'fo.si veR'da.Di
Sua experiência lhe dizia o contrário.	'su.a es.pe.ri'e~.sja Li Di'zi.a u ko~'tra.rju
Este fim de semana tem a ver com relacionamento e amor.	'es.Ti 'fi~ Di se~'ma~.na te~j~ a 'veX ko~ Re.la.si.o~.na~'me~.tu i a~'moX
Bom, eu sei que você tem um monte de coisas para me dizer, mas neste momento é melhor ir se lavar.	'bo~, ew 'sej ki vo'se te~j~ u~ 'mo~.Ti Di 'koj.zas 'pa.ra mi Di'zeX, majs 'nes.Ti mo~'me~.tu E me'LOr 'iX si la'vaX
Os outros dois estão vindo para o jantar. Ela foi andando, mas parou e virou-se.	uz 'ow.trus 'dojz es'ta~w~ 'vi~.du 'pa.ra u Za~'taX, 'E.la 'foj a~'da~.du, majs pa'row i vi'row si
Mackenzie, sei que seu coração está cheio de dor, de raiva e de muita confusão.	ma'ke~.zi, 'sej ki 'sew ko.ra'sa~w~ es'ta 'Sej.u Di 'doX, Di 'Raj.va i Di 'mu~j~.ta ko~.fu'za~w~
Nós dois vamos falar um pouco disso enquanto você estiver aqui.	'nOjs 'dojs 'va~.mus fa'lar u~ 'pow.ku 'Di.su e~'kwa~.tu vo'se es.Ti'vEr a'ki
Mas também quero que saiba que estão acontecendo mais coisas do que você pode imaginar ou entender.	majs ta~'be~j~ 'kE.ru ki 'saj.ba ki es'ta~w~ a.ko~.te'se~.du 'majs 'koj.zas du ki vo'se 'pO.Di i~.ma.Zi~'nar ow e~.te~'deX
Procure usar ao máximo a confiança que tiver em mim, mesmo que ela seja pequena, está bem?	pro'ku.ri u'zar aw 'ma.si~.mu a ko~.fi'a~.sa ki Ti'vEr e~j~ 'mi~, 'mez.mu ki 'E.la 'se.Za pe'ke~.na, es'ta 'be~j~
Mack baixara a cabeça e olhava para o chão.	'mE.ki baj'Sa.ra a ka'be.sa i o'La.va 'pa.ra u 'Sa~w~
Ela sabe, pensou.	'E.la 'sa.bi, pe~'sow
Pequena ou praticamente nada?	pe'ke~.na ow pra.Ti.ka~'me~.Ti 'na.da
Confirmando com a cabeça, olhou para cima e notou novamente as cicatrizes nos pulsos dela.	ko~.fiR'ma~.du ko~ a ka'be.sa, o'Low 'pa.ra 'si~.ma i no'tow nO.va~'me~.Ti as si.ka'tri.zis nus 'puw.sus 'dE.la
Papai? disse Mack muito sem jeito.	pa'paj, 'Di.si 'mE.ki 'mu~j~.tu se~j~ 'Zej.tu
O que é, querido?	u ki E, ke'ri.du
Mack lutou para encontrar as palavras que expressassem o que lhe ia no coração.	'mE.ki lu'tow 'pa.ra e~.ko~'trar as pa'la.vras ki es.pre'sa.se~j~ u ki Li 'i.a nu ko.ra'sa~w~
Lamento muito que você, que Jesus tivesse de morrer.	la~'me~.tu 'mu~j~.tu ki vo'se, ki Ze'zujs Ti'vE.si Di mo'ReX
Ela rodeou a mesa e deu outro grande abraço em Mack.	'E.la Ro.de'ow a 'me.za i 'dew 'ow.tru 'gra~.Di a'bra.su e~j~ 'mE.ki
Sei que lamenta e agradeço.	'sej ki la~'me~.ta i a.gra'de.su
Mas você precisa saber que nós não lamentamos nem um pouco.	majs vo'se pre'si.za sa'beX ki 'nOjs 'na~w~ la~.me~'ta~.mus ne~j~ u~ 'pow.ku
Valeu a pena.	va'lew a 'pe~.na
Não é, filho?	'na~w~ E, 'fi.Lu
Ela se virou para fazer a pergunta a Jesus, que havia acabado de entrar no chalé.	'E.la si vi'row 'pa.ra fa'zer a peR'gu~.ta a Ze'zujs, ki a'vi.a a.ka'ba.du Di e~'traR nu Sa'lE
Sem dúvida! Ele fez uma pausa e depois olhou para Mack.	se~j~ 'du.vi.da, 'e.li 'fejz u~.ma 'paw.za i de'pojz o'Low 'pa.ra 'mE.ki
E eu teria feito aquilo mesmo que fosse somente por você.	i ew te'ri.a 'fej.tu a'ki.lu 'mez.mu ki 'fo.si sO~'me~.Ti puR vo'se
Mas não foi! disse com um sorriso acolhedor.	majs 'na~w~ 'foj, 'Di.si ko~ u~ so'Ri.zu a.ko.Le'doX
Mack pediu licença e saiu em direção ao banheiro.	'mE.ki pe'Diw li'se~.sa i sa'iw e~j~ Di.re'sa~w~ aw ba~'Jej.ru
Lavou as mãos e o rosto e tentou recuperar a compostura.	la'vow as 'ma~w~z i u 'Ros.tu i te~'tow Re.ku.pe'rar a ko~.pos'tu.ra
Oremos para que a raça humana jamais escape da Terra para espalhar sua iniquidade em outros lugares.	o're~.mus 'pa.ra ki a 'Ra.sa u~'ma~.na Za~'majz es'ka.pi da 'tE.Ra 'pa.ra es.pa'LaX 'su.a i~.ni.kwi'da.Di e~j~ 'ow.trus lu'ga.ris
Mack ficou parado no banheiro olhando o espelho enquanto enxugava o rosto com uma toalha.	'mE.ki fi'kow pa'ra.du nu ba~'Jej.ru o'La~.du u es'pe.Lu e~'kwa~.tu e~.Su'ga.va u 'Ros.tu ko~ u~.ma to'a.La
Procurava algum sinal de insanidade naqueles olhos que o espiavam de volta.	pro.ku'ra.va aw'gu~ si~'naw Di i~.sa~.ni'da.Di na'ke.liz 'O.Lus ki u es.pi'a.va~w~ Di 'vOw.ta
Aquilo seria real?	a'ki.lu se'ri.a Re'aw
Claro que não, era impossível.	'kla.ru ki 'na~w~, 'E.ra i~.po'si.vew
Talvez fosse uma alucinação trazida por todo o seu sofrimento e desespero.	taw'vejs 'fo.si u~.ma a.lu.si~.na'sa~w~ tra'zi.da puX 'to.du u 'sew so.fri~'me~.tu i de.zes'pe.ru
Talvez fosse um sonho e ele estivesse dormindo em algum lugar, quem sabe na cabana, morrendo congelado.	taw'vejs 'fo.si u~ 'so~.Ju i 'e.li es.Ti'vE.si doR'mi~.du e~j~ aw'gu~ lu'gaX, 'ke~j~ 'sa.bi na ka'ba~.na, mo'Re~.du ko~.Ze'la.du
Vinha da direção da cozinha e deixou Mack paralisado.	'vi~.Ja da Di.re'sa~w~ da ko'zi~.Ja i dej'Sow 'mE.ki pa.ra.li'za.du
Por um momento houve um silêncio mortal e depois, inesperadamente, gargalhadas retumbantes.	pur u~ mo~'me~.tu 'ow.vi u~ si'le~.sju moX'taw i de'pojs, i~.nes.pe.ra.da~'me~.Ti, gaR.ga'La.das Re.tu~'ba~.Tis
Curioso, saiu do banheiro e enfiou a cabeça pela porta da cozinha.	ku.ri'o.zu, sa'iw du ba~'Jej.ru i e~.fi'ow a ka'be.sa 'pe.la 'pOX.ta da ko'zi~.Ja
Mack ficou chocado diante da cena.	'mE.ki fi'kow So'ka.du Di'a~.Ti da 'se~.na
A barra da saia de Papai e seus pés descalços estavam cobertos pela massa gosmenta.	a 'ba.Ra da 'saj.a Di pa'paj i 'sews 'pEjs des'kaw.suz es'ta.va~w~ ko'bEX.tus 'pe.la 'ma.sa goz'me~.ta
Sarayu disse alguma coisa sobre a falta de jeito dos humanos e os três caíram na risada.	sa.ra'ju 'Di.si aw'gu~.ma 'koj.za 'so.bri a 'faw.ta Di 'Zej.tu duz u~'ma~.nuz i us 'trejs ka'i.ra~w~ na Ri'za.da
Por fim, Jesus passou por Mack e voltou com toalhas e uma grande bacia de água.	puX 'fi~, Ze'zujs pa'sow puR 'mE.ki i vow'tow ko~ to'a.Laz i u~.ma 'gra~.Di ba'si.a Di 'a.gwa
Sarayu já estava começando a limpar a sujeira do chão e dos armários, mas Jesus foi direto até Papai e, ajoelhando-se aos pés dela, começou a limpar a frente de seu vestido.	sa.ra'ju 'Za es'ta.va ko~.me'sa~.du a li~'par a su'Zej.ra du 'Sa~w~ i duz aR'ma.rjus, ma.Ze'zujs 'foj Di'rE.tu a'tE pa'paj i, a.Zo.e'La~.du si aws 'pEjs 'dE.la, ko~.me'sow a li~'par a 'fre~.Ti Di 'sew ves'Ti.du
Gentilmente levantou um pé de cada vez e colocou os dois na bacia, onde os limpou e massageou.	Ze~.Tiw'me~.Ti le.va~'tow 'u~ 'pE Di 'ka.da 'vejz i ko.lo'kow us 'dojs na ba'si.a, 'o~.Di us li~'pow i ma.sa.Ze'ow
Uuuuuh, isso é tão bom! exclamou Papai.	'uuuuu, 'i.su E 'ta~w~ 'bo~, es.kla~'mow pa'paj
Encostado no portal, Mack não parava de pensar.	e~.kos'ta.du nu poX'taw, 'mE.ki 'na~w~ pa'ra.va Di pe~'saX
Então Deus era assim no relacionamento?	e~'ta~w~ 'dewz 'E.ra a'si~ nu Re.la.si.o~.na~'me~.tu
Muito linda e atraente!	'mu~j~.tu 'li~.da i a.tra'e~.Ti
Ele sabia que ninguém estava em busca do culpado pela sujeira do chão, pela tigela quebrada ou por um prato que não seria compartilhado.	'e.li sa'bi.a ki ni~'ge~j~ es'ta.va e~j~ 'bus.ka du kuw'pa.du 'pe.la su'Zej.ra du 'Sa~w~, 'pe.la Ti'ZE.la ke'bra.da ow pur u~ 'pra.tu ki 'na~w~ se'ri.a ko~.paX.Ti'La.du
Era óbvio que o que realmente importava era o amor que eles sentiam uns pelos outros e a plenitude que esse amor lhes trazia.	'E.ra 'Ob.vju ki u ki Re.aw'me~.Ti i~.poX'ta.va 'E.ra u a~'moX ki 'e.lis se~'Ti.a~w~ u~s 'pe.luz 'ow.truz i a ple~.ni'tu.Di ki 'e.si a~'moR Lis tra'zi.a
Balançou a cabeça.	ba.la~'sow a ka'be.sa
Como isso era diferente da maneira como ele tratava seus entes queridos!	'ko~.mu 'i.su 'E.ra Di.fe're~.Ti da ma~'nej.ra 'ko~.mu 'e.li tra'ta.va 'sewz 'e~.Tis ke'ri.dus
Embora simples, o jantar foi um banquete.	e~'bO.ra 'si~.plis, u Za~'taX 'foj u~ ba~'ke.Ti
Algum tipo de ave assada com uma espécie de molho de laranja, manga e alguma outra coisa, verduras frescas temperadas com sabe-se lá o quê, com gosto de fruta e de gengibre, e arroz de uma qualidade que Mack jamais havia provado.	aw'gu~ 'Ti.pu Di 'a.vi a'sa.da ko~ u~.ma es'pE.si Di 'mo.Lu Di la'ra~.Za, 'ma~.ga i aw'gu~.ma 'ow.tra 'koj.za, veR'du.ras 'fres.kas te~.pe'ra.das ko~ 'sa.bi si 'la u 'ke, ko~ 'gos.tu Di 'fru.ta i Di Ze~'Zi.bri, i a'Rojz Di u~.ma kwa.li'da.Di ki 'mE.ki Za~'majz a'vi.a pro'va.du
Por hábito, abaixou a cabeça para orar.	pur 'a.bi.tu, a.baj'Sow a ka'be.sa 'pa.ra o'raX
Levantou-a e viu os três rindo para ele.	le.va~'tow a i 'viw us 'trejs 'Ri~.du 'pa.ra 'e.li
Claro. Nós íamos ter um molho japonês incrível, mas o sem-jeito ali, Papai acenou na direção de Jesus, decidiu ver se a tigela quicava.	'kla.ru, 'nOjz 'i.a~.mus 'ter u~ 'mo.Lu Za.po~'nejz i~'kri.vew, majz u se~j~ 'Zej.tu a'li, pa'paj a.se~'now na Di.re'sa~w~ Di Ze'zujs, de.si'Diw 'veX si a Ti'ZE.la ki'ka.va
Ah, qual é? respondeu Jesus num arremedo de defesa.	'a, 'kwaw E, Res.po~'dew Ze'zujs nu~ a.Re~'me.du Di de'fe.za
Minhas mãos estavam escorregadias.	'mi~.Jas 'ma~w~z es'ta.va~w~ es.ko.Re.ga'Di.as
Papai piscou para Mack enquanto lhe passava o arroz.	pa'paj pis'kow 'pa.ra 'mE.ki e~'kwa~.tu Li pa'sa.va u a'Rojs
Não se consegue bons empregados por aqui.	'na~w~ si ko~'sE.gi 'bo~z e~.pre'ga.dus pur a'ki
Todo mundo riu.	'to.du 'mu~.du 'Riw
A conversa parecia quase normal.	a ko~'vEX.sa pa.re'si.a 'kwa.zi noR'maw
Pediram que Mack falasse de cada um dos filhos, menos de Missy, e ele contou das várias lutas e conquistas deles.	pe'Di.ra~w~ ki 'mE.ki fa'la.si Di 'ka.da 'u~ dus 'fi.Lus, 'me~.nus Di 'mi.si, i 'e.li ko~'tow das 'va.rjas 'lu.taz i ko~'kis.tas 'de.lis
Quando falou de suas preocupações com Kate, os três apenas assentiram com uma expressão solidária, mas não ofereceram nenhum conselho.	'kwa~.du fa'low Di 'su.as prew.ku.pa'so~j~s ko~ 'kej.Ti, us 'trejz a'pe~.naz a.se~'Ti.ra~w~ ko~ u~.ma es.pre'sa~w~ so.li'da.rja, majs 'na~w~ o.fe.re'se.ra~w~ ne~'Ju~ ko~'se.Lu
Ele também respondeu a perguntas sobre os amigos, e Sarayu pareceu mais interessada em perguntar por Nan.	'e.li ta~'be~j~ Res.po~'dew a peR'gu~.tas 'so.bri uz a~'mi.gus, i sa.ra'ju pa.re'sew 'majz i~.te.re'sa.da e~j~ peR.gu~'taX puR 'na~
Bom, estou aqui falando sobre meus filhos, meus amigos e sobre Nan, mas vocês já sabem tudo o que vou dizer, não é?	'bo~, es'tow a'ki fa'la~.du 'so.bri 'mews 'fi.Lus, 'mewz a~'mi.guz i 'so.bri 'na~, majs vo'sej'Za 'sa.be~j~ 'tu.du u ki 'vow Di'zeX, 'na~w~ E
Vocês estão agindo como se ouvissem pela primeira vez.	vo'sejz es'ta~w~ a'Zi~.du 'ko~.mu si ow'vi.se~j~ 'pe.la pri~'mej.ra 'vejs
Sarayu estendeu a mão por cima da mesa e segurou a dele.	sa.ra'ju es.te~'dew a 'ma~w~ puX 'si~.ma da 'me.za i se.gu'row a 'de.li
Mackenzie, lembra-se da nossa conversa anterior sobre limitação?	ma'ke~.zi, 'le~.bra si da 'nO.sa ko~'vEX.sa a~.te.ri'oX 'so.bri li~.mi.ta'sa~w~
Nossa conversa? Ele olhou para Papai, que assentiu como quem sabe das coisas.	'nO.sa ko~'vEX.sa, 'e.li o'Low 'pa.ra pa'paj, ki a.se~'Tiw 'ko~.mu 'ke~j~ 'sa.bi das 'koj.zas
Você não pode compartilhar com um de nós sem que compartilhe com todos, disse Sarayu e sorriu.	vo'se 'na~w~ 'pO.Di ko~.paX.Ti'LaX ko~ 'u~ Di 'nOjs se~j~ ki ko~.paX'Ti.Li ko~ 'to.dus, 'Di.si sa.ra'ju i so'Riw
Lembre-se das muitas vezes em que escolheu sentar no chão para facilitar um relacionamento, para honrá-lo.	'le~.bri si das 'mu~j~.tas 've.ziz e~j~ ki es.ko'Lew se~'taR nu 'Sa~w~ 'pa.ra fa.si.li'tar u~ Re.la.si.o~.na~'me~.tu, 'pa.ra o~'Ra lu
Mackenzie, você faz isso frequentemente.	ma'ke~.zi, vo'se 'fajz 'i.su fre.kwe~.Ti~'me~.Ti
Você não brinca com uma criança ou colore uma figura com ela para mostrar sua superioridade.	vo'se 'na~w~ 'bri~.ka ko~ u~.ma kri'a~.sa ow ko'lO.ri u~.ma fi'gu.ra ko~ 'E.la 'pa.ra mos'traX 'su.a su.pe.ri.o.ri'da.Di
Pelo contrário, você escolhe se limitar para facilitar e honrar o relacionamento.	'pe.lu ko~'tra.rju, vo'se es'kO.Li si li~.mi'taX 'pa.ra fa.si.li'tar i o~'Rar u Re.la.si.o~.na~'me~.tu
Você é até capaz de perder uma competição como um ato de amor.	vo'se E a'tE ka'pajz Di peR'der u~.ma ko~.pe.Ti'sa~w~ 'ko~.mu u~ 'a.tu Di a~'moX
Isso não tem nada a ver com ganhar e perder, e sim com amor e respeito.	'i.su 'na~w~ te~j~ 'na.da a 'veX ko~ ga~'Jar i peR'deX, i 'si~ ko~ a~'mor i Res'pej.tu
Então o que acontece quando estou falando com vocês sobre meus filhos?	e~'ta~w~ u ki a.ko~'tE.si 'kwa~.du es'tow fa'la~.du ko~ vo'sejs 'so.bri 'mews 'fi.Lus
Nós nos limitamos por respeito a você.	'nOjs nus li~.mi'ta~.mus pu.Res'pej.tu a vo'se
Não estamos trazendo à mente, por assim dizer, nosso conhecimento sobre seus filhos.	'na~w~ es'ta~.mus tra'ze~.du a 'me~.Ti, pur a'si~ Di'zeX, 'nO.su ko~.Je.si~'me~.tu 'so.bri 'sews 'fi.Lus
Ouvimos como se fosse a primeira vez e temos enorme prazer em conhecê-los através dos seus olhos.	ow'vi~.mus 'ko~.mu si 'fo.si a pri~'mej.ra 'vejz i 'te~.muz e~'nOR.mi pra'zer e~j~ ko~.Je'se luz a.tra'vEjs dus 'sewz 'O.Lus
Gosto disso, refletiu Mack, recostando-se na cadeira.	'gOs.tu 'Di.su, Re.fle'Tiw 'mE.ki, Re.kos'ta~.du si na ka'dej.ra
Sarayu apertou a mão dele e pareceu se recostar.	sa.ra'ju a.peX'tow a 'ma~w~ 'de.li i pa.re'sew si Re.kos'taX
Eu também!	ew ta~'be~j~
Os relacionamentos não têm nada a ver com poder. Nunca!	us Re.la.si.o~.na~'me~.tus 'na~w~ 'te~j~ 'na.da a 'veX ko~ po'deX, 'nu~.ka
E um modo de evitar a vontade de exercer poder é escolher se limitar e servir.	i u~ 'mO.du Di e.vi'tar a vo~'ta.Di Di e.zeX'seX po'der E es.ko'LeX si li~.mi'tar i seR'viX
Os humanos costumam fazer isso quando cuidam dos enfermos, quando servem os idosos, quando se relacionam com os pobres, quando amam os muito velhos e os muito novos, ou até mesmo quando se importam com aqueles que assumiram uma posição de poder sobre eles.	uz u~'ma~.nus kos'tu~.ma~w~ fa'zer 'i.su 'kwa~.du 'kuj.da~w~ duz e~'feR.mus, 'kwa~.du 'sER.ve~j~ uz i'dO.zus, 'kwa~.du si Re.la.si'o~.na~w~ ko~ us 'pO.bris, 'kwa~.du 'a~.ma~w~ us 'mu~j~.tu 'vE.Luz i us 'mu~j~.tu 'nO.vus, ow a'tE 'mez.mu 'kwa~.du si i~'pOX.ta~w~ ko~ a'ke.lis ki a.su~'mi.ra~w~ u~.ma po.zi'sa~w~ Di po'deX 'so.bri 'e.lis
Bem falado, Sarayu, disse Papai, com o rosto luzindo de orgulho.	'be~j~ fa'la.du, sa.ra'ju, 'Di.si pa'paj, ko~ u 'Ros.tu lu'zi~.du Di oR'gu.Lu
Eu cuido dos pratos depois. Mas primeiro gostaria de ter um tempo para as devoções.	ew 'kuj.du dus 'pra.tus de'pojs, majs pri~'mej.ru gos.ta'ri.a Di 'ter u~ 'te~.pu 'pa.ra as de.vo'so~j~s
Mack teve de conter um risinho diante da idéia de Deus fazendo orações.	'mE.ki 'te.vi Di ko~'ter u~ Ri'zi~.Ju Di'a~.Ti da i'dEj.a Di 'dews fa'ze~.du o.ra'so~j~s
Imagens de devoções familiares de sua infância vieram se derramar em seu pensamento.	i~'ma.Ze~s Di de.vo'so~j~s fa~.mi.li'a.ris Di 'su.a i~'fa~.sja vi'E.ra~w~ si de.Ra~'mar e~j~ 'sew pe~.sa~'me~.tu
E não eram exatamente boas lembranças.	i 'na~w~ 'E.ra~w~ e.za.ta~'me~.Ti 'bo.as le~'bra~.sas
Com frequência consistiam em um exercício tedioso de dar as respostas certas, ou melhor, as mesmas velhas respostas às mesmas velhas perguntas sobre histórias da Bíblia e depois tentar ficar acordado durante as orações exaustivamente longas de seu pai.	ko~ fre'kwe~.sja ko~.sis'Ti.a~w~ e~j~ u~ e.zeX'si.sju te.Di'o.zu Di 'dar as Res'pOs.tas 'sEX.tas, ow me'LOX, as 'mez.mas 'vE.Las Res'pOs.taz as 'mez.mas 'vE.Las peR'gu~.tas 'so.bri is'tO.rjas da 'bi.blja i de'pojs te~'taX fi'kar a.koR'da.du du'ra~.Ti az o.ra'so~j~z e.zaws.Ti.va~'me~.Ti 'lo~.gas Di 'sew 'paj
E, quando o pai tinha bebido, as orações da família sempre se tornavam um terrível campo minado, em que qualquer resposta errada ou um olhar distraído provocava uma explosão.	i, 'kwa~.du u 'paj 'Ti~.Ja be'bi.du, az o.ra'so~j~s da fa~'mi.lja 'se~.pri si toR'na.va~w~ u~ te'Ri.vew 'ka~.pu mi~'na.du, e~j~ ki kwaw'kE.Res'pOs.ta e'Ra.da ow u~ o'LaR Dis.tra'i.du pro.vo'ka.va u~.ma es.plo'za~w~
Ficou esperando que Jesus pegasse uma velha versão da Bíblia.	fi'kow es.pe'ra~.du ki Ze'zujs pe'ga.si u~.ma 'vE.La veX'sa~w~ da 'bi.blja
Em vez disso, Jesus estendeu as mãos sobre a mesa e segurou as de Papai, com as cicatrizes agora claramente visíveis.	e~j~ 'vejz 'Di.su, Ze'zujz es.te~'dew as 'ma~w~s 'so.bri a 'me.za i se.gu'row as Di pa'paj, ko~ as si.ka'tri.ziz a'gO.ra kla.ra~'me~.Ti vi'zi.vejs
Mack ficou sentado, em extremo fascínio, vendo Jesus beijar as mãos do Pai, depois olhar fundo nos seus olhos e finalmente dizer: Papai, adorei ver como hoje você se tornou completamente disponível para assumir a dor de Mack e deixar que ele escolhesse seu próprio ritmo.	'mE.ki fi'kow se~'ta.du, e~j~ es'tre~.mu fa'si~.nju, 've~.du Ze'zujs bej'Zar as 'ma~w~s du 'paj, de'pojz o'LaX 'fu~.du nus 'sewz 'O.Luz i fi~.naw'me~.Ti Di'zeX, pa'paj, a.do'rej 'veX 'ko~.mu 'o.Zi vo'se si toR'now ko~.plE.ta~'me~.Ti Dis.po~'ni.vew 'pa.ra a.su~'mir a 'doR Di 'mE.ki i dej'SaX ki 'e.li es.ko'Le.si 'sew 'prO.prju 'Ri.Ti~.mu
Você o honrou e me honrou.	vo'se u o~'Row i mi o~'Row
Ouvir você sussurrar amor e calma no coração dele foi realmente incrível.	ow'viR vo'se su.su'Rar a~'mor i 'kaw.ma nu ko.ra'sa~w~ 'de.li 'foj Re.aw'me~.Ti i~'kri.vew
Que alegria imensa ver isso!	ki a.le'gri.a i~'me~.sa 'ver 'i.su
Adoro ser seu filho.	a'dO.ru 'seX 'sew 'fi.Lu
Embora Mack se sentisse um intruso, ninguém pareceu se preocupar e, de qualquer modo, ele não tinha idéia de para onde ir.	e~'bO.ra 'mE.ki si se~'Ti.si u~ i~'tru.zu, ni~'ge~j~ pa.re'sew si prew.ku'par i, Di kwaw'kER 'mO.du, 'e.li 'na~w~ 'Ti~.Ja i'dEj.a Di 'pa.ra 'o~.Di 'iX
Presenciar a expressão de tamanho amor parecia deslocar qualquer entrave lógico e, ainda que ele não soubesse exatamente o que sentia, era muito bom.	pre.ze~.si'ar a es.pre'sa~w~ Di ta~'ma~.Ju a~'moX pa.re'si.a dez.lo'kaX kwaw'kEr e~'tra.vi 'lO.Zi.ku i, a'i~.da ki 'e.li 'na~w~ sow'bE.si e.za.ta~'me~.Ti u ki se~'Ti.a, 'E.ra 'mu~j~.tu 'bo~
Estava testemunhando algo simples, caloroso, íntimo e verdadeiro.	es'ta.va tes.te~.mu~'Ja~.du 'aw.gu 'si~.plis, ka.lo'ro.zu, 'i~.Ti~.mu i veR.da'dej.ru
Isso era sagrado.	'i.su 'E.ra sa'gra.du
A santidade sempre fora um conceito frio e estéril para Mack, mas isso era diferente.	a sa~.Ti'da.Di 'se~.pri 'fo.ra u~ ko~'sej.tu 'fri.u i es'tE.riw 'pa.ra 'mE.ki, majz 'i.su 'E.ra Di.fe're~.Ti
Preocupado em não fazer qualquer gesto que perturbasse aquele momento, simplesmente fechou os olhos e cruzou as mãos.	prew.ku'pa.du e~j~ 'na~w~ fa'zeX kwaw'kER 'ZEs.tu ki peX.tuR'ba.si a'ke.li mo~'me~.tu, si~.pliz'me~.Ti fe'Sow uz 'O.Luz i kru'zow as 'ma~w~s
Ouvindo atentamente de olhos fechados, sentiu Jesus mexer a cadeira.	ow'vi~.du a.te~.ta~'me~.Ti Di 'O.Lus fe'Sa.dus, se~'Tiw Ze'zujs me'Ser a ka'dej.ra
Houve uma pausa antes que ele falasse de novo: Sarayu, começou Jesus com suavidade e ternura, você lava, eu enxugo.	'ow.vi u~.ma 'paw.za 'a~.Tis ki 'e.li fa'la.si Di 'no.vu, sa.ra'ju, ko~.me'sow Ze'zujs ko~ su.a.vi'da.Di i teR'nu.ra, vo'se 'la.va, ew e~'Su.gu
Ficou sentado alguns minutos sem saber o que fazer.	fi'kow se~'ta.du aw'gu~s mi~'nu.tus se~j~ sa'ber u ki fa'zeX
Papai tinha ido a algum lugar e os outros dois estavam ocupados com os pratos.	pa'paj 'Ti~.Ja 'i.du a aw'gu~ lu'gar i uz 'ow.trus 'dojz es'ta.va~w~ o.ku'pa.dus ko~ us 'pra.tus
A decisão foi fácil.	a de.si'za~w~ 'foj 'fa.siw
Pegou os talheres e os copos e levou-os para a cozinha.	pe'gow us ta'LE.riz i us 'kO.puz i le'vow us 'pa.ra a ko'zi~.Ja
Assim que entrou, Jesus lhe jogou um pano e, enquanto Sarayu lavava os pratos, os dois começaram a enxugar.	a'si~ ki e~'trow, Ze'zujs Li Zo'gow u~ 'pa~.nu i, e~'kwa~.tu sa.ra'ju la'va.va us 'pra.tus, us 'dojs ko~.me'sa.ra~w~ a e~.Su'gaX
Sarayu começou a cantarolar uma música evocativa que ele havia escutado Papai cantar.	sa.ra'ju ko~.me'sow a ka~.ta.ro'lar u~.ma 'mu.zi.ka e.vo.ka'Ti.va ki 'e.li a'vi.a es.ku'ta.du pa'paj ka~'taX
Mais uma vez a melodia mexeu no fundo de Mack, despertando lembranças e emoções.	'majz u~.ma 'vejz a me.lo'Di.a me'Sew nu 'fu~.du Di 'mE.ki, des.peX'ta~.du le~'bra~.saz i e~.mo'so~j~s
Se pudesse permanecer ouvindo aquela canção, aceitaria ficar enxugando os pratos pelo resto da vida.	si pu'dE.si peR.ma~.ne'ser ow'vi~.du a'kE.la ka~'sa~w~, a.sej.ta'ri.a fi'kar e~.Su'ga~.du us 'pra.tus 'pe.lu 'REs.tu da 'vi.da
Cerca de 10 minutos depois haviam acabado.	'seX.ka Di 'dEjz mi~'nu.tus de'pojz a'vi.a~w~ a.ka'ba.du
Jesus deu um beijo no rosto de Sarayu e ela desapareceu no corredor.	Ze'zujs 'dew u~ 'bej.Zu nu 'Ros.tu Di sa.ra'ju i 'E.la de.za.pa.re'sew nu ko.Re'doX
Em seguida ele sorriu para Mack.	e~j~ se'gi.da 'e.li so'Riw 'pa.ra 'mE.ki
Vamos ao cais olhar as estrelas.	'va~.muz aw 'kajz o'Lar az es'tre.las
E os outros? perguntou Mack.	i uz 'ow.trus, peR.gu~'tow 'mE.ki
Estou aqui, respondeu Jesus. Sempre estou aqui.	es'tow a'ki, Res.po~'dew Ze'zujs, 'se~.pri es'tow a'ki
Mack assentiu.	'mE.ki a.se~'Tiw
Esse negócio da presença de Deus, embora difícil de entender, parecia estar penetrando constantemente em sua mente e em seu coração.	'e.si ne'gO.sju da pre'ze~.sa Di 'dews, e~'bO.ra Di'fi.siw Di e~.te~'deX, pa.re'si.a es'taX pe~.ne'tra~.du ko~s.ta~.Ti~'me~.Ti e~j~ 'su.a 'me~.Ti i e~j~ 'sew ko.ra'sa~w~
Por isso relaxou.	pur 'i.su Re.la'Sow
Vamos, disse Jesus, interrompendo seus pensamentos.	'va~.mus, 'Di.si Ze'zujs, i~.te.Ro~'pe~.du 'sews pe~.sa~'me~.tus
Sei que você gosta de olhar as estrelas! Parecia uma criança cheia de ansiedade e expectativa.	'sej ki vo'se 'gOs.ta Di o'Lar az es'tre.las, pa.re'si.a u~.ma kri'a~.sa 'Sej.a Di a~.si.e'da.Di i es.pek.ta'Ti.va
É, acho que gosto, respondeu Mack, percebendo que a última vez em que fizera isso fora na maldita viagem com as crianças.	E, 'a.Su ki 'gOs.tu, Res.po~'dew 'mE.ki, peX.se'be~.du ki a 'uw.Ti~.ma 'vejz e~j~ ki fi'zE.ra 'i.su 'fo.ra na maw'Di.ta vi'a.Ze~j~ ko~ as kri'a~.sas
Talvez tivesse chegado a hora de correr alguns riscos.	taw'vejs Ti'vE.si Se'ga.du a 'O.ra Di ko'Rer aw'gu~s 'Ris.kus
Seguiu Jesus, saindo pela porta dos fundos.	se'giw Ze'zujs, sa'i~.du 'pe.la 'pOX.ta dus 'fu~.dus
Nos momentos finais do crepúsculo, Mack podia ver a margem rochosa do lago, não cheia de mato alto como ele recordava, mas lindamente cuidada e perfeita como uma pintura.	nus mo~'me~.tus fi~'najs du kre'pus.ku.lu, 'mE.ki po'Di.a 'ver a 'maR.Ze~j~ Ro'SO.za du 'la.gu, 'na~w~ 'Sej.a Di 'ma.tu 'aw.tu 'ko~.mu 'e.li Re.koR'da.va, majs li~.da~'me~.Ti kuj'da.da i peX'fej.ta 'ko~.mu u~.ma pi~'tu.ra
O riacho ali perto parecia cantarolar algum tipo de música.	u Ri'a.Su a'li 'pEX.tu pa.re'si.a ka~.ta.ro'lar aw'gu~ 'Ti.pu Di 'mu.zi.ka
Projetando-se cerca de 15 metros sobre o lago havia um cais e Mack mal conseguiu vislumbrar três canoas amarradas nele.	pro.Ze'ta~.du si 'seX.ka Di 'ki~.zi 'mE.trus 'so.bri u 'la.gu a'vi.a u~ 'kajz i 'mE.ki 'maw ko~.se'giw viz.lu~'braX 'trejs ka~'no.az a~.ma'Ra.das 'ne.li
A noite ia caindo depressa e a escuridão distante já estava cheia dos sons de grilos e sapos.	a 'noj.Ti 'i.a ka'i~.du de'prE.sa i a es.ku.ri'da~w~ Dis'ta~.Ti 'Za es'ta.va 'Sej.a dus 'so~s Di 'gri.luz i 'sa.pus
Jesus pegou-o pelo braço e guiou-o pelo caminho enquanto seus olhos se ajustavam, mas Mack já estava olhando para uma noite sem luar, com o espanto das estrelas emergindo.	Ze'zujs pe'gow u 'pe.lu 'bra.su i gi'ow u 'pe.lu ka~'mi~.Ju e~'kwa~.tu 'sewz 'O.Lus si a.Zus'ta.va~w~, majs 'mE.ki 'Za es'ta.va o'La~.du 'pa.ra u~.ma 'noj.Ti se~j~ lu'aX, ko~ u es'pa~.tu daz es'tre.laz e~.meR'Zi~.du
Chegaram ao meio do cais e se deitaram de costas, olhando para cima.	Se'ga.ra~w~ aw 'mej.u du 'kajz i si dej'ta.ra~w~ Di 'kOs.tas, o'La~.du 'pa.ra 'si~.ma
A altitude do lugar parecia ampliar o céu e Mack adorou ver a imensidão do espaço tão claramente estrelada.	a aw.Ti'tu.Di du lu'gaX pa.re'si.a a~.pli'ar u 'sEw i 'mE.ki a.do'row 'ver a i~.me~.si'da~w~ du es'pa.su 'ta~w~ kla.ra~'me~.Ti es.tre'la.da
Jesus sugeriu que fechassem os olhos por alguns minutos, permitindo que os últimos clarões do crepúsculo desaparecessem.	Ze'zujs su.Ze'riw ki fe'Sa.se~j~ uz 'O.Lus pur aw'gu~s mi~'nu.tus, peR.mi'Ti~.du ki uz 'uw.Ti~.mus kla'ro~j~s du kre'pus.ku.lu de.za.pa.re'se.se~j~
Mack obedeceu e, quando finalmente abriu os olhos, a visão foi tão poderosa que por alguns segundos ele experimentou uma espécie de vertigem.	'mE.ki o.be.de'sew i, 'kwa~.du fi~.naw'me~.Ti a'briw uz 'O.Lus, a vi'za~w~ 'foj 'ta~w~ po.de'rO.za ki pur aw'gu~s se'gu~.duz 'e.li es.pe.ri~.me~'tow u~.ma es'pE.si Di veX'Ti.Ze~j~
Era quase como se estivesse caindo no espaço, com as estrelas correndo em sua direção para abraçá-lo.	'E.ra 'kwa.zi 'ko~.mu si es.Ti'vE.si ka'i~.du nu es'pa.su, ko~ az es'tre.las ko'Re~.du e~j~ 'su.a Di.re'sa~w~ 'pa.ra a.bra'sa lu
Levantou as mãos imaginando que podia colher diamantes, um a um, de um céu de veludo negro.	le.va~'tow as 'ma~w~z i~.ma.Zi~'na~.du ki po'Di.a ko'LeR Di.a~'ma~.Tis, 'u~ a 'u~, Di u~ 'sEw Di ve'lu.du 'ne.gru
Uau! exclamou.	u'aw, es.kla~'mow
Incrível! sussurrou Jesus, com a cabeça perto da de Mack no escuro.	i~'kri.vew, su.su'Row Ze'zujs, ko~ a ka'be.sa 'pEX.tu da Di 'mE.ki nu es'ku.ru
Nunca me canso de ver isso.	'nu~.ka mi 'ka~.su Di 'ver 'i.su
Mesmo que você tenha criado?	'mez.mu ki vo'se 'te~.Ja kri'a.du
Eu criei quando era o Verbo, antes que o Verbo se tornasse Carne.	ew kri'ej 'kwa~.du 'E.ra u 'vER.bu, 'a~.Tis ki u 'vER.bu si toR'na.si 'kaR.ni
De modo que, mesmo tendo criado tudo isso, agora vejo como humano.	Di 'mO.du ki, 'mez.mu 'te~.du kri'a.du 'tu.du 'i.su, a'gO.ra 've.Zu 'ko~.mu u~'ma~.nu
E acho impressionante!	i 'a.Su i~.pre.si.o~'na~.Ti
É mesmo. Mack não sabia como descrever o que sentia, mas enquanto continuavam deitados em silêncio, olhando o espetáculo celestial num espanto reverente, observando e ouvindo, soube em seu coração que isso também era sagrado.	E 'mez.mu, 'mE.ki 'na~w~ sa'bi.a 'ko~.mu des.kre'ver u ki se~'Ti.a, majz e~'kwa~.tu ko~.Ti~.nu'a.va~w~ dej'ta.duz e~j~ si'le~.sju, o'La~.du u es.pe'ta.ku.lu se.les.Ti'aw nu~ es'pa~.tu Re.ve're~.Ti, ob.seR'va~.du i ow'vi~.du, 'sow.bi e~j~ 'sew ko.ra'sa~w~ ki 'i.su ta~'be~j~ 'E.ra sa'gra.du
Estrelas cadentes ocasionais chamejavam numa trilha breve cortando o negrume da noite e fazendo um ou outro exclamar: Viu aquilo?	es'tre.las ka'de~.Tiz o.ka.zi.o~'naj.Sa~.me'Za.va~w~ 'nu~.ma 'tri.La 'brE.vi koX'ta~.du u ne'gru~.mi da 'noj.Ti i fa'ze~.du 'u~ ow 'ow.tru es.kla~'maX, 'viw a'ki.lu
Que maravilha!	ki ma.ra'vi.La
Depois de um silêncio particularmente longo, Mack falou: Eu me sinto mais confortável perto de você.	de'pojs Di u~ si'le~.sju paX.Ti.ku.laR'me~.Ti 'lo~.gu, 'mE.ki fa'low, ew mi 'si~.tu 'majs ko~.foX'ta.vew 'pEX.tu Di vo'se
Você parece muito diferente delas.	vo'se pa'rE.si 'mu~j~.tu Di.fe're~.Ti 'dE.las
Como assim, diferente? a voz suave de Jesus emergiu da escuridão.	'ko~.mu a'si~, Di.fe're~.Ti, a 'vOjs su'a.vi Di Ze'zujz e~.meR'Ziw da es.ku.ri'da~w~
Bom. Mack fez uma pausa enquanto pensava.	'bo~, 'mE.ki 'fejz u~.ma 'paw.za e~'kwa~.tu pe~'sa.va
Mais real ou palpável. Não sei. Lutou com as palavras e Jesus ficou deitado em silêncio, esperando.	'majs Re'aw ow paw'pa.vew, 'na~w~ 'sej, lu'tow ko~ as pa'la.vraz i Ze'zujs fi'kow dej'ta.du e~j~ si'le~.sju, es.pe'ra~.du
É como se eu sempre tivesse conhecido você.	E 'ko~.mu si ew 'se~.pri Ti'vE.si ko~.Je'si.du vo'se
Mas Papai não é nem um pouco o que eu esperava de Deus e Sarayu é muito estranha.	majs pa'paj 'na~w~ E ne~j~ u~ 'pow.ku u ki ew es.pe'ra.va Di 'dewz i sa.ra'ju E 'mu~j~.tu es'tra~.Ja
Jesus deu um risinho no escuro.	Ze'zujs 'dew u~ Ri'zi~.Ju nu es'ku.ru
Como eu sou humano, nós temos muito mais em comum.	'ko~.mu ew 'sow u~'ma~.nu, 'nOjs 'te~.mus 'mu~j~.tu 'majz e~j~ ko~'mu~
Mas, mesmo assim, não entendo...	majs, 'mez.mu a'si~, 'na~w~ e~'te~.du
Eu sou o melhor modo que qualquer humano pode ter de se relacionar com Papai ou com Sarayu.	ew 'sow u me'LOR 'mO.du ki kwaw'kEr u~'ma~.nu 'pO.Di 'teR Di si Re.la.si.o~'naX ko~ pa'paj ow ko~ sa.ra'ju
Me ver é vê-las.	mi 'ver E 've las
E, acredite, Papai e Sarayu são tão reais quanto eu, embora, como você viu, de maneiras muito diferentes.	i, a.kre'Di.Ti, pa'paj i sa.ra'ju 'sa~w~ 'ta~w~ Re'ajs 'kwa~.tu ew, e~'bO.ra, 'ko~.mu vo'se 'viw, Di ma~'nej.ras 'mu~j~.tu Di.fe're~.Tis
Por falar em Sarayu, ela é o Espírito Santo?	puX fa'lar e~j~ sa.ra'ju, 'E.la E u es'pi.ri.tu 'sa~.tu
É. É Criatividade, é Ação, é o Sopro da Vida.	E, E kri.a.Ti.vi'da.Di, E a'sa~w~, E u 'so.pru da 'vi.da
E é muito mais.	i E 'mu~j~.tu 'majs
Ela é o meu Espírito.	'E.la E u 'mew es'pi.ri.tu
E o nome dela, Sarayu?	i u 'no~.mi 'dE.la, sa.ra'ju
É um nome simples de uma das nossas línguas humanas.	E u~ 'no~.mi 'si~.plis Di u~.ma das 'nO.sas 'li~.gwaz u~'ma~.nas
Significa Vento, na verdade um vento comum.	si.gi~.ni'fi.ka 've~.tu, na veR'da.Di u~ 've~.tu ko~'mu~
Ela adora esse nome.	'E.la a'dO.ra 'e.si 'no~.mi
Humm, resmungou Mack.	w~, Rez.mu~'gow 'mE.ki
Não há nada de muito comum nela!	'na~w~ 'a 'na.da Di 'mu~j~.tu ko~'mu~ 'nE.la
Isso é verdade.	'i.su E veR'da.Di
Elousia, disse a voz reverentemente no escuro, ao lado dele.	e.low'zi.a, 'Di.si a 'vOjz Re.ve.re~.Ti~'me~.Ti nu es'ku.ru, aw 'la.du 'de.li
Esse é um nome maravilhoso.	'e.si E u~ 'no~.mi ma.ra.vi'Lo.zu
El é meu nome como Deus Criador, mas ousia é ser, ou aquilo que é verdadeiramente real, de modo que o nome significa o Deus Criador que é verdadeiramente real e a base de todo o ser.	'Ew E 'mew 'no~.mi 'ko~.mu 'dews kri.a'doX, majz ow'zi.a E 'seX, ow a'ki.lu ki E veR.da.dej.ra~'me~.Ti Re'aw, Di 'mO.du ki u 'no~.mi si.gi~.ni'fi.ka u 'dews kri.a'doX ki E veR.da.dej.ra~'me~.Ti Re'aw i a 'ba.zi Di 'to.du u 'seX
Isso é que é um nome bonito!	'i.su E ki E u~ 'no~.mi bo~'ni.tu
Houve silêncio por um minuto enquanto Mack pensava no que Jesus havia dito.	'ow.vi si'le~.sju pur 'u~ mi~'nu.tu e~'kwa~.tu 'mE.ki pe~'sa.va nu ki Ze'zujz a'vi.a 'Di.tu
Então onde é que isso nos deixa?	e~'ta~w~ 'o~.Di E ki 'i.su nus 'dej.Sa
Bem, onde vocês sempre se destinaram a estar.	'be~j~, 'o~.Di vo'sejs 'se~.pri si des.Ti~'na.ra~w~ a es'taX
No próprio centro do nosso amor e do nosso propósito.	nu 'prO.prju 'se~.tru du 'nO.su a~'mor i du 'nO.su pro'pO.zi.tu
De novo uma pausa e depois: Acho que posso viver com isso.	Di 'no.vu u~.ma 'paw.za i de'pojs, 'a.Su ki 'pO.su vi'veX ko~ 'i.su
Jesus deu um risinho.	Ze'zujs 'dew u~ Ri'zi~.Ju
Fico feliz em saber, e os dois riram.	'fi.ku fe'liz e~j~ sa'beX, i us 'dojs 'Ri.ra~w~
Ninguém falou por um tempo.	ni~'ge~j~ fa'low pur u~ 'te~.pu
O silêncio havia baixado como um cobertor e tudo de que Mack tinha realmente consciência era do som da água batendo no cais.	u si'le~.sju a'vi.a baj'Sa.du 'ko~.mu u~ ko.beX'tor i 'tu.du Di ki 'mE.ki 'Ti~.Ja Re.aw'me~.Ti ko~.si'e~.sja 'E.ra du 'so~ da 'a.gwa ba'te~.du nu 'kajs
Novamente ele rompeu o silêncio.	nO.va~'me~.Ti 'e.li Ro~'pew u si'le~.sju
O que é, Mackenzie?	u ki E, ma'ke~.zi
Estou surpreso com uma coisa em você.	es'tow suX'pre.zu ko~ u~.ma 'koj.za e~j~ vo'se
Acho que eu esperava que você fosse mais...	'a.Su ki ew es.pe'ra.va ki vo'se 'fo.si 'majs
Cuidado aí, Mack.	kuj'da.du a'i, 'mE.ki
Humanamente marcante?	u~.ma~.na~'me~.Ti maX'ka~.Ti
Quer dizer bonito?	'kER Di'zeR bo~'ni.tu
Agora ele estava gargalhando.	a'gO.ra 'e.li es'ta.va gaR.ga'La~.du
Bom, eu estava tentando evitar dizer assim, mas é.	'bo~, ew es'ta.va te~'ta~.du e.vi'taR Di'zer a'si~, majz E
De algum modo achei que você seria o homem ideal, você sabe, atlético e de uma beleza avassaladora.	Di aw'gu~ 'mO.du a'Sej ki vo'se se'ri.a u 'o~.me~j~ i.de'aw, vo'se 'sa.bi, a'tlE.Ti.ku i Di u~.ma be'le.za a.va.sa.la'do.ra
É o meu nariz, não é?	E u 'mew na'ris, 'na~w~ E
Mack não soube o que dizer.	'mE.ki 'na~w~ 'sow.bi u ki Di'zeX
Eu sou judeu, você sabe.	ew 'sow Zu'dew, vo'se 'sa.bi
Meu avô materno tinha um narigão. Na verdade, a maioria dos homens do meu lado materno tinha nariz grande.	'mew a'vo ma'tER.nu 'Ti~.Ja u~ na.ri'ga~w~, na veR'da.Di, a maj.o'ri.a duz 'o~.me~s du 'mew 'la.du ma'tER.nu 'Ti~.Ja na'riz 'gra~.Di
Só pensei que você teria uma aparência melhor.	'sO pe~'sej ki vo'se te'ri.a u~.ma a.pa're~.sja me'LOX
De acordo com que padrão?	Di a'koR.du ko~ ki pa'dra~w~
De qualquer modo, quando você me conhecer melhor, isso não vai importar.	Di kwaw'kER 'mO.du, 'kwa~.du vo'se mi ko~.Je'seR me'LOX, 'i.su 'na~w~ 'vaj i~.poX'taX
Mesmo ditas com gentileza, as palavras machucaram.	'mez.mu 'Di.tas ko~ Ze~.Ti'le.za, as pa'la.vras ma.Su'ka.ra~w~
Machucaram o quê, exatamente?	ma.Su'ka.ra~w~ u 'ke, e.za.ta~'me~.Ti
Talvez o que conhecesse fosse um ícone, um ideal, uma imagem através da qual tentava captar um sentimento de espiritualidade, mas não uma pessoa real.	taw'vejz u ki ko~.Je'se.si 'fo.si u~ 'i.ko~.ni, u~ i.de'aw, u~.ma i~'ma.Ze~j~ a.tra'vEjs da 'kwaw te~'ta.va kap'tar u~ se~.Ti~'me~.tu Di es.pi.ri.tu.a.li'da.Di, majs 'na~w~ u~.ma pe'so.a Re'aw
Por que isso? perguntou finalmente.	puX 'ke 'i.su, peR.gu~'tow fi~.naw'me~.Ti
Você disse que, se eu o conhecesse de verdade, sua aparência não importaria...	vo'se 'Di.si ki, si ew u ko~.Je'se.si Di veR'da.Di, 'su.a a.pa're~.sja 'na~w~ i~.poX.ta'ri.a
Na verdade é bem simples.	na veR'da.Di E 'be~j~ 'si~.plis
O ser sempre transcende a aparência.	u 'seX 'se~.pri tra~'se~.Di a a.pa're~.sja
Assim que você começa a descobrir o ser que há por trás de um rosto muito bonito ou muito feio, de acordo com seus conceitos e preconceitos, as aparências superficiais somem até simplesmente não importarem mais.	a'si~ ki vo'se ko~'mE.sa a des.ko'brir u 'seX ki 'a puX 'trajs Di u~ 'Ros.tu 'mu~j~.tu bo~'ni.tu ow 'mu~j~.tu 'fej.u, Di a'koR.du ko~ 'sews ko~'sej.tuz i pre.ko~'sej.tus, az a.pa're~.sjas su.peX.fi.si'ajs 'so~.me~j~ a'tE si~.pliz'me~.Ti 'na~w~ i~.poX'ta.re~j~ 'majs
Por isso Elousia é um nome tão maravilhoso.	pur 'i.su e.low'zi.a E u~ 'no~.mi 'ta~w~ ma.ra.vi'Lo.zu
Qualquer aparência que mascare essa verdade está destinada a cair.	kwaw'kEr a.pa're~.sja ki mas'ka.ri 'E.sa veR'da.Di es'ta des.Ti~'na.da a ka'iX
Seguiu-se um silêncio enquanto Mack refletia sobre o que Jesus havia falado.	se'giw si u~ si'le~.sju e~'kwa~.tu 'mE.ki Re.fle'Ti.a 'so.bri u ki Ze'zujz a'vi.a fa'la.du
Desistiu depois de apenas um ou dois minutos e decidiu fazer a pergunta mais arriscada.	de.zis'Tiw de'pojs Di a'pe~.naz 'u~ ow 'dojs mi~'nu.tuz i de.si'Diw fa'zer a peR'gu~.ta 'majz a.Ris'ka.da
Você disse que eu não o conheço de verdade.	vo'se 'Di.si ki ew 'na~w~ u ko~'Je.su Di veR'da.Di
Seria muito mais fácil se pudéssemos sempre conversar assim.	se'ri.a 'mu~j~.tu 'majs 'fa.siw si pu'dE.se~.mus 'se~.pri ko~.veX'sar a'si~
Admito, Mack, que essa conversa é especial.	a.Di~'mi.tu, 'mE.ki, ki 'E.sa ko~'vEX.sa E es.pe.si'aw
Você estava realmente travado e nós queríamos ajudá-lo a se arrastar para fora da dor.	vo'se es'ta.va Re.aw'me~.Ti tra'va.du i 'nOjs ke'ri.a~.muz a.Zu'da lu a si a.Ras'taX 'pa.ra 'fO.ra da 'doX
Mas não fique achando que porque não sou visível o nosso relacionamento precisa ser menos real.	majs 'na~w~ 'fi.ki a'Sa~.du ki puX'ke 'na~w~ 'sow vi'zi.vew u 'nO.su Re.la.si.o~.na~'me~.tu pre'si.za 'seR 'me~.nus Re'aw
Como assim?	'ko~.mu a'si~
Meu propósito, desde o início, era viver em você e você viver em mim.	'mew pro'pO.zi.tu, 'dez.Di u i~'ni.sju, 'E.ra vi'ver e~j~ vo'se i vo'se vi'ver e~j~ 'mi~
Espere, espere. Espere um minuto.	es'pE.ri, es'pE.ri, es'pE.ri u~ mi~'nu.tu
Como isso pode acontecer? Se você ainda é totalmente humano, como pode estar dentro de mim?	'ko~.mu 'i.su 'pO.Di a.ko~.te'seX, si vo'se a'i~.da E to.taw'me~.Ti u~'ma~.nu, 'ko~.mu 'pO.Di es'taR 'de~.tru Di 'mi~
Espantoso, não é?	es.pa~'to.zu, 'na~w~ E
É o milagre de Papai.	E u mi'la.gri Di pa'paj
É o poder de Sarayu, meu Espírito, o Espírito de Deus que restaura a união que foi perdida há tanto tempo.	E u po'deR Di sa.ra'ju, 'mew es'pi.ri.tu, u es'pi.ri.tu Di 'dews ki Res'taw.ra a u~.ni'a~w~ ki 'foj peR'Di.da 'a 'ta~.tu 'te~.pu
A cada momento eu escolho viver totalmente humano.	a 'ka.da mo~'me~.tu ew es'ko.Lu vi'veX to.taw'me~.Ti u~'ma~.nu
Como eu disse, é o milagre de Papai.	'ko~.mu ew 'Di.si, E u mi'la.gri Di pa'paj
Mack estava deitado no escuro ouvindo com atenção.	'mE.ki es'ta.va dej'ta.du nu es'ku.ru ow'vi~.du ko~ a.te~'sa~w~
Você está falando de uma moradia real e não somente de uma questão teológica?	vo'se es'ta fa'la~.du Di u~.ma mo.ra'Di.a Re'aw i 'na~w~ sO~'me~.Ti Di u~.ma kes'ta~w~ te.o'lO.Zi.ka
Claro, respondeu Jesus com a voz forte e segura.	'kla.ru, Res.po~'dew Ze'zujs ko~ a 'vOjs 'fOX.Ti i se'gu.ra
O humano, formado a partir da criação material e física, pode ser totalmente habitado pela vida espiritual, a minha vida.	u u~'ma~.nu, foR'ma.du a paX'TiR da kri.a'sa~w~ ma.te.ri'aw i 'fi.zi.ka, 'pO.Di 'seX to.taw'me~.Ti a.bi'ta.du 'pe.la 'vi.da es.pi.ri.tu'aw, a 'mi~.Ja 'vi.da
Isso exige a existência de uma união muito real, dinâmica e ativa.	'i.su e'zi.Zi a e.zis'te~.sja Di u~.ma u~.ni'a~w~ 'mu~j~.tu Re'aw, Di~'na~.mi.ka i a'Ti.va
É quase inacreditável! exclamou Mack baixinho.	E 'kwa.zi i~.na.kre.Di'ta.vew, es.kla~'mow 'mE.ki baj'Si~.Ju
Eu não fazia idéia.	ew 'na~w~ fa'zi.a i'dEj.a
Preciso pensar mais nisso.	pre'si.zu pe~'saR 'majs 'ni.su
Mas talvez eu tenha outro monte de perguntas.	majs taw'vejz ew 'te~.Ja 'ow.tru 'mo~.Ti Di peR'gu~.tas
Mas por enquanto chega disso.	majs pur e~'kwa~.tu 'Se.ga 'Di.su
Vamos nos perder de novo na noite estrelada.	'va~.mus nus peR'deR Di 'no.vu na 'noj.Ti es.tre'la.da
Depois do que pareceu um longo tempo, Jesus rompeu o silêncio.	de'pojs du ki pa.re'sew u~ 'lo~.gu 'te~.pu, Ze'zujs Ro~'pew u si'le~.sju
Nunca vou me cansar de olhar para isso.	'nu~.ka 'vow mi ka~'saR Di o'LaX 'pa.ra 'i.su
A maravilha de tudo, o esbanjamento da Criação, como disse um dos nossos irmãos.	a ma.ra'vi.La Di 'tu.du, u ez.ba~.Za~'me~.tu da kri.a'sa~w~, 'ko~.mu 'Di.si 'u~ dus 'nO.suz iR'ma~w~s
Tão elegante, tão cheia de desejo e beleza, mesmo agora.	'ta~w~ e.le'ga~.Ti, 'ta~w~ 'Sej.a Di de'ze.Zu i be'le.za, 'mez.mu a'gO.ra
Humano? sugeriu Jesus.	u~'ma~.nu, su.Ze'riw Ze'zujs
Mas feio. E começou a rir, primeiro baixinho e contido, depois às gargalhadas.	majs 'fej.u, i ko~.me'sow a 'RiX, pri~'mej.ru baj'Si~.Ju i ko~'Ti.du, de'pojz as gaR.ga'La.das
Era contagioso e Mack deixou-se levar num riso que vinha de algum lugar bem no fundo.	'E.ra ko~.ta.Zi'o.zu i 'mE.ki dej'Sow si le'vaR nu~ 'Ri.zu ki 'vi~.Ja Di aw'gu~ lu'gaR 'be~j~ nu 'fu~.du
Não ria a partir daquele lugar havia muito tempo.	'na~w~ 'Ri.a a paX'TiR da'ke.li lu'gar a'vi.a 'mu~j~.tu 'te~.pu
Os dois acabaram se aquietando e o silêncio da noite se impôs mais uma vez.	us 'dojz a.ka'ba.ra~w~ si a.ki.e'ta~.du i u si'le~.sju da 'noj.Ti si i~'pojs 'majz u~.ma 'vejs
Mack ficou parado, se dando conta da culpa por estar se divertindo e rindo.	'mE.ki fi'kow pa'ra.du, si 'da~.du 'ko~.ta da 'kuw.pa pur es'taX si Di.veX'Ti~.du i 'Ri~.du
Mesmo no escuro, sentiu a Grande Tristeza chegar e encobri-lo.	'mez.mu nu es'ku.ru, se~'Tiw a 'gra~.Di tris'te.za Se'gar i e~.ko'bri lu
Jesus? sussurrou com a voz embargada.	Ze'zujs, su.su'Row ko~ a 'vOjz e~.baR'ga.da
Eu me sinto muito perdido.	ew mi 'si~.tu 'mu~j~.tu peR'Di.du
Uma mão se estendeu e ficou apertando a sua.	u~.ma 'ma~w~ si es.te~'dew i fi'kow a.peX'ta~.du a 'su.a
Eu sei, Mack.	ew 'sej, 'mE.ki
Mas não é verdade.	majs 'na~w~ E veR'da.Di
Lamento se a sensação é essa, mas ouça com clareza: você não está perdido.	la~'me~.tu si a se~.sa'sa~w~ E 'E.sa, majz 'ow.sa ko~ kla're.za, vo'se 'na~w~ es'ta peR'Di.du
Espero que você esteja certo, respondeu Mack, com a tensão afrouxada pelas palavras do amigo recém-encontrado.	es'pE.ru ki vo'se es'te.Za 'sEX.tu, Res.po~'dew 'mE.ki, ko~ a te~'sa~w~ a.frow'Sa.da 'pe.las pa'la.vras du a~'mi.gu Re'se~j~ e~.ko~'tra.du
Venha, disse Jesus, levantando-se e estendendo a mão para Mack.	've~.Ja, 'Di.si Ze'zujs, le.va~'ta~.du si i es.te~'de~.du a 'ma~w~ 'pa.ra 'mE.ki
Você tem um grande dia pela frente.	vo'se te~j~ u~ 'gra~.Di 'Di.a 'pe.la 'fre~.Ti
Vou levá-lo para a cama.	'vow le'va lu 'pa.ra a 'ka~.ma
Passou o braço pelo ombro de Mack e juntos andaram para o chalé.	pa'sow u 'bra.su 'pe.lu 'o~.bru Di 'mE.ki i 'Zu~.tuz a~'da.ra~w~ 'pa.ra u Sa'lE
De repente, Mack sentiu-se exausto.	Di Re'pe~.Ti, 'mE.ki se~'Tiw si e'zaws.tu
O dia fora longo.	u 'Di.a 'fo.ra 'lo~.gu
Talvez acordasse em casa, na sua cama, depois de uma noite de sonhos vívidos.	taw'vejz a.koR'da.si e~j~ 'ka.za, na 'su.a 'ka~.ma, de'pojs Di u~.ma 'noj.Ti Di 'so~.Jus 'vi.vi.dus
Mas em algum lugar dentro de si esperava estar errado.	majz e~j~ aw'gu~ lu'gaR 'de~.tru Di 'si es.pe'ra.va es'tar e'Ra.du
Crescer significa mudar e mudar envolve riscos, uma passagem do conhecido para o desconhecido.	kre'seX si.gi~.ni'fi.ka mu'dar i mu'dar e~'vOw.vi 'Ris.kus, u~.ma pa'sa.Ze~j~ du ko~.Je'si.du 'pa.ra u des.ko~.Je'si.du
Quando chegou no quarto, Mack descobriu que as roupas que havia deixado no carro estavam dobradas em cima da cômoda ou penduradas no armário.	'kwa~.du Se'gow nu 'kwaX.tu, 'mE.ki des.ko'briw ki as 'Row.pas ki a'vi.a dej'Sa.du nu 'ka.Ru es'ta.va~w~ do'bra.daz e~j~ 'si~.ma da 'ko~.mo.da ow pe~.du'ra.das nu aR'ma.rju
Achou engraçado encontrar uma Bíblia na mesinha-de-cabeceira.	a'Sow e~.gra'sa.du e~.ko~'trar u~.ma 'bi.blja na me'zi~.Ja Di ka.be'sej.ra
Escancarou a janela para deixar que o ar da noite entrasse livremente, algo que Nan jamais tolerava em casa porque tinha medo de aranhas e de qualquer coisa rastejante.	es.ka~.ka'row a Za~'nE.la 'pa.ra dej'SaX ki u 'aR da 'noj.Ti e~'tra.si li.vri~'me~.Ti, 'aw.gu ki 'na~ Za~'majs to.le'ra.va e~j~ 'ka.za puX'ke 'Ti~.Ja 'me.du Di a'ra~.Jaz i Di kwaw'kEX 'koj.za Ras.te'Za~.Ti
Quem nunca voou assim talvez não acredite que seja possível, mas no fundo sente um pouco de inveja.	'ke~j~ 'nu~.ka vo'ow a'si~ taw'vejz 'na~w~ a.kre'Di.Ti ki 'se.Za po'si.vew, majs nu 'fu~.du 'se~.Ti u~ 'pow.ku Di i~'vE.Za
Havia anos que ele não tinha esse tipo de sonho, pelo menos desde que a Grande Tristeza baixara, mas nessa noite Mack voou alto na noite estrelada, através do ar límpido e frio, sem qualquer desconforto.	a'vi.a 'a~.nus ki 'e.li 'na~w~ 'Ti~.Ja 'e.si 'Ti.pu Di 'so~.Ju, 'pe.lu 'me~.nus 'dez.Di ki a 'gra~.Di tris'te.za baj'Sa.ra, majs 'nE.sa 'noj.Ti 'mE.ki vo'ow 'aw.tu na 'noj.Ti es.tre'la.da, a.tra'vEjs du 'aR 'li~.pi.du i 'fri.u, se~j~ kwaw'kER des.ko~'foX.tu
Sobrevoou lagos e rios, atravessou um litoral oceânico e várias ilhotas cercadas de recifes.	so.bre.vo'ow 'la.guz i 'Ri.us, a.tra.ve'sow u~ li.to'raw o.se'a~.ni.ku i 'va.rjaz i'LO.tas seX'ka.das Di Re'si.fis
Por mais estranho que pareça, Mack aprendera com seus sonhos a voar erguendo-se do chão sem ser sustentado por nada, sem asas, sem qualquer tipo de aparelho, apenas ele.	puR 'majz es'tra~.Ju ki pa're.sa, 'mE.ki a.pre~'de.ra ko~ 'sews 'so~.Juz a vo'ar eR'ge~.du si du 'Sa~w~ se~j~ 'seX sus.te~'ta.du puR 'na.da, se~j~ 'a.zas, se~j~ kwaw'kEX 'Ti.pu Di a.pa're.Lu, a'pe~.naz 'e.li
Os vôos inicialmente o elevavam a alguns centímetros do chão, por causa do medo de cair.	us 'vowz i~.ni.si.aw'me~.Ti u e.le'va.va~w~ a aw'gu~s se~'Ti~.me.trus du 'Sa~w~, puX 'kaw.za du 'me.du Di ka'iX
Aos poucos ele foi adquirindo confiança e se alçando mais alto, descobrindo que a queda não era dolorosa, apenas um pequeno ricochete em câmara lenta.	aws 'pow.kuz 'e.li 'foj a.Di.ki'ri~.du ko~.fi'a~.sa i si aw'sa~.du 'majz 'aw.tu, des.ko'bri~.du ki a 'kE.da 'na~w~ 'E.ra do.lo'rO.za, a'pe~.naz u~ pe'ke~.nu Ri.ko'Se.Ti e~j~ 'ka~.ma.ra 'le~.ta
Enquanto planava à vontade sobre montanhas escarpadas e praias de um branco cristalino, usufruía a maravilha do sonho de voar.	e~'kwa~.tu pla~'na.va a vo~'ta.Di 'so.bri mo~'ta~.Jaz es.kaX'pa.daz i 'praj.as Di u~ 'bra~.ku kris.ta'li~.nu, u.zu.fru'i.a a ma.ra'vi.La du 'so~.Ju Di vo'aX
Subitamente, algo o agarrou pelo tornozelo e o puxou para baixo.	su.bi.ta~'me~.Ti, 'aw.gu u a.ga'Row 'pe.lu toR.no'ze.lu i u pu'Sow 'pa.ra 'baj.Su
Em questão de segundos foi arrastado das alturas e jogado violentamente, de cara, numa estrada lamacenta e muito esburacada.	e~j~ kes'ta~w~ Di se'gu~.dus 'foj a.Ras'ta.du daz aw'tu.raz i Zo'ga.du vi.o.le~.ta~'me~.Ti, Di 'ka.ra, 'nu~.ma es'tra.da la~.ma'se~.ta i 'mu~j~.tu ez.bu.ra'ka.da
E tudo veio de novo, raios iluminando o rosto de sua filha enquanto ela gritava Papai! sem emitir nenhum som e se virava e corria para a escuridão, o vestido vermelho visível apenas por alguns clarões breves e depois sumindo.	i 'tu.du 'vej.u Di 'no.vu, 'Raj.uz i.lu~.mi~'na~.du u 'Ros.tu Di 'su.a 'fi.La e~'kwa~.tu 'E.la gri'ta.va pa'paj, se~j~ e~.mi'TiR ne~'Ju~ 'so~ i si vi'ra.va i ko'Ri.a 'pa.ra a es.ku.ri'da~w~, u ves'Ti.du veR'me.Lu vi'zi.vew a'pe~.nas pur aw'gu~s kla'ro~j~s 'brE.viz i de'pojs su~'mi~.du
No momento em que estava submergindo, acordou ofegando.	nu mo~'me~.tu e~j~ ki es'ta.va sub.meR'Zi~.du, a.koR'dow o.fe'ga~.du
Com o coração disparado e a imaginação presa às imagens do pesadelo, demorou alguns instantes para perceber que fora somente um sonho.	ko~ u ko.ra'sa~w~ Dis.pa'ra.du i a i~.ma.Zi~.na'sa~w~ 'pre.za az i~'ma.Ze~s du pe.za'de.lu, de~.mo'row aw'gu~z i~s'ta~.Tis 'pa.ra peX.se'beX ki 'fo.ra sO~'me~.Ti u~ 'so~.Ju
Mas, mesmo que o sonho fosse sumindo da consciência, as emoções permaneceram.	majs, 'mez.mu ki u 'so~.Ju 'fo.si su~'mi~.du da ko~.si'e~.sja, az e~.mo'so~j~s peR.ma~.ne'se.ra~w~
O sonho havia provocado a Grande Tristeza e, antes que ele pudesse sair da cama, estava de novo procurando um caminho através do desespero que viera devorando muitos dos seus dias.	u 'so~.Ju a'vi.a pro.vo'ka.du a 'gra~.Di tris'te.za i, 'a~.Tis ki 'e.li pu'dE.si sa'iR da 'ka~.ma, es'ta.va Di 'no.vu pro.ku'ra~.du u~ ka~'mi~.Ju a.tra'vEjs du de.zes'pe.ru ki vi'E.ra de.vo'ra~.du 'mu~j~.tus dus 'sews 'Di.as
Olhou ao redor do quarto, no cinza opaco de antes do amanhecer que chegava sorrateiramente do outro lado dos postigos da janela.	o'Low aw Re'dOR du 'kwaX.tu, nu 'si~.za o'pa.ku Di 'a~.Tis du a~.ma~.Je'seX ki Se'ga.va so.Ra.tej.ra~'me~.Ti du 'ow.tru 'la.du dus pos'Ti.gus da Za~'nE.la
Aquele não era seu quarto, nada parecia familiar.	a'ke.li 'na~w~ 'E.ra 'sew 'kwaX.tu, 'na.da pa.re'si.a fa~.mi.li'aX
Onde estava?	'o~.Di es'ta.va
Pense, Mack, pense!	'pe~.si, 'mE.ki, 'pe~.si
Então se lembrou.	e~'ta~w~ si le~'brow
Isso não pode estar acontecendo de verdade, resmungou, enquanto punha os pés para fora da cama e se sentava na beira com a cabeça nas mãos.	'i.su 'na~w~ 'pO.Di es'tar a.ko~.te'se~.du Di veR'da.Di, Rez.mu~'gow, e~'kwa~.tu 'pu~.Ja us 'pEjs 'pa.ra 'fO.ra da 'ka~.ma i si se~'ta.va na 'bej.ra ko~ a ka'be.sa nas 'ma~w~s
Pensou no dia anterior e de novo sentiu medo de estar enlouquecendo.	pe~'sow nu 'Di.a a~.te.ri'or i Di 'no.vu se~'Tiw 'me.du Di es'tar e~.low.ke'se~.du
Como nunca fora uma pessoa muito chegada a contatos físicos e a emoções, Papai, ou quem quer que fosse, o deixara nervoso, e ele não fazia idéia do que pensar a respeito de Sarayu.	'ko~.mu 'nu~.ka 'fo.ra u~.ma pe'so.a 'mu~j~.tu Se'ga.da a ko~'ta.tus 'fi.zi.kuz i a e~.mo'so~j~s, pa'paj, ow 'ke~j~ 'kEX ki 'fo.si, u dej'Sa.ra neR'vo.zu, i 'e.li 'na~w~ fa'zi.a i'dEj.a du ki pe~'sar a Res'pej.tu Di sa.ra'ju
Admitiu que gostava um bocado de Jesus, mas ele parecia o menos divino dos três.	a.Di~.mi'Tiw ki gos'ta.va u~ bo'ka.du Di Ze'zujs, majz 'e.li pa.re'si.a u 'me~.nus Di'vi~.nu dus 'trejs
Soltou um suspiro fundo e pesado.	sow'tow u~ sus'pi.ru 'fu~.du i pe'za.du
E, se Deus estava realmente ali, por que não havia afastado seus pesadelos?	i, si 'dewz es'ta.va Re.aw'me~.Ti a'li, puX 'ke 'na~w~ a'vi.a a.fas'ta.du 'sews pe.za'de.lus
Ficar se debatendo com um dilema não iria ajudar.	fi'kaX si de.ba'te~.du ko~ u~ Di'le~.ma 'na~w~ i'ri.a a.Zu'daX
Demorou um tempo no calor da água, depois se barbeando e, de volta ao quarto, vestindo-se.	de~.mo'row u~ 'te~.pu nu ka'loR da 'a.gwa, de'pojs si baR.be'a~.du i, Di 'vOw.ta aw 'kwaX.tu, ves'Ti~.du si
O aroma penetrante e sedutor do café o atraiu para a xícara fumegante que o esperava na mesa junto à porta.	u a'ro~.ma pe~.ne'tra~.Ti i se.du'toR du ka'fE u a.tra'iw 'pa.ra a 'Si.ka.ra fu~.me'ga~.Ti ki u es.pe'ra.va na 'me.za 'Zu~.tu a 'pOX.ta
Tomando um gole, abriu os postigos e ficou olhando pela janela do quarto para o lago que apenas vislumbrara como uma sombra na noite anterior.	to~'ma~.du u~ 'gO.li, a'briw us pos'Ti.guz i fi'kow o'La~.du 'pe.la Za~'nE.la du 'kwaX.tu 'pa.ra u 'la.gu ki a'pe~.nas viz.lu~'bra.ra 'ko~.mu u~.ma 'so~.bra na 'noj.Ti a~.te.ri'oX
Era perfeito, liso como o vidro, a não ser pelo salto ocasional de alguma truta, lançando círculos de ondas em miniatura que se irradiavam pela superfície de um azul profundo até serem lentamente absorvidas de volta na superfície maior.	'E.ra peX'fej.tu, 'li.zu 'ko~.mu u 'vi.dru, a 'na~w~ 'seX 'pe.lu 'saw.tu o.ka.zi.o~'naw Di aw'gu~.ma 'tru.ta, la~'sa~.du 'siX.ku.lus Di 'o~.daz e~j~ mi~.ni.a'tu.ra ki si i.Ra.Di'a.va~w~ 'pe.la su.peX'fi.si Di u~ a'zuw pro'fu~.du a'tE 'se.re~j~ le~.ta~'me~.Ti ab.soR'vi.das Di 'vOw.ta na su.peX'fi.si maj'OX
Avaliou que a margem mais distante estaria a uns 800 metros.	a.va.li'ow ki a 'maR.Ze~j~ 'majs Dis'ta~.Ti es.ta'ri.a a u~z oj.tu'se~.tus 'mE.trus
O orvalho brilhava em toda parte como diamantes refletindo o amor do sol.	u oR'va.Lu bri'La.va e~j~ 'to.da 'paX.Ti 'ko~.mu Di.a~'ma~.Tis Re.fle'Ti~.du u a~'moR du 'sOw
As três canoas que repousavam tranquilas ao longo do cais pareciam convidativas, mas Mack afastou o pensamento.	as 'trejs ka~'no.as ki Re.pow'za.va~w~ tra~'kwi.laz aw 'lo~.gu du 'kajs pa.re'si.a~w~ ko~.vi.da'Ti.vas, majs 'mE.ki a.fas'tow u pe~.sa~'me~.tu
Canoas traziam muitas lembranças dolorosas.	ka~'no.as tra'zi.a~w~ 'mu~j~.tas le~'bra~.sas do.lo'rO.zas
O cais o fez lembrar-se da noite anterior.	u 'kajz u 'fejz le~'braX si da 'noj.Ti a~.te.ri'oX
Será que realmente havia se deitado ali com Aquele que fizera o universo?	se'ra ki Re.aw'me~.Ti a'vi.a si dej'ta.du a'li ko~ a'ke.li ki fi'zE.ra u u~.ni'vEX.su
Mack balançou a cabeça, perplexo.	'mE.ki ba.la~'sow a ka'be.sa, peX'plEk.su
O que estava acontecendo?	u ki es'ta.va a.ko~.te'se~.du
Quem eram eles e o que queriam?	'ke~j~ 'E.ra~w~ 'e.liz i u ki ke'ri.a~w~
O que quer que fosse, Mack estava certo de que não tinha nada para dar.	u ki 'kEX ki 'fo.si, 'mE.ki es'ta.va 'sEX.tu Di ki 'na~w~ 'Ti~.Ja 'na.da 'pa.ra 'daX
O cheiro de ovos e bacon ondulou para dentro do quarto, interrompendo seus pensamentos.	u 'Sej.ru Di 'O.vuz i 'bej.ko~ o~.du'low 'pa.ra 'de~.tru du 'kwaX.tu, i~.te.Ro~'pe~.du 'sews pe~.sa~'me~.tus
Ao entrar na sala, ouviu o som de uma música conhecida, de Bruce Cockburn, vindo da cozinha, e uma voz aguda de mulher acompanhando bastante bem: Ah, amor que incendeia o sol, mantenha-me aceso.	aw e~'traR na 'sa.la, ow'viw u 'so~ Di u~.ma 'mu.zi.ka ko~.Je'si.da, Di 'bru.si kO.ki'buR.ni, 'vi~.du da ko'zi~.Ja, i u~.ma 'vOjz a'gu.da Di mu'LEr a.ko~.pa~'Ja~.du bas'ta~.Ti 'be~j~, 'a, a~'moX ki i~.se~'dej.a u 'sOw, ma~'te~.Ja mi a'se.zu
Papai surgiu com pratos cheios de panquecas, batatas fritas e algum tipo de verdura.	pa'paj suR'Ziw ko~ 'pra.tu'Sej.us Di pa~'kE.kas, ba'ta.tas 'fri.taz i aw'gu~ 'Ti.pu Di veR'du.ra
Vestia uma roupa comprida e larga, de aparência africana, com uma faixa multicolorida no cabelo.	ves'Ti.a u~.ma 'Row.pa ko~'pri.da i 'laR.ga, Di a.pa're~.sja a.fri'ka~.na, ko~ u~.ma 'faj.Sa muw.Ti.ko.lo'ri.da nu ka'be.lu
Parecia radiante, quase reluzindo.	pa.re'si.a Ra.Di'a~.Ti, 'kwa.zi Re.lu'zi~.du
Sabe, exclamou ela, adoro as músicas dessa criança!	'sa.bi, es.kla~'mow 'E.la, a'dO.ru as 'mu.zi.kas 'dE.sa kri'a~.sa
Gosto especialmente do Bruce, você sabe.	'gOs.tu es.pe.si.aw'me~.Ti du 'bru.si, vo'se 'sa.bi
Ela olhou para Mack, que estava se sentando à mesa.	'E.la o'Low 'pa.ra 'mE.ki, ki es'ta.va si se~'ta~.du a 'me.za
Mack assentiu, com o apetite aumentando a cada segundo.	'mE.ki a.se~'Tiw, ko~ u a.pe'Ti.Ti aw~.me~'ta~.du a 'ka.da se'gu~.du
É, continuou ela, e sei que você também gosta dele.	E, ko~.Ti~.nu'ow 'E.la, i 'sej ki vo'se ta~'be~j~ 'gOs.ta 'de.li
Mack sorriu.	'mE.ki so'Riw
Era verdade.	'E.ra veR'da.Di
Então, querido, perguntou Papai, enquanto se ocupava com alguma coisa.	e~'ta~w~, ke'ri.du, peR.gu~'tow pa'paj, e~'kwa~.tu si o.ku'pa.va ko~ aw'gu~.ma 'koj.za
Como foram seus sonhos esta noite?	'ko~.mu 'fo.ra~w~ 'sews 'so~.Juz 'Es.ta 'noj.Ti
Algumas vezes os sonhos são importantes, você sabe.	aw'gu~.mas 've.ziz us 'so~.Jus 'sa~w~ i~.poX'ta~.Tis, vo'se 'sa.bi
Podem ser um modo de abrir a janela e deixar que o ar poluído saia.	'pO.de~j~ 'ser u~ 'mO.du Di a'brir a Za~'nE.la i dej'SaX ki u 'aX po.lu'i.du 'saj.a
Mack sabia que isso era um convite para destrancar a porta de seus terrores, mas no momento não estava pronto para convidá-la a entrar naquele buraco com ele.	'mE.ki sa'bi.a ki 'i.su 'E.ra u~ ko~'vi.Ti 'pa.ra des.tra~'kar a 'pOX.ta Di 'sews te'Ro.ris, majs nu mo~'me~.tu 'na~w~ es'ta.va 'pro~.tu 'pa.ra ko~.vi'da la a e~'traR na'ke.li bu'ra.ku ko~ 'e.li
Dormi bem, obrigado, respondeu e rapidamente mudou de assunto.	doR'mi 'be~j~, o.bri'ga.du, Res.po~'dew i Ra.pi.da~'me~.Ti mu'dow Di a'su~.tu
Quer dizer que Bruce é seu predileto?	'kER Di'zeX ki 'bru.si E 'sew pre.Di'lE.tu
Ela parou e olhou-o.	'E.la pa'row i o'Low u
Mackenzie, eu não tenho prediletos; apenas gosto especialmente dele.	ma'ke~.zi, ew 'na~w~ 'te~.Ju pre.Di'lE.tus, a'pe~.nas 'gOs.tu es.pe.si.aw'me~.Ti 'de.li
Você parece gostar especialmente de um monte de pessoas, observou Mack.	vo'se pa'rE.si gos'tar es.pe.si.aw'me~.Ti Di u~ 'mo~.Ti Di pe'so.as, ob.seR'vow 'mE.ki
E há alguém de quem você não goste especialmente?	i 'a aw'ge~j~ Di 'ke~j~ vo'se 'na~w~ 'gOs.Ti es.pe.si.aw'me~.Ti
Ela ergueu a cabeça e revirou os olhos como se estivesse examinando mentalmente o catálogo de cada ser criado.	'E.la eR'gew a ka'be.sa i Re.vi'row uz 'O.Lus 'ko~.mu si es.Ti'vE.si e.za~.mi~'na~.du me~.taw'me~.Ti u ka'ta.lo.gu Di 'ka.da 'seX kri'a.du
Não, não consigo encontrar ninguém.	'na~w~, 'na~w~ ko~'si.gu e~.ko~'traR ni~'ge~j~
Acho que sou assim.	'a.Su ki 'sow a'si~
Mack ficou interessado.	'mE.ki fi'kow i~.te.re'sa.du
Nunca fica furiosa com alguém?	'nu~.ka 'fi.ka fu.ri'O.za ko~ aw'ge~j~
Imagina! Que pai não fica?	i~.ma'Zi~.na, ki 'paj 'na~w~ 'fi.ka
Os filhos se metem em várias confusões que deixam a gente furiosa.	us 'fi.Lus si 'mE.te~j~ e~j~ 'va.rjas ko~.fu'zo~j~s ki 'dej.Sa~w~ a 'Ze~.Ti fu.ri'O.za
Não gosto de muitas das escolhas que eles fazem, mas essa minha raiva é uma expressão de amor.	'na~w~ 'gOs.tu Di 'mu~j~.tas daz es'ko.Las ki 'e.lis 'fa.ze~j~, majz 'E.sa 'mi~.Ja 'Raj.va E u~.ma es.pre'sa~w~ Di a~'moX
Eu amo aqueles de quem estou com raiva tanto quanto aqueles de quem não estou.	ew 'a~.mu a'ke.lis Di 'ke~j~ es'tow ko~ 'Raj.va 'ta~.tu 'kwa~.tu a'ke.lis Di 'ke~j~ 'na~w~ es'tow
Mas... Mack fez uma pausa.	majs, 'mE.ki 'fejz u~.ma 'paw.za
E a sua ira?	i a 'su.a 'i.ra
Parece que, se você pretende ser o Deus Todo-Poderoso, precisa ser muito mais irado.	pa'rE.si ki, si vo'se pre'te~.Di 'ser u 'dews 'to.du po.de'ro.zu, pre'si.za 'seR 'mu~j~.tu 'majz i'ra.du
É mesmo?	E 'mez.mu
É o que eu acho. Você não vivia matando gente na Bíblia?	E u ki ew 'a.Su, vo'se 'na~w~ vi'vi.a ma'ta~.du 'Ze~.Ti na 'bi.blja
Você não parece se encaixar naquele modelo.	vo'se 'na~w~ pa'rE.si si e~.kaj'SaR na'ke.li mo'de.lu
Entendo como tudo isso deve deixar você desorientado, Mack.	e~'te~.du 'ko~.mu 'tu.du 'i.su 'dE.vi dej'SaR vo'se de.zo.ri.e~'ta.du, 'mE.ki
Mas o único que está pretendendo ser alguma coisa aqui é você.	majz u 'u~.ni.ku ki es'ta pre.te~'de~.du 'ser aw'gu~.ma 'koj.za a'ki E vo'se
Eu sou o que sou.	ew 'sow u ki 'sow
Não estou tentando me encaixar em modelo nenhum.	'na~w~ es'tow te~'ta~.du mi e~.kaj'Sar e~j~ mo'de.lu ne~'Ju~
Não estou pedindo que acredite em nada, mas vou lhe dizer que você vai achar este dia muito mais fácil se simplesmente aceitá-lo como é, em vez de tentar encaixá-lo em suas idéias preconcebidas.	'na~w~ es'tow pe'Di~.du ki a.kre'Di.Ti e~j~ 'na.da, majs 'vow Li Di'zeX ki vo'se 'vaj a'Sar 'es.Ti 'Di.a 'mu~j~.tu 'majs 'fa.siw si si~.pliz'me~.Ti a.sej'ta lu 'ko~.mu E, e~j~ 'vejz Di te~'tar e~.kaj'Sa lu e~j~ 'su.az i'dEj.as pre.ko~.se'bi.das
Mas o Deus que me ensinaram derramou grandes doses de fúria, mandou o dilúvio e lançou pessoas num lago de fogo.	majz u 'dews ki mi e~.si~'na.ra~w~ de.Ra~'mow 'gra~.Dis 'dO.zis Di 'fu.rja, ma~'dow u Di'lu.vju i la~'sow pe'so.as nu~ 'la.gu Di 'fo.gu
Mack podia sentir sua raiva profunda emergindo de novo, fazendo brotar as perguntas, e se chateou um pouco com sua falta de controle.	'mE.ki po'Di.a se~'TiX 'su.a 'Raj.va pro'fu~.da e~.meR'Zi~.du Di 'no.vu, fa'ze~.du bro'tar as peR'gu~.tas, i si Sa.te'ow u~ 'pow.ku ko~ 'su.a 'faw.ta Di ko~'tro.li
Mas perguntou mesmo assim: Honestamente, você não gosta de castigar aqueles que a desapontam?	majs peR.gu~'tow 'mez.mu a'si~, o~.nEs.ta~'me~.Ti, vo'se 'na~w~ 'gOs.ta Di kas.Ti'gar a'ke.lis ki a de.za'po~.ta~w~
Diante disso, Papai interrompeu suas ocupações e virou-se para Mack.	Di'a~.Ti 'Di.su, pa'paj i~.te.Ro~'pew 'su.az o.ku.pa'so~j~z i vi'row si 'pa.ra 'mE.ki
Ele pôde ver uma tristeza profunda nos olhos dela.	'e.li 'po.Di 'ver u~.ma tris'te.za pro'fu~.da nuz 'O.Lus 'dE.la
Não sou quem você pensa, Mackenzie.	'na~w~ 'sow 'ke~j~ vo'se 'pe~.sa, ma'ke~.zi
Não preciso castigar as pessoas pelos pecados.	'na~w~ pre'si.zu kas.Ti'gar as pe'so.as 'pe.lus pe'ka.dus
O pecado é o próprio castigo, pois devora as pessoas por dentro.	u pe'ka.du E u 'prO.prju kas'Ti.gu, 'pojs de'vO.ra as pe'so.as puR 'de~.tru
Meu objetivo não é castigar.	'mew ob.Ze'Ti.vu 'na~w~ E kas.Ti'gaX
Minha alegria é curar.	'mi~.Ja a.le'gri.a E ku'raX
Não entendo...	'na~w~ e~'te~.du
Está certo. Não entende mesmo, disse ela com um sorriso meio triste.	es'ta 'sEX.tu, 'na~w~ e~'te~.Di 'mez.mu, 'Di.si 'E.la ko~ u~ so'Ri.zu 'mej.u 'tris.Ti
Mas, afinal de contas, você ainda não terminou.	majs, a.fi~'naw Di 'ko~.tas, vo'se a'i~.da 'na~w~ teR.mi~'now
Neste momento, Jesus e Sarayu entraram rindo pela porta dos fundos, entretidos numa conversa.	'nes.Ti mo~'me~.tu, Ze'zujz i sa.ra'ju e~'tra.ra~w~ 'Ri~.du 'pe.la 'pOX.ta dus 'fu~.dus, e~.tre'Ti.dus 'nu~.ma ko~'vEX.sa
Jesus chegou vestido praticamente como no dia anterior, com jeans e uma camisa azul-clara que fazia seus olhos castanhos se destacarem.	Ze'zuj.Se'gow ves'Ti.du pra.Ti.ka~'me~.Ti 'ko~.mu nu 'Di.a a~.te.ri'oX, ko~ 'Di~z i u~.ma ka~'mi.za a'zuw 'kla.ra ki fa'zi.a 'sewz 'O.Lus kas'ta~.Jus si des.ta'ka.re~j~
Sarayu, por outro lado, vestia algo tão fino e rendado que praticamente voava à mais tênue brisa.	sa.ra'ju, pur 'ow.tru 'la.du, ves'Ti.a 'aw.gu 'ta~w~ 'fi~.nu i Re~'da.du ki pra.Ti.ka~'me~.Ti vo'a.va a 'majs 'te~.nwi 'bri.za
Padrões de arco-íris tremeluziam e se alteravam a cada gesto dela.	pa'dro~j~s Di 'aX.ku 'i.ris tre~.me.lu'zi.a~w~ i si aw.te'ra.va~w~ a 'ka.da 'ZEs.tu 'dE.la
Mack se perguntou se em algum momento ela parava completamente de se mexer.	'mE.ki si peR.gu~'tow si e~j~ aw'gu~ mo~'me~.tu 'E.la pa'ra.va ko~.plE.ta~'me~.Ti Di si me'SeX
Papai inclinou-se para ficar com os olhos na mesma altura dos de Mack.	pa'paj i~.kli~'now si 'pa.ra fi'kaX ko~ uz 'O.Lus na 'mez.ma aw'tu.ra dus Di 'mE.ki
Você faz algumas perguntas interessantes.	vo'se 'fajz aw'gu~.mas peR'gu~.taz i~.te.re'sa~.Tis
Chegaremos a elas, prometo.	Se.ga're~.muz a 'E.las, pro~'me.tu
Mas agora vamos aproveitar o café da manhã.	majz a'gO.ra 'va~.muz a.pro.vej'tar u ka'fE da ma~'Ja~
Mack assentiu de novo um pouco sem graça enquanto voltava a atenção para a comida.	'mE.ki a.se~'Tiw Di 'no.vu u~ 'pow.ku se~j~ 'gra.sa e~'kwa~.tu vow'ta.va a a.te~'sa~w~ 'pa.ra a ko~'mi.da
Estava de fato com fome e havia muita coisa apetitosa.	es'ta.va Di 'fa.tu ko~ 'fo~.mi i a'vi.a 'mu~j~.ta 'koj.za a.pe.Ti'tO.za
Obrigado pelo café da manhã, disse a Papai, enquanto Jesus e Sarayu ocupavam seus lugares.	o.bri'ga.du 'pe.lu ka'fE da ma~'Ja~, 'Di.si a pa'paj, e~'kwa~.tu Ze'zujz i sa.ra'ju o.ku'pa.va~w~ 'sews lu'ga.ris
O quê? reagiu ela num horror fingido.	u 'ke, Re.a'Ziw 'E.la nu~ o'RoX fi~'Zi.du
Você não vai abaixar a cabeça e fechar os olhos?	vo'se 'na~w~ 'vaj a.baj'Sar a ka'be.sa i fe'Sar uz 'O.Lus
Ela começou a andar em direção à cozinha, fazendo pequenos muxoxos de reprovação.	'E.la ko~.me'sow a a~'dar e~j~ Di.re'sa~w~ a ko'zi~.Ja, fa'ze~.du pe'ke~.nus mu'So.Sus Di Re.pro.va'sa~w~
O que está acontecendo com este mundo?	u ki es'ta a.ko~.te'se~.du ko~ 'es.Ti 'mu~.du
Meu bem, não há de quê.	'mew 'be~j~, 'na~w~ 'a Di 'ke
Um instante depois retornou trazendo outra tigela com uma comida fumegante que desprendia um aroma maravilhoso e convidativo.	u~ i~s'ta~.Ti de'pojs Re.toR'now tra'ze~.du 'ow.tra Ti'ZE.la ko~ u~.ma ko~'mi.da fu~.me'ga~.Ti ki des.pre~'Di.a u~ a'ro~.ma ma.ra.vi'Lo.zu i ko~.vi.da'Ti.vu
Passaram as tigelas uns para os outros e Mack ficou fascinado enquanto olhava e ouvia Papai participar da conversa de Jesus e Sarayu.	pa'sa.ra~w~ as Ti'ZE.laz u~s 'pa.ra uz 'ow.truz i 'mE.ki fi'kow fa.si~'na.du e~'kwa~.tu o'La.va i ow'vi.a pa'paj paX.Ti.si'paR da ko~'vEX.sa Di Ze'zujz i sa.ra'ju
Estavam falando algo sobre conciliar uma família em crise, mas não foi o que eles falavam que atraiu Mack e sim como eles se relacionavam.	es'ta.va~w~ fa'la~.du 'aw.gu 'so.bri ko~.si.li'ar u~.ma fa~'mi.lja e~j~ 'kri.zi, majs 'na~w~ 'foj u ki 'e.lis fa'la.va~w~ ki a.tra'iw 'mE.ki i 'si~ 'ko~.mu 'e.lis si Re.la.si.o~'na.va~w~
Nunca vira três pessoas compartilharem sentimentos com tamanha simplicidade e beleza.	'nu~.ka 'vi.ra 'trejs pe'so.as ko~.paX.Ti'La.re~j~ se~.Ti~'me~.tus ko~ ta~'ma~.Ja si~.pli.si'da.Di i be'le.za
Cada um parecia mais interessado nos outros do que em si mesmo.	'ka.da 'u~ pa.re'si.a 'majz i~.te.re'sa.du nuz 'ow.trus du ki e~j~ 'si 'mez.mu
Então o que acha, Mack? perguntou Jesus, fazendo um gesto em sua direção.	e~'ta~w~ u ki 'a.Sa, 'mE.ki, peR.gu~'tow Ze'zujs, fa'ze~.du u~ 'ZEs.tu e~j~ 'su.a Di.re'sa~w~
Não faço a mínima idéia do que vocês estão falando, respondeu Mack com a boca cheia daquelas verduras saborosas.	'na~w~ 'fa.su a 'mi~.ni~.ma i'dEj.a du ki vo'sejz es'ta~w~ fa'la~.du, Res.po~'dew 'mE.ki ko~ a 'bo.ka 'Sej.a da'kE.las veR'du.ras sa.bo'rO.zas
Mas adoro o modo como falam.	majz a'dO.ru u 'mO.du 'ko~.mu 'fa.la~w~
Uau! disse Papai, que vinha retornando da cozinha com outro prato.	u'aw, 'Di.si pa'paj, ki 'vi~.Ja Re.toR'na~.du da ko'zi~.Ja ko~ 'ow.tru 'pra.tu
Vá com calma nessas verduras, rapaz.	'va ko~ 'kaw.ma 'nE.sas veR'du.ras, Ra'pajs
Se não tiver cuidado, elas podem dar uma bela dor de barriga.	si 'na~w~ Ti'vEX kuj'da.du, 'E.las 'pO.de~j~ 'dar u~.ma 'bE.la 'doR Di ba'Ri.ga
Certo, tentarei me lembrar, disse Mack servindo-se do prato que ela lhe oferecia.	'sEX.tu, te~.ta'rej mi le~'braX, 'Di.si 'mE.ki seR'vi~.du si du 'pra.tu ki 'E.la Li o.fe.re'si.a
Depois, virando-se de novo para Jesus, acrescentou: Adoro o modo como vocês se tratam.	de'pojs, vi'ra~.du si Di 'no.vu 'pa.ra Ze'zujs, a.kre.se~'tow, a'dO.ru u 'mO.du 'ko~.mu vo'sejs si 'tra.ta~w~
Certamente eu não esperaria que Deus fosse desse jeito.	sEX.ta~'me~.Ti ew 'na~w~ es.pe.ra'ri.a ki 'dews 'fo.si 'de.si 'Zej.tu
Mas vocês se tratam de uma forma tão amável!	majs vo'sejs si 'tra.ta~w~ Di u~.ma 'fOR.ma 'ta~w~ a~'ma.vew
Um não manda mais do que os outros dois?	'u~ 'na~w~ 'ma~.da 'majs du ki uz 'ow.trus 'dojs
Os três se entreolharam como se nunca tivessem pensado nisso.	us 'trejs si e~.tre.o'La.ra~w~ 'ko~.mu si 'nu~.ka Ti'vE.se~j~ pe~'sa.du 'ni.su
Um Espírito livre? sugeriu Papai.	u~ es'pi.ri.tu 'li.vri, su.Ze'riw pa'paj
Exatamente, um Espírito livre, mas ainda assim sob a orientação do Pai.	e.za.ta~'me~.Ti, u~ es'pi.ri.tu 'li.vri, majz a'i~.da a'si~ sob a o.ri.e~.ta'sa~w~ du 'paj
Faz sentido?	'fajs se~'Ti.du
Jesus olhou para Papai, tentando com alguma dificuldade manter uma aparência séria.	Ze'zujz o'Low 'pa.ra pa'paj, te~'ta~.du ko~ aw'gu~.ma Di.fi.kuw'da.Di ma~'ter u~.ma a.pa're~.sja 'sE.rja
Faz sentido para você, Abba?	'fajs se~'Ti.du 'pa.ra vo'se, 'a.ba
Francamente, não tenho a mínima idéia do que este homem está falando.	fra~.ka~'me~.Ti, 'na~w~ 'te~.Ju a 'mi~.ni~.ma i'dEj.a du ki 'es.Ti 'o~.me~j~ es'ta fa'la~.du
Papai franziu o rosto, como se estivesse se concentrando.	pa'paj fra~'ziw u 'Ros.tu, 'ko~.mu si es.Ti'vE.si si ko~.se~'tra~.du
Não, eu estava tentando entender, mas sinto muito.	'na~w~, ew es'ta.va te~'ta~.du e~.te~'deX, majs 'si~.tu 'mu~j~.tu
Para mim isso não tem pé nem cabeça.	'pa.ra 'mi~ 'i.su 'na~w~ te~j~ 'pE ne~j~ ka'be.sa
Vocês sabem do que estou falando. Mack ficou meio frustrado.	vo'sejs 'sa.be~j~ du ki es'tow fa'la~.du, 'mE.ki fi'kow 'mej.u frus'tra.du
Estou falando de quem está no comando.	es'tow fa'la~.du Di 'ke~j~ es'ta nu ko~'ma~.du
Vocês não têm uma cadeia de comando?	vo'sejs 'na~w~ 'te~j~ u~.ma ka'dej.a Di ko~'ma~.du
Cadeia de comando?	ka'dej.a Di ko~'ma~.du
Isso parece medonho! disse Jesus.	'i.su pa'rE.si me'do~.Ju, 'Di.si Ze'zujs
No mínimo opressivo, acrescentou Papai, enquanto os outros dois começavam a rir.	nu 'mi~.ni~.mu o.pre'si.vu, a.kre.se~'tow pa'paj, e~'kwa~.tu uz 'ow.trus 'dojs ko~.me'sa.va~w~ a 'RiX
Então, virando-se para Mack, cantou: Mesmo sendo correntes de ouro, ainda são correntes.	e~'ta~w~, vi'ra~.du si 'pa.ra 'mE.ki, ka~'tow, 'mez.mu 'se~.du ko'Re~.Tis Di 'ow.ru, a'i~.da 'sa~w~ ko'Re~.Tis
Ah, não se incomode com esses dois, interrompeu Sarayu, estendendo a mão para confortá-lo.	'a, 'na~w~ si i~.ko~'mO.Di ko~ 'e.sis 'dojs, i~.te.Ro~'pew sa.ra'ju, es.te~'de~.du a 'ma~w~ 'pa.ra ko~.foX'ta lu
Eles só estão brincando com você.	'e.lis 'sO es'ta~w~ bri~'ka~.du ko~ vo'se
Na verdade, este é um assunto que nos interessa.	na veR'da.Di, 'es.Ti E u~ a'su~.tu ki nuz i~.te'rE.sa
Mack assentiu, aliviado e meio chateado por ter de novo perdido o controle.	'mE.ki a.se~'Tiw, a.li.vi'a.du i 'mej.u Sa.te'a.du puX 'teR Di 'no.vu peR'Di.du u ko~'tro.li
Mackenzie, não existe conceito de autoridade superior entre nós, apenas de unidade.	ma'ke~.zi, 'na~w~ e'zis.Ti ko~'sej.tu Di aw.to.ri'da.Di su.pe.ri'or 'e~.tri 'nOjs, a'pe~.nas Di u~.ni'da.Di
Estamos num círculo de relacionamento e não numa cadeia de comando.	es'ta~.mus nu~ 'siX.ku.lu Di Re.la.si.o~.na~'me~.tu i 'na~w~ 'nu~.ma ka'dej.a Di ko~'ma~.du
O que você está vendo aqui é um relacionamento sem qualquer camada de poder.	u ki vo'se es'ta 've~.du a'ki E u~ Re.la.si.o~.na~'me~.tu se~j~ kwaw'kEX ka~'ma.da Di po'deX
Não precisamos exercer poder um sobre o outro porque sempre estamos procurando o melhor.	'na~w~ pre.si'za~.muz e.zeX'seX po'der 'u~ 'so.bri u 'ow.tru puX'ke 'se~.pri es'ta~.mus pro.ku'ra~.du u me'LOX
A hierarquia não faria sentido entre nós.	a i.e.raX'ki.a 'na~w~ fa'ri.a se~'Ti.du 'e~.tri 'nOjs
Na verdade, isso é um problema de vocês, não nosso.	na veR'da.Di, 'i.su E u~ pro'ble~.ma Di vo'sejs, 'na~w~ 'nO.su
Os humanos estão tão perdidos e estragados que para vocês é quase incompreensível que as pessoas possam trabalhar ou viver juntas sem que alguém esteja no comando.	uz u~'ma~.nuz es'ta~w~ 'ta~w~ peR'Di.duz i es.tra'ga.dus ki 'pa.ra vo'sejz E 'kwa.zi i~.ko~.pre.e~'si.vew ki as pe'so.as 'pO.sa~w~ tra.ba'Lar ow vi'veR 'Zu~.tas se~j~ ki aw'ge~j~ es'te.Za nu ko~'ma~.du
Mas qualquer instituição humana, desde as políticas até as empresariais, até mesmo o casamento, é governada por esse tipo de pensamento.	majs kwaw'kEr i~s.Ti.tuj'sa~w~ u~'ma~.na, 'dez.Di as po'li.Ti.kaz a'tE az e~.pre.za.ri'ajs, a'tE 'mez.mu u ka.za~'me~.tu, E go.veR'na.da pur 'e.si 'Ti.pu Di pe~.sa~'me~.tu
É a trama do nosso tecido social, declarou Mack.	E a 'tra~.ma du 'nO.su te'si.du so.si'aw, de.kla'row 'mE.ki
Que desperdício! disse Papai, pegando o prato vazio e indo para a cozinha.	ki des.peR'Di.sju, 'Di.si pa'paj, pe'ga~.du u 'pra.tu va'zi.u i 'i~.du 'pa.ra a ko'zi~.Ja
Esse é um dos motivos pelos quais é tão difícil para vocês experimentar o verdadeiro relacionamento, acrescentou Jesus.	'e.si E 'u~ dus mo'Ti.vus 'pe.lus 'kwajz E 'ta~w~ Di'fi.siw 'pa.ra vo'sejz es.pe.ri~.me~'tar u veR.da'dej.ru Re.la.si.o~.na~'me~.tu, a.kre.se~'tow Ze'zujs
Assim que montam uma hierarquia, vocês precisam de regras para protegê-la e administrá-la, e então precisam de leis e da aplicação das leis, e acabam criando algum tipo de cadeia de comando que destrói o relacionamento, em vez de promovê-lo.	a'si~ ki 'mo~.ta~w~ u~.ma i.e.raX'ki.a, vo'sejs pre'si.za~w~ Di 'RE.gras 'pa.ra pro.te'Ze la i a.Di~.mi~.nis'tra la, i e~'ta~w~ pre'si.za~w~ Di 'lejz i da a.pli.ka'sa~w~ das 'lejs, i a'ka.ba~w~ kri'a~.du aw'gu~ 'Ti.pu Di ka'dej.a Di ko~'ma~.du ki des'trOj u Re.la.si.o~.na~'me~.tu, e~j~ 'vejz Di pro~.mo've lu
Raramente vocês vivem o relacionamento fora do poder.	Ra.ra~'me~.Ti vo'sejs 'vi.ve~j~ u Re.la.si.o~.na~'me~.tu 'fO.ra du po'deX
A hierarquia impõe leis e regras e vocês acabam perdendo a maravilha do relacionamento que nós pretendemos para vocês.	a i.e.raX'ki.a i~'po~j~ 'lejz i 'RE.graz i vo'sejz a'ka.ba~w~ peR'de~.du a ma.ra'vi.La du Re.la.si.o~.na~'me~.tu ki 'nOjs pre.te~'de~.mus 'pa.ra vo'sejs
Bom, disse Mack com sarcasmo, recostando-se na cadeira.	'bo~, 'Di.si 'mE.ki ko~ saX'kaz.mu, Re.kos'ta~.du si na ka'dej.ra
Certamente parece que nos adaptamos muito bem a isso.	sEX.ta~'me~.Ti pa'rE.si ki nuz a.dap'ta~.mus 'mu~j~.tu 'be~j~ a 'i.su
Sarayu foi rápida em responder: Não confunda adaptação com intenção, ou sedução com realidade.	sa.ra'ju 'foj 'Ra.pi.da e~j~ Res.po~'deX, 'na~w~ ko~'fu~.da a.dap.ta'sa~w~ ko~ i~.te~'sa~w~, ow se.du'sa~w~ ko~ Re.a.li'da.Di
Então nós fomos seduzidos por essa preocupação com a autoridade?	e~'ta~w~ 'nOjs 'fo~.mus se.du'zi.dus pur 'E.sa prew.ku.pa'sa~w~ ko~ a aw.to.ri'da.Di
De certo modo, sim! respondeu Papai, passando o prato de verduras para Mack com uma certa relutância.	Di 'sEX.tu 'mO.du, 'si~, Res.po~'dew pa'paj, pa'sa~.du u 'pra.tu Di veR'du.ras 'pa.ra 'mE.ki ko~ u~.ma 'sEX.ta Re.lu'ta~.sja
Só estou cuidando de você, filho.	'sO es'tow kuj'da~.du Di vo'se, 'fi.Lu
Sarayu continuou: Quando vocês escolhem a independência nos relacionamentos tornam-se perigosos uns para os outros.	sa.ra'ju ko~.Ti~.nu'ow, 'kwa~.du vo'sejz es'kO.Le~j~ a i~.de.pe~'de~.sja nus Re.la.si.o~.na~'me~.tus 'tOR.na~w~ si pe.ri'gO.zuz u~s 'pa.ra uz 'ow.trus
As pessoas se tornam objetos a serem manipulados ou administrados para a felicidade de alguém.	as pe'so.as si 'tOR.na~w~ ob'ZE.tuz a 'se.re~j~ ma~.ni.pu'la.duz ow a.Di~.mi~.nis'tra.dus 'pa.ra a fe.li.si'da.Di Di aw'ge~j~
A autoridade, como vocês geralmente pensam nela, é meramente a desculpa que o forte usa para fazer com que os outros se sujeitem ao que ele quer.	a aw.to.ri'da.Di, 'ko~.mu vo'sejs Ze.raw'me~.Ti 'pe~.sa~w~ 'nE.la, E mE.ra~'me~.Ti a des'kuw.pa ki u 'fOX.Ti 'u.za 'pa.ra fa'zeX ko~ ki uz 'ow.trus si su'Zej.te~j~ aw ki 'e.li 'kEX
Ela não é útil para impedir que as pessoas lutem interminavelmente ou se machuquem?	'E.la 'na~w~ E 'u.Tiw 'pa.ra i~.pe'DiX ki as pe'so.as 'lu.te~j~ i~.teR.mi~.na.vew'me~.Ti ow si ma'Su.ke~j~
Às vezes.	as 've.zis
Mas num mundo egoísta também é usada para infligir grandes danos.	majs nu~ 'mu~.du e.go'is.ta ta~'be~j~ E u'za.da 'pa.ra i~.fli'ZiR 'gra~.Dis 'da~.nus
Mas vocês não a usam para conter o mal?	majs vo'sejs 'na~w~ a 'u.za~w~ 'pa.ra ko~'ter u 'maw
Nós respeitamos cuidadosamente as suas escolhas e por isso trabalhamos dentro dos seus sistemas, ao mesmo tempo que procuramos libertá-los deles, continuou Papai.	'nOjs Res.pej'ta~.mus kuj.da.dO.za~'me~.Ti as 'su.az es'ko.Laz i pur 'i.su tra.ba'La~.mus 'de~.tru dus 'sews sis'te~.mas, aw 'mez.mu 'te~.pu ki pro.ku'ra~.mus li.beX'ta lus 'de.lis, ko~.Ti~.nu'ow pa'paj
A Criação foi levada por um caminho muito diferente daquele que desejávamos.	a kri.a'sa~w~ 'foj le'va.da pur u~ ka~'mi~.Ju 'mu~j~.tu Di.fe're~.Ti da'ke.li ki de.ze'Za.va~.mus
Em seu mundo, o valor do indivíduo é constantemente medido em comparação com a sobrevivência do sistema, seja ele político, econômico, social ou religioso; na verdade, de qualquer sistema.	e~j~ 'sew 'mu~.du, u va'loR du i~.Di'vi.dwu E ko~s.ta~.Ti~'me~.Ti me'Di.du e~j~ ko~.pa.ra'sa~w~ ko~ a so.bre.vi've~.sja du sis'te~.ma, 'se.Za 'e.li po'li.Ti.ku, e.ko~'no~.mi.ku, so.si'aw ow Re.li.Zi'o.zu, na veR'da.Di, Di kwaw'kEX sis'te~.ma
Primeiro uma pessoa, depois umas poucas e finalmente muitas são facilmente sacrificadas pelo bem e pela permanência do sistema.	pri~'mej.ru u~.ma pe'so.a, de'pojz u~.mas 'pow.kaz i fi~.naw'me~.Ti 'mu~j~.tas 'sa~w~ fa.siw'me~.Ti sa.kri.fi'ka.das 'pe.lu 'be~j~ i 'pe.la peR.ma~'ne~.sja du sis'te~.ma
De uma forma ou de outra, isso está por trás de cada luta pelo poder, de cada preconceito, de cada guerra e de cada abuso de relacionamento.	Di u~.ma 'fOR.ma ow Di 'ow.tra, 'i.su es'ta puX 'trajs Di 'ka.da 'lu.ta 'pe.lu po'deX, Di 'ka.da pre.ko~'sej.tu, Di 'ka.da 'gE.Ra i Di 'ka.da a'bu.zu Di Re.la.si.o~.na~'me~.tu
A vontade de poder e independência se tornou tão disseminada que agora é considerada normal.	a vo~'ta.Di Di po'der i i~.de.pe~'de~.sja si toR'now 'ta~w~ Di.se~.mi~'na.da ki a'gO.ra E ko~.si.de'ra.da noR'maw
E não é?	i 'na~w~ E
É o paradigma humano, acrescentou Papai, após retornar com mais comida.	E u pa.ra'Di.gi~.ma u~'ma~.nu, a.kre.se~'tow pa'paj, a'pOjs Re.toR'naX ko~ 'majs ko~'mi.da
É como água para os peixes, tão natural que permanece sem ser vista e questionada.	E 'ko~.mu 'a.gwa 'pa.ra us 'pej.Sis, 'ta~w~ na.tu'raw ki peR.ma~'nE.si se~j~ 'seR 'vis.ta i kes.Ti.o~'na.da
É a matriz, uma trama diabólica em que vocês estão presos sem esperança, mesmo que completamente inconscientes da sua existência.	E a ma'tris, u~.ma 'tra~.ma Di.a'bO.li.ka e~j~ ki vo'sejz es'ta~w~ 'pre.zus se~j~ es.pe'ra~.sa, 'mez.mu ki ko~.plE.ta~'me~.Ti i~.ko~.si'e~.Tis da 'su.a e.zis'te~.sja
Jesus continuou: Como glória máxima da Criação, vocês foram feitos à nossa imagem.	Ze'zujs ko~.Ti~.nu'ow, 'ko~.mu 'glO.rja 'ma.si~.ma da kri.a'sa~w~, vo'sejs 'fo.ra~w~ 'fej.tuz a 'nO.sa i~'ma.Ze~j~
Se realmente tivessem aprendido a considerar que as preocupações dos outros têm tanto valor quanto as suas, não haveria necessidade de hierarquia.	si Re.aw'me~.Ti Ti'vE.se~j~ a.pre~'Di.du a ko~.si.de'raX ki as prew.ku.pa'so~j~s duz 'ow.trus 'te~j~ 'ta~.tu va'loX 'kwa~.tu as 'su.as, 'na~w~ a.ve'ri.a ne.se.si'da.Di Di i.e.raX'ki.a
Mack se recostou na cadeira, perplexo com as implicações do que ouvia.	'mE.ki si Re.kos'tow na ka'dej.ra, peX'plEk.su ko~ az i~.pli.ka'so~j~s du ki ow'vi.a
Então vocês estão me dizendo que sempre que nós, humanos, usamos o poder para nos proteger...	e~'ta~w~ vo'sejz es'ta~w~ mi Di'ze~.du ki 'se~.pri ki 'nOjs, u~'ma~.nus, u'za~.muz u po'deX 'pa.ra nus pro.te'ZeX
Estão cedendo à matriz e não a nós, terminou Jesus.	es'ta~w~ se'de~.du a ma'triz i 'na~w~ a 'nOjs, teR.mi~'now Ze'zujs
E agora, exclamou Sarayu, completamos o círculo, voltando a uma das minhas declarações iniciais: vocês, humanos, estão tão perdidos e estragados que não conseguem compreender um relacionamento sem hierarquia.	i a'gO.ra, es.kla~'mow sa.ra'ju, ko~.ple'ta~.muz u 'siX.ku.lu, vow'ta~.du a u~.ma das 'mi~.Jas de.kla.ra'so~j~z i~.ni.si'ajs, vo'sejs, u~'ma~.nus, es'ta~w~ 'ta~w~ peR'Di.duz i es.tra'ga.dus ki 'na~w~ ko~'sE.ge~j~ ko~.pre.e~'der u~ Re.la.si.o~.na~'me~.tu se~j~ i.e.raX'ki.a
Por isso acham que Deus se relaciona dentro de uma hierarquia, tal como vocês.	pur 'i.su 'a.Sa~w~ ki 'dews si Re.la.si'o~.na 'de~.tru Di u~.ma i.e.raX'ki.a, 'taw 'ko~.mu vo'sejs
Mas não somos assim.	majs 'na~w~ 'so~.muz a'si~
E como podemos mudar isso?	i 'ko~.mu po'de~.mus mu'dar 'i.su
Se abrirmos mão do poder e da hierarquia, as pessoas simplesmente vão nos usar.	si a'briR.mus 'ma~w~ du po'der i da i.e.raX'ki.a, as pe'so.as si~.pliz'me~.Ti 'va~w~ nuz u'zaX
Provavelmente sim.	pro.va.vew'me~.Ti 'si~
Mas não estamos pedindo que faça isso com os outros, Mack.	majs 'na~w~ es'ta~.mus pe'Di~.du ki 'fa.sa 'i.su ko~ uz 'ow.trus, 'mE.ki
Pedimos que faça conosco.	pe'Di~.mus ki 'fa.sa ko~'nos.ku
Este é o único lugar onde isso pode começar.	'es.Ti E u 'u~.ni.ku lu'gar 'o~.Di 'i.su 'pO.Di ko~.me'saX
Não vamos usar você.	'na~w~ 'va~.muz u'zaR vo'se
Mack, disse Papai com uma intensidade que o fez escutar com muita atenção, queremos compartilhar com você o amor, a alegria, a liberdade e a luz que já conhecemos em nós.	'mE.ki, 'Di.si pa'paj ko~ u~.ma i~.te~.si'da.Di ki u 'fejz es.ku'taX ko~ 'mu~j~.ta a.te~'sa~w~, ke're~.mus ko~.paX.Ti'LaX ko~ vo'se u a~'moX, a a.le'gri.a, a li.beR'da.Di i a 'lujs ki 'Za ko~.Je'se~.muz e~j~ 'nOjs
Criamos vocês, os humanos, para estarem num relacionamento de igual para igual conosco e para se juntarem ao nosso círculo de amor.	kri'a~.mus vo'sejs, uz u~'ma~.nus, 'pa.ra es'ta.re~j~ nu~ Re.la.si.o~.na~'me~.tu Di i'gwaw 'pa.ra i'gwaw ko~'nos.ku i 'pa.ra si Zu~'ta.re~j~ aw 'nO.su 'siX.ku.lu Di a~'moX
Por mais difícil que seja entender isso, tudo que aconteceu está ocorrendo exatamente segundo esse propósito, sem violar qualquer escolha ou vontade.	puR 'majs Di'fi.siw ki 'se.Za e~.te~'der 'i.su, 'tu.du ki a.ko~.te'sew es'ta o.ko'Re~.du e.za.ta~'me~.Ti se'gu~.du 'e.si pro'pO.zi.tu, se~j~ vi.o'laX kwaw'kEr es'ko.La ow vo~'ta.Di
A voz de Mack baixou até um sussurro.	a 'vOjz Di 'mE.ki baj'Sow a'tE u~ su'su.Ru
E qual é o valor de uma menininha ser assassinada por um tarado?	i 'kwaw E u va'loR Di u~.ma me~.ni~'ni~.Ja 'ser a.sa.si~'na.da pur u~ ta'ra.du
Ali estava de novo a pergunta que abria um buraco a fogo em sua alma.	a'li es'ta.va Di 'no.vu a peR'gu~.ta ki a'bri.a u~ bu'ra.ku a 'fo.gu e~j~ 'su.a 'aw.ma
Vocês podem não causar as coisas, mas certamente não as impedem.	vo'sejs 'pO.de~j~ 'na~w~ kaw'zar as 'koj.zas, majs sEX.ta~'me~.Ti 'na~w~ az i~'pE.de~j~
Mackenzie, respondeu Papai com ternura, aparentemente não se ofendendo com a acusação, há milhões de motivos para permitir a dor, a mágoa e o sofrimento, em vez de erradicá-los, mas a maioria desses motivos só pode ser entendida dentro da história de cada pessoa.	ma'ke~.zi, Res.po~'dew pa'paj ko~ teR'nu.ra, a.pa.re~.Ti~'me~.Ti 'na~w~ si o.fe~'de~.du ko~ a a.ku.za'sa~w~, 'a mi'Lo~j~s Di mo'Ti.vus 'pa.ra peR.mi'Tir a 'doX, a 'ma.gwa i u so.fri~'me~.tu, e~j~ 'vejz Di e.Ra.Di'ka lus, majz a maj.o'ri.a 'de.sis mo'Ti.vus 'sO 'pO.Di 'ser e~.te~'Di.da 'de~.tru da is'tO.rja Di 'ka.da pe'so.a
Eu não sou má.	ew 'na~w~ 'sow 'ma
Vocês é que abraçam o medo, a dor, o poder e os direitos em seus relacionamentos.	vo'sejz E ki a'bra.sa~w~ u 'me.du, a 'doX, u po'der i us Di'rej.tuz e~j~ 'sews Re.la.si.o~.na~'me~.tus
Mas suas escolhas também não são mais fortes do que os meus propósitos, e eu usarei cada escolha que vocês fizerem para o bem final e para o resultado mais amoroso.	majs 'su.az es'ko.Las ta~'be~j~ 'na~w~ 'sa~w~ 'majs 'fOX.Tis du ki us 'mews pro'pO.zi.tus, i ew u.za'rej 'ka.da es'ko.La ki vo'sejs fi'zE.re~j~ 'pa.ra u 'be~j~ fi~'naw i 'pa.ra u Re.zuw'ta.du 'majz a~.mo'ro.zu
Veja só, interveio Sarayu, os humanos feridos centram sua vida ao redor de coisas que parecem boas para eles, procurando compensação.	've.Za 'sO, i~.teR'vej.u sa.ra'ju, uz u~'ma~.nus fe'ri.dus 'se~.tra~w~ 'su.a 'vi.da aw Re'dOR Di 'koj.zas ki pa'rE.se~j~ 'bo.as 'pa.ra 'e.lis, pro.ku'ra~.du ko~.pe~.sa'sa~w~
Mas isso não irá preenchê-los nem libertá-los.	majz 'i.su 'na~w~ i'ra pre.e~'Se lus ne~j~ li.beX'ta lus
Eles são viciados em poder, ou na ilusão de segurança que o poder oferece.	'e.lis 'sa~w~ vi.si'a.duz e~j~ po'deX, ow na i.lu'za~w~ Di se.gu'ra~.sa ki u po'der o.fe'rE.si
Quando acontece um desastre, essas mesmas pessoas vão se voltar contra os falsos poderes nos quais confiavam.	'kwa~.du a.ko~'tE.si u~ de'zas.tri, 'E.sas 'mez.mas pe'so.as 'va~w~ si vow'taX 'ko~.tra us 'faw.sus po'de.ris nus 'kwajs ko~.fi'a.va~w~
Em seu desapontamento, se suavizam com relação a mim ou se tornam mais ousados em sua independência.	e~j~ 'sew de.za.po~.ta~'me~.tu, si su.a'vi.za~w~ ko~ Re.la'sa~w~ a 'mi~ ow si 'tOR.na~w~ 'majz ow'za.duz e~j~ 'su.a i~.de.pe~'de~.sja
Se você ao menos pudesse ver como tudo isso terminará e o que alcançaremos sem violar qualquer vontade humana, entenderia.	si vo'se aw 'me~.nus pu'dE.si 'veX 'ko~.mu 'tu.du 'i.su teR.mi~.na'ra i u ki aw.ka~.sa're~.mus se~j~ vi.o'laX kwaw'kER vo~'ta.Di u~'ma~.na, e~.te~.de'ri.a
Um dia entenderá.	u~ 'Di.a e~.te~.de'ra
Mas o custo! Mack estava aparvalhado.	majz u 'kus.tu, 'mE.ki es'ta.va a.paR.va'La.du
Ele parou e olhou para a mesa.	'e.li pa'row i o'Low 'pa.ra a 'me.za
E vejam o que custou para vocês.	i 've.Za~w~ u ki kus'tow 'pa.ra vo'sejs
Valeu a pena?	va'lew a 'pe~.na
Sim! foi a resposta unânime e jubilosa dos três.	'si~, 'foj a Res'pOs.ta u~'na~.ni~.mi i Zu.bi'lO.za dus 'trejs
Mas como podem dizer isso?	majs 'ko~.mu 'pO.de~j~ Di'zer 'i.su
Desse jeito parece que o fim justifica os meios, que para obter o que querem vocês são capazes de qualquer coisa, mesmo que isso custe a vida de bilhões de pessoas.	'de.si 'Zej.tu pa'rE.si ki u 'fi~ Zus.Ti'fi.ka us 'mej.us, ki 'pa.ra ob'ter u ki 'kE.re~j~ vo'sejs 'sa~w~ ka'pa.zis Di kwaw'kEX 'koj.za, 'mez.mu ki 'i.su 'kus.Ti a 'vi.da Di bi'Lo~j~s Di pe'so.as
Mackenzie. Era a voz de Papai outra vez, especialmente gentil e terna.	ma'ke~.zi, 'E.ra a 'vOjz Di pa'paj 'ow.tra 'vejs, es.pe.si.aw'me~.Ti Ze~'Tiw i 'tER.na
Você realmente ainda não entende.	vo'se Re.aw'me~.Ti a'i~.da 'na~w~ e~'te~.Di
Tenta dar sentido ao mundo em que vive baseado numa visão pequena e incompleta da realidade.	'te~.ta 'daX se~'Ti.du aw 'mu~.du e~j~ ki 'vi.vi ba.ze'a.du 'nu~.ma vi'za~w~ pe'ke~.na i i~.ko~'plE.ta da Re.a.li'da.Di
É como olhar um desfile pelo buraco minúsculo da dor, da mágoa, do egocentrismo e do poder e acreditar que você está sozinho e é insignificante.	E 'ko~.mu o'Lar u~ des'fi.li 'pe.lu bu'ra.ku mi~'nus.ku.lu da 'doX, da 'ma.gwa, du e.go.se~'triz.mu i du po'der i a.kre.Di'taX ki vo'se es'ta sO'zi~.Ju i E i~.si.gi~.ni.fi'ka~.Ti
Tudo isso contém mentiras poderosas.	'tu.du 'i.su ko~'te~j~ me~'Ti.ras po.de'rO.zas
Você vê a dor e a morte como males definitivos, e Deus como o traidor definitivo, ou talvez, na melhor das hipóteses, como fundamentalmente indigno de confiança.	vo'se 've a 'dor i a 'mOX.Ti 'ko~.mu 'ma.lis de.fi~.ni'Ti.vus, i 'dews 'ko~.mu u traj'doR de.fi~.ni'Ti.vu, ow taw'vejs, na me'LOR daz i'pO.te.zis, 'ko~.mu fu~.da~.me~.taw'me~.Ti i~'Di.gi~.nu Di ko~.fi'a~.sa
Você dita os termos, julga meus atos e me declara culpado.	vo'se 'Di.ta us 'teR.mus, 'Zuw.ga 'mewz 'a.tuz i mi de'kla.ra kuw'pa.du
Parou um instante e depois prosseguiu: A verdadeira falha implícita de sua vida, Mackenzie, é que você não acha que eu sou bom.	pa'row u~ i~s'ta~.Ti i de'pojs pro.se'giw, a veR.da'dej.ra 'fa.La i~'pli.si.ta Di 'su.a 'vi.da, ma'ke~.zi, E ki vo'se 'na~w~ 'a.Sa ki ew 'sow 'bo~
Se soubesse que eu sou bom e que tudo, os meios, os fins e todos os processos das vidas individuais, é coberto por minha bondade, mesmo que nem sempre entenda o que estou fazendo, confiaria em mim.	si sow'bE.si ki ew 'sow 'bo~ i ki 'tu.du, us 'mej.us, us 'fi~z i 'to.duz us pro'sE.sus das 'vi.daz i~.Di.vi.du'ajs, E ko'bEX.tu puR 'mi~.Ja bo~'da.Di, 'mez.mu ki ne~j~ 'se~.pri e~'te~.da u ki es'tow fa'ze~.du, ko~.fi.a'ri.a e~j~ 'mi~
Mas não confia.	majs 'na~w~ ko~'fi.a
Não? perguntou Mack, mas não era realmente uma pergunta.	'na~w~, peR.gu~'tow 'mE.ki, majs 'na~w~ 'E.ra Re.aw'me~.Ti u~.ma peR'gu~.ta
Era uma declaração, e ele sabia disso.	'E.ra u~.ma de.kla.ra'sa~w~, i 'e.li sa'bi.a 'Di.su
Os outros pareciam saber também e a mesa permaneceu em silêncio.	uz 'ow.trus pa.re'si.a~w~ sa'beX ta~'be~j~ i a 'me.za peR.ma~.ne'sew e~j~ si'le~.sju
Sarayu disse: Mackenzie, você não pode produzir confiança, assim como não pode fazer humildade.	sa.ra'ju 'Di.si, ma'ke~.zi, vo'se 'na~w~ 'pO.Di pro.du'ziX ko~.fi'a~.sa, a'si~ 'ko~.mu 'na~w~ 'pO.Di fa'zer u~.miw'da.Di
Ela existe ou não.	'E.la e'zis.Ti ow 'na~w~
A confiança é fruto de um relacionamento em que você sabe que é amado.	a ko~.fi'a~.sa E 'fru.tu Di u~ Re.la.si.o~.na~'me~.tu e~j~ ki vo'se 'sa.bi ki E a~'ma.du
Como não sabe que eu o amo, não pode confiar em mim.	'ko~.mu 'na~w~ 'sa.bi ki ew u 'a~.mu, 'na~w~ 'pO.Di ko~.fi'ar e~j~ 'mi~
De novo se fez silêncio.	Di 'no.vu si 'fejs si'le~.sju
Por fim Mack olhou para Papai e disse: Não sei como mudar isso.	puX 'fi~ 'mE.ki o'Low 'pa.ra pa'paj i 'Di.si, 'na~w~ 'sej 'ko~.mu mu'dar 'i.su
Você não pode mudar, pelo menos sozinho, mas juntos vamos ver essa mudança acontecer.	vo'se 'na~w~ 'pO.Di mu'daX, 'pe.lu 'me~.nus sO'zi~.Ju, ma'Zu~.tus 'va~.mus 'ver 'E.sa mu'da~.sa a.ko~.te'seX
Por enquanto só quero que você esteja comigo e descubra que nosso relacionamento não tem a ver com seu desempenho nem com qualquer obrigação de me agradar.	pur e~'kwa~.tu 'sO 'kE.ru ki vo'se es'te.Za ko~'mi.gu i des'ku.bra ki 'nO.su Re.la.si.o~.na~'me~.tu 'na~w~ te~j~ a 'veX ko~ 'sew de.ze~'pe~.Ju ne~j~ ko~ kwaw'kEr o.bri.ga'sa~w~ Di mi a.gra'daX
Não sou um valentão nem uma divindade egocêntrica e exigente que insiste que as coisas sejam feitas do jeito que eu quero.	'na~w~ 'sow u~ va.le~'ta~w~ ne~j~ u~.ma Di.vi~'da.Di e.go'se~.tri.ka i e.zi'Ze~.Ti ki i~'sis.Ti ki as 'koj.zas 'se.Za~w~ 'fej.tas du 'Zej.tu ki ew 'kE.ru
Sou boa e só desejo o que é melhor para você.	'sow 'bo.a i 'sO de'ze.Zu u ki E me'LOX 'pa.ra vo'se
Não é pela culpa, pela condenação ou pela coerção que você vai encontrar isso.	'na~w~ E 'pe.la 'kuw.pa, 'pe.la ko~.de~.na'sa~w~ ow 'pe.la ko.eX'sa~w~ ki vo'se 'vaj e~.ko~'trar 'i.su
É apenas praticando um relacionamento de amor.	E a'pe~.nas pra.Ti'ka~.du u~ Re.la.si.o~.na~'me~.tu Di a~'moX
E eu amo você.	i ew 'a~.mu vo'se
Sarayu se levantou da mesa e olhou diretamente para Mack.	sa.ra'ju si le.va~'tow da 'me.za i o'Low Di.rE.ta~'me~.Ti 'pa.ra 'mE.ki
Mackenzie, se você quiser, eu gostaria que viesse me ajudar no jardim.	ma'ke~.zi, si vo'se ki'zEX, ew gos.ta'ri.a ki vi'E.si mi a.Zu'daR nu ZaR'Di~
Há coisas que preciso fazer lá antes da celebração de amanhã.	'a 'koj.zas ki pre'si.zu fa'zeR 'la 'a~.Tis da se.le.bra'sa~w~ Di a~.ma~'Ja~
Podemos continuar nossa conversa lá fora, por favor?	po'de~.mus ko~.Ti~.nu'aR 'nO.sa ko~'vEX.sa 'la 'fO.ra, puX fa'voX
Claro, respondeu Mack, levantando-se.	'kla.ru, Res.po~'dew 'mE.ki, le.va~'ta~.du si
Um último comentário, ele acrescentou.	u~ 'uw.Ti~.mu ko~.me~'ta.rju, 'e.li a.kre.se~'tow
Simplesmente não consigo imaginar um resultado final que justifique tudo isso.	si~.pliz'me~.Ti 'na~w~ ko~'si.gu i~.ma.Zi~'nar u~ Re.zuw'ta.du fi~'naw ki Zus.Ti'fi.ki 'tu.du 'i.su
Mackenzie. Papai se levantou da cadeira e rodeou a mesa para lhe dar um abraço apertado.	ma'ke~.zi, pa'paj si le.va~'tow da ka'dej.ra i Ro.de'ow a 'me.za 'pa.ra Li 'dar u~ a'bra.su a.peX'ta.du
Não estamos justificando.	'na~w~ es'ta~.mu.Zus.Ti.fi'ka~.du
Estamos libertando.	es'ta~.mus li.beX'ta~.du
Mesmo que encontrássemos outro Éden, não teríamos condição de desfrutá-lo perfeitamente nem de ficar lá para sempre.	'mez.mu ki e~.ko~'tra.se~.muz 'ow.tru 'E.de~, 'na~w~ te'ri.a~.mus ko~.Di'sa~w~ Di des.fru'ta lu peX.fej.ta~'me~.Ti ne~j~ Di fi'kaR 'la 'pa.ra 'se~.pri
Mack acompanhou Sarayu pela porta dos fundos do melhor modo que pôde e seguiu pelo caminho, passando pela aléia de pinheiros.	'mE.ki a.ko~.pa~'Jow sa.ra'ju 'pe.la 'pOX.ta dus 'fu~.dus du me'LOR 'mO.du ki 'po.Di i se'giw 'pe.lu ka~'mi~.Ju, pa'sa~.du 'pe.la a'lEj.a Di pi~'Jej.rus
Andar atrás de um ser daqueles era como seguir um raio de sol.	a~'dar a'trajs Di u~ 'seR da'ke.liz 'E.ra 'ko~.mu se'gir u~ 'Raj.u Di 'sOw
A luz parecia se irradiar dela e refletir sua presença numa infinidade de lugares ao mesmo tempo.	a 'lujs pa.re'si.a si i.Ra.Di'aR 'dE.la i Re.fle'TiX 'su.a pre'ze~.sa 'nu~.ma i~.fi~.ni'da.Di Di lu'ga.riz aw 'mez.mu 'te~.pu
Mack concentrou-se no caminho.	'mE.ki ko~.se~'trow si nu ka~'mi~.Ju
Enquanto rodeava as árvores, viu pela primeira vez um magnífico jardim e pomar, contido num terreno que não teria mais de 4 mil metros quadrados.	e~'kwa~.tu Ro.de'a.va az 'aR.vo.ris, 'viw 'pe.la pri~'mej.ra 'vejz u~ ma.gi~'ni.fi.ku ZaR'Di~ i po~'maX, ko~'Ti.du nu~ te'Re~.nu ki 'na~w~ te'ri.a 'majs Di 'kwa.tru 'miw 'mE.trus kwa'dra.dus
Mack imaginara um jardim em estilo inglês, perfeitamente cuidado e organizado.	'mE.ki i~.ma.Zi~'na.ra u~ ZaR'Di~ e~j~ es'Ti.lu i~'glejs, peX.fej.ta~'me~.Ti kuj'da.du i oR.ga~.ni'za.du
Não era assim!	'na~w~ 'E.ra a'si~
Era um caos de cores.	'E.ra u~ 'kaws Di 'ko.ris
Jorros ofuscantes de flores se espalhavam em meio a legumes, verduras e ervas plantados aleatoriamente, um tipo de vegetação que Mack nunca vira.	'Zo.Ruz o.fus'ka~.Tis Di 'flo.ris si es.pa'La.va~w~ e~j~ 'mej.u a le'gu~.mis, veR'du.raz i 'ER.vas pla~'ta.duz a.le.a.tO.ri.a~'me~.Ti, u~ 'Ti.pu Di ve.Ze.ta'sa~w~ ki 'mE.ki 'nu~.ka 'vi.ra
Era confuso, espantoso e incrivelmente lindo.	'E.ra ko~'fu.zu, es.pa~'to.zu i i~.kri.vew'me~.Ti 'li~.du
Para mim parece uma confusão, murmurou Mack baixinho.	'pa.ra 'mi~ pa'rE.si u~.ma ko~.fu'za~w~, muR.mu'row 'mE.ki baj'Si~.Ju
Sarayu parou e se virou para Mack, com o rosto glorioso.	sa.ra'ju pa'row i si vi'row 'pa.ra 'mE.ki, ko~ u 'Ros.tu glo.ri'o.zu
Mack! Obrigada!	'mE.ki, o.bri'ga.da
Que elogio maravilhoso! Ela olhou o jardim ao redor.	ki e.lo'Zi.u ma.ra.vi'Lo.zu, 'E.la o'Low u ZaR'Di~ aw Re'dOX
É exatamente isso, uma confusão.	E e.za.ta~'me~.Ti 'i.su, u~.ma ko~.fu'za~w~
Sarayu se aproximou de uma erva, arrancou alguns brotos e virou-se para Mack.	sa.ra'ju si a.pro.si~'mow Di u~.ma 'ER.va, a.Ra~'kow aw'gu~s 'bro.tuz i vi'row si 'pa.ra 'mE.ki
Papai não estava brincando no café da manhã, disse, a voz parecendo mais música do que qualquer outra coisa.	pa'paj 'na~w~ es'ta.va bri~'ka~.du nu ka'fE da ma~'Ja~, 'Di.si, a 'vOjs pa.re'se~.du 'majs 'mu.zi.ka du ki kwaw'kEr 'ow.tra 'koj.za
É melhor você mastigar essa erva por alguns minutos.	E me'LOR vo'se mas.Ti'gar 'E.sa 'ER.va pur aw'gu~s mi~'nu.tus
Vai se contrapor ao movimento natural daquelas verduras que você comeu demais, se é que me entende.	'vaj si ko~.tra'por aw mo.vi~'me~.tu na.tu'raw da'kE.las veR'du.ras ki vo'se ko~'mew de~'majs, si E ki mi e~'te~.Di
Mack deu um risinho enquanto aceitava e, com algum cuidado, começou a mastigar.	'mE.ki 'dew u~ Ri'zi~.Ju e~'kwa~.tu a.sej'ta.va i, ko~ aw'gu~ kuj'da.du, ko~.me'sow a mas.Ti'gaX
É, mas o gosto daquelas verduras era bom demais!	E, majz u 'gos.tu da'kE.las veR'du.raz 'E.ra 'bo~ de~'majs
Seu estômago havia começado a se revirar um pouco.	'sew es'to~.ma.gu a'vi.a ko~.me'sa.du a si Re.vi'rar u~ 'pow.ku
O gosto da erva não era desagradável: uma sugestão de hortelã e alguns outros temperos que ele provavelmente já havia cheirado antes, mas que não podia identificar.	u 'gos.tu da 'ER.va 'na~w~ 'E.ra de.za.gra'da.vew, u~.ma su.Zes'ta~w~ Di oX.te'la~ i aw'gu~z 'ow.trus te~'pe.rus ki 'e.li pro.va.vew'me~.Ti 'Za a'vi.a Sej'ra.du 'a~.Tis, majs ki 'na~w~ po'Di.a i.de~.Ti.fi'kaX
Enquanto andavam, seu estômago foi se aplacando e ele relaxou.	e~'kwa~.tu a~'da.va~w~, 'sew es'to~.ma.gu 'foj si a.pla'ka~.du i 'e.li Re.la'Sow
Sem dizer uma palavra, tentou seguir Sarayu de um lugar a outro no jardim, mas acabou se distraindo com as incríveis misturas de cores.	se~j~ Di'zer u~.ma pa'la.vra, te~'tow se'giX sa.ra'ju Di u~ lu'gar a 'ow.tru nu ZaR'Di~, majz a.ka'bow si Dis.tra'i~.du ko~ az i~'kri.vejs mis'tu.ras Di 'ko.ris
Era tudo maravilhosamente espantoso e inebriante.	'E.ra 'tu.du ma.ra.vi.LO.za~'me~.Ti es.pa~'to.zu i i~.ne.bri'a~.Ti
Sarayu parecia muito concentrada numa tarefa específica.	sa.ra'ju pa.re'si.a 'mu~j~.tu ko~.se~'tra.da 'nu~.ma ta'rE.fa es.pe'si.fi.ka
Oscilava como um vento brincalhão e ele jamais sabia exatamente para onde ela estava soprando.	o.si'la.va 'ko~.mu u~ 've~.tu bri~.ka'La~w~ i 'e.li Za~'majs sa'bi.a e.za.ta~'me~.Ti 'pa.ra 'o~.Di 'E.la es'ta.va so'pra~.du
Achava bastante difícil acompanhá-la.	a'Sa.va bas'ta~.Ti Di'fi.siw a.ko~.pa~'Ja la
Ela se movia pelo jardim cortando várias flores e ervas e entregando para Mack carregar.	'E.la si mo'vi.a 'pe.lu ZaR'Di~ koX'ta~.du 'va.rjas 'flo.riz i 'ER.vaz i e~.tre'ga~.du 'pa.ra 'mE.ki ka.Re'gaX
O buquê improvisado ficou bastante grande, uma linda massa aromática diferente de qualquer coisa que ele já havia cheirado e tão forte que quase dava para sentir o gosto.	u bu'ke i~.pro.vi'za.du fi'kow bas'ta~.Ti 'gra~.Di, u~.ma 'li~.da 'ma.sa a.ro~'ma.Ti.ka Di.fe're~.Ti Di kwaw'kEX 'koj.za ki 'e.li 'Za a'vi.a Sej'ra.du i 'ta~w~ 'fOX.Ti ki 'kwa.zi 'da.va 'pa.ra se~'Tir u 'gos.tu
Depositaram o buquê final dentro de uma pequena oficina que Mack não havia notado antes, como se estivesse enterrada num adensamento de mato selvagem.	de.po.zi'ta.ra~w~ u bu'ke fi~'naw 'de~.tru Di u~.ma pe'ke~.na o.fi'si~.na ki 'mE.ki 'na~w~ a'vi.a no'ta.du 'a~.Tis, 'ko~.mu si es.Ti'vE.si e~.te'Ra.da nu~ a.de~.sa~'me~.tu Di 'ma.tu sew'va.Ze~j~
Uma tarefa terminada, anunciou Sarayu, e outra pela frente.	u~.ma ta'rE.fa teR.mi~'na.da, a~.nu~.si'ow sa.ra'ju, i 'ow.tra 'pe.la 'fre~.Ti
Entregou a Mack uma pá, um ancinho, uma foice e um par de luvas e flutuou por uma trilha coberta de mato que parecia ir em direção à extremidade mais distante do jardim.	e~.tre'gow a 'mE.ki u~.ma 'pa, u~ a~'si~.Ju, u~.ma 'foj.si i u~ 'paR Di 'lu.vaz i flu.tu'ow pur u~.ma 'tri.La ko'bEX.ta Di 'ma.tu ki pa.re'si.a 'ir e~j~ Di.re'sa~w~ a es.tre~.mi'da.Di 'majs Dis'ta~.Ti du ZaR'Di~
Pelo caminho, às vezes diminuía a velocidade para tocar uma planta ou uma flor, sempre cantarolando a música repetitiva que havia cativado Mack na tarde anterior.	'pe.lu ka~'mi~.Ju, as 've.zis Di~.mi~.nu'i.a a ve.lo.si'da.Di 'pa.ra to'kar u~.ma 'pla~.ta ow u~.ma 'floX, 'se~.pri ka~.ta.ro'la~.du a 'mu.zi.ka Re.pe.Ti'Ti.va ki a'vi.a ka.Ti'va.du 'mE.ki na 'taR.Di a~.te.ri'oX
Ele seguia, obediente, levando as ferramentas.	'e.li se'gi.a, o.be.Di'e~.Ti, le'va~.du as fe.Ra~'me~.tas
Quando Sarayu parou, Mack quase chocou-se com ela.	'kwa~.du sa.ra'ju pa'row, 'mE.ki 'kwa.zi So'kow si ko~ 'E.la
De algum modo Sarayu havia mudado; agora vestia roupas de trabalho: jeans com estampados loucos, uma camisa de trabalho e luvas.	Di aw'gu~ 'mO.du sa.ra'ju a'vi.a mu'da.du, a'gO.ra ves'Ti.a 'Row.pas Di tra'ba.Lu, 'Di~s ko~ es.ta~'pa.dus 'low.kus, u~.ma ka~'mi.za Di tra'ba.Lu i 'lu.vas
Estavam num local aberto, rodeado por pereiras e cerejeiras, no meio do qual havia uma cascata de arbustos com flores roxas e amarelas de tirar o fôlego.	es'ta.va~w~ nu~ lo'kaw a'bEX.tu, Ro.de'a.du puX pe'rej.raz i se.re'Zej.ras, nu 'mej.u du 'kwaw a'vi.a u~.ma kas'ka.ta Di aR'bus.tus ko~ 'flo.ris 'Ro.Saz i a~.ma'rE.las Di Ti'rar u 'fo.le.gu
Mackenzie, ela apontou diretamente para o incrível trecho florido, gostaria que você me ajudasse a limpar todo esse terreno.	ma'ke~.zi, 'E.la a.po~'tow Di.rE.ta~'me~.Ti 'pa.ra u i~'kri.vew 'tre.Su flo'ri.du, gos.ta'ri.a ki vo'se mi a.Zu'da.si a li~'paX 'to.du 'e.si te'Re~.nu
Há uma coisa muito especial que quero plantar aqui amanhã, e temos de deixar tudo pronto.	'a u~.ma 'koj.za 'mu~j~.tu es.pe.si'aw ki 'kE.ru pla~'tar a'ki a~.ma~'Ja~, i 'te~.mus Di dej'SaX 'tu.du 'pro~.tu
Olhou para Mack e estendeu a mão para a foice.	o'Low 'pa.ra 'mE.ki i es.te~'dew a 'ma~w~ 'pa.ra a 'foj.si
Você não pode estar falando sério!	vo'se 'na~w~ 'pO.Di es'taX fa'la~.du 'sE.rju
Isso é tão maravilhoso!	'i.su E 'ta~w~ ma.ra.vi'Lo.zu
Mas Sarayu pareceu não notar.	majs sa.ra'ju pa.re'sew 'na~w~ no'taX
Sem mais explicações, virou-se e começou a destruir o espetáculo artístico das flores.	se~j~ 'majz es.pli.ka'so~j~s, vi'row si i ko~.me'sow a des.tru'ir u es.pe'ta.ku.lu aX'Tis.Ti.ku das 'flo.ris
Fazia cortes limpos, aparentemente sem esforço.	fa'zi.a 'kOX.Tis 'li~.pus, a.pa.re~.Ti~'me~.Ti se~j~ es'foX.su
Mack deu de ombros, calçou as luvas e começou a amontoar em pilhas o estrago que ela estava fazendo.	'mE.ki 'dew Di 'o~.brus, kaw'sow as 'lu.vaz i ko~.me'sow a a~.mo~.to'ar e~j~ 'pi.Laz u es'tra.gu ki 'E.la es'ta.va fa'ze~.du
Lutava para acompanhar o ritmo.	lu'ta.va 'pa.ra a.ko~.pa~'Jar u 'Ri.Ti~.mu
Para ela talvez não fosse um esforço, mas para ele era um trabalho estafante.	'pa.ra 'E.la taw'vejz 'na~w~ 'fo.si u~ es'foX.su, majs 'pa.ra 'e.li 'E.ra u~ tra'ba.Lu es.ta'fa~.Ti
Os antebraços de Mack estavam riscados com marcas de arranhões dos galhos que havia empilhado.	uz a~.te'bra.sus Di 'mE.ki es'ta.va~w~ Ris'ka.dus ko~ 'maX.kas Di a.Ra~'Jo~j~s dus 'ga.Lus ki a'vi.a e~.pi'La.du
Estava sem fôlego e suando, feliz por terminar.	es'ta.va se~j~ 'fo.le.gu i su'a~.du, fe'lis puX teR.mi~'naX
Sarayu parou, examinando o trabalho.	sa.ra'ju pa'row, e.za~.mi~'na~.du u tra'ba.Lu
Não é empolgante? perguntou.	'na~w~ E e~.pow'ga~.Ti, peR.gu~'tow
Já me empolguei com coisas melhores, retrucou Mack, sarcástico.	'Za mi e~.pow'gej ko~ 'koj.zas me'LO.ris, Re.tru'kow 'mE.ki, saX'kas.Ti.ku
Ah, Mackenzie, se você soubesse.	'a, ma'ke~.zi, si vo'se sow'bE.si
Não é o trabalho, e sim o propósito que o torna especial.	'na~w~ E u tra'ba.Lu, i 'si~ u pro'pO.zi.tu ki u 'tOR.na es.pe.si'aw
E, ela sorriu, é o único tipo que eu faço.	i, 'E.la so'Riw, E u 'u~.ni.ku 'Ti.pu ki ew 'fa.su
Mack se apoiou no ancinho, olhou o jardim ao redor e os vergões vermelhos nos braços.	'mE.ki si a.poj'ow nu a~'si~.Ju, o'Low u ZaR'Di~ aw Re'dOr i us veR'go~j~s veR'me.Lus nus 'bra.sus
Sarayu, sei que você é o Criador. Mas você fez as plantas venenosas, as urtigas e os mosquitos também?	sa.ra'ju, 'sej ki vo'se E u kri.a'doX, majs vo'se 'fejz as 'pla~.tas ve~.ne~'nO.zas, az uX'Ti.gaz i us mos'ki.tus ta~'be~j~
Mackenzie, respondeu Sarayu, parecendo se mover junto com a brisa.	ma'ke~.zi, Res.po~'dew sa.ra'ju, pa.re'se~.du si mo'veR 'Zu~.tu ko~ a 'bri.za
Para fazer algo diferente, um ser criado tem que partir do que já existe.	'pa.ra fa'zer 'aw.gu Di.fe're~.Ti, u~ 'seX kri'a.du te~j~ ki paX'TiR du ki 'Za e'zis.Ti
Então você está dizendo que...	e~'ta~w~ vo'se es'ta Di'ze~.du ki
Mas, quando as criei, elas eram boas, porque é assim que eu sou.	majs, 'kwa~.du as kri'ej, 'E.laz 'E.ra~w~ 'bo.as, puX'ke E a'si~ ki ew 'sow
Ela pareceu quase se dobrar numa reverência antes de retomar sua tarefa.	'E.la pa.re'sew 'kwa.zi si do'braR 'nu~.ma Re.ve're~.sja 'a~.Tis Di Re.to~'maX 'su.a ta'rE.fa
Mas, continuou Mack, insatisfeito, então por que tantas coisas boas ficaram ruins?	majs, ko~.Ti~.nu'ow 'mE.ki, i~.sa.Tis'fej.tu, e~'ta~w~ puX 'ke 'ta~.tas 'koj.zas 'bo.as fi'ka.ra~w~ Ru'i~s
Agora Sarayu parou antes de responder.	a'gO.ra sa.ra'ju pa'row 'a~.Tis Di Res.po~'deX
Vocês, humanos, são verdadeiramente cegos em relação ao seu lugar na Criação.	vo'sejs, u~'ma~.nus, 'sa~w~ veR.da.dej.ra~'me~.Ti 'sE.guz e~j~ Re.la'sa~w~ aw 'sew lu'gaR na kri.a'sa~w~
Ela balançou a cabeça e o vento sussurrou pelas árvores próximas.	'E.la ba.la~'sow a ka'be.sa i u 've~.tu su.su'Row 'pe.laz 'aR.vo.ris 'prO.si~.mas
É muito triste, mas não será assim para sempre.	E 'mu~j~.tu 'tris.Ti, majs 'na~w~ se'ra a'si~ 'pa.ra 'se~.pri
Os dois desfrutaram alguns instantes de silêncio, enquanto Mack contemplava as várias plantas ao alcance de sua vista.	us 'dojs des.fru'ta.ra~w~ aw'gu~z i~s'ta~.Tis Di si'le~.sju, e~'kwa~.tu 'mE.ki ko~.te~'pla.va as 'va.rjas 'pla~.taz aw aw'ka~.si Di 'su.a 'vis.ta
Então existem plantas venenosas neste jardim? perguntou.	e~'ta~w~ e'zis.te~j~ 'pla~.tas ve~.ne~'nO.zas 'nes.Ti ZaR'Di~, peR.gu~'tow
Ah, sim, exclamou Sarayu.	'a, 'si~, es.kla~'mow sa.ra'ju
São algumas das minhas prediletas.	'sa~w~ aw'gu~.mas das 'mi~.Jas pre.Di'lE.tas
Há certas plantas perigosas ao toque, como esta aqui.	'a 'sEX.tas 'pla~.tas pe.ri'gO.zaz aw 'tO.ki, 'ko~.mu 'Es.ta a'ki
Ela estendeu a mão para um arbusto próximo e arrancou algo que parecia um graveto morto com apenas algumas folhas minúsculas que brotavam da haste.	'E.la es.te~'dew a 'ma~w~ 'pa.ra u~ aR'bus.tu 'prO.si~.mu i a.Ra~'kow 'aw.gu ki pa.re'si.a u~ gra've.tu 'moX.tu ko~ a'pe~.naz aw'gu~.mas 'fo.Las mi~'nus.ku.las ki bro'ta.va~w~ da 'as.Ti
Entregou a Mack, que levantou as duas mãos evitando tocá-lo.	e~.tre'gow a 'mE.ki, ki le.va~'tow as 'du.as 'ma~w~z e.vi'ta~.du to'ka lu
Sarayu riu.	sa.ra'ju 'Riw
Eu estou aqui, Mack.	ew es'tow a'ki, 'mE.ki
Há ocasiões em que é seguro tocar e ocasiões em que é preciso tomar precauções.	'a o.ka.zi'o~j~z e~j~ ki E se'gu.ru to'kar i o.ka.zi'o~j~z e~j~ ki E pre'si.zu to~'maX pre.kaw'so~j~s
Esta é a maravilha e a aventura da exploração, uma parte do que vocês chamam de ciência: discernir e descobrir o que nós escondemos.	'Es.ta E a ma.ra'vi.La i a a.ve~'tu.ra da es.plo.ra'sa~w~, u~.ma 'paX.Ti du ki vo'sej'Sa~.ma~w~ Di si'e~.sja, Di.seR'nir i des.ko'brir u ki 'nOjz es.ko~'de~.mus
Então por que esconderam?	e~'ta~w~ puX 'ke es.ko~'de.ra~w~
Por que as crianças adoram brincar de esconde-esconde?	puX 'ke as kri'a~.saz a'dO.ra~w~ bri~'kaR Di es'ko~.Di es'ko~.Di
Pergunte a qualquer pessoa que tenha paixão por explorar, descobrir e criar.	peR'gu~.Ti a kwaw'kEX pe'so.a ki 'te~.Ja paj'Sa~w~ pur es.plo'raX, des.ko'brir i kri'aX
Escolhemos esconder tantas maravilhas de vocês como um ato de amor, um verdadeiro presente dentro do processo da vida.	es.ko'Le~.muz es.ko~'deX 'ta~.tas ma.ra'vi.Las Di vo'sejs 'ko~.mu u~ 'a.tu Di a~'moX, u~ veR.da'dej.ru pre'ze~.Ti 'de~.tru du pro'sE.su da 'vi.da
Mack estendeu a mão cautelosamente e pegou o galho venenoso.	'mE.ki es.te~'dew a 'ma~w~ kaw.te.lO.za~'me~.Ti i pe'gow u 'ga.Lu ve~.ne~'no.zu
Se você não tivesse me dito que era seguro tocar, ele teria me envenenado?	si vo'se 'na~w~ Ti'vE.si mi 'Di.tu ki 'E.ra se'gu.ru to'kaX, 'e.li te'ri.a mi e~.ve~.ne~'na.du
Mas, se eu o der para você tocar, é diferente.	majs, si ew u 'dEX 'pa.ra vo'se to'kaX, E Di.fe're~.Ti
Então por que criar plantas venenosas? perguntou Mack, devolvendo o galho.	e~'ta~w~ puX 'ke kri'aX 'pla~.tas ve~.ne~'nO.zas, peR.gu~'tow 'mE.ki, de.vow've~.du u 'ga.Lu
Sua pergunta parte do princípio de que o veneno é algo ruim, uma coisa sem propósito.	'su.a peR'gu~.ta 'paX.Ti du pri~'si.puj Di ki u ve~'ne~.nu E 'aw.gu Ru'i~, u~.ma 'koj.za se~j~ pro'pO.zi.tu
Muitas das supostas plantas ruins, como esta, contêm propriedades incríveis de curar ou são necessárias para criar maravilhas magníficas quando combinadas com outros elementos.	'mu~j~.tas das su'pOs.tas 'pla~.tas Ru'i~s, 'ko~.mu 'Es.ta, ko~'te~j~ pro.pri.e'da.Diz i~'kri.vejs Di ku'rar ow 'sa~w~ ne.se'sa.rjas 'pa.ra kri'aR ma.ra'vi.Las ma.gi~'ni.fi.kas 'kwa~.du ko~.bi~'na.das ko~ 'ow.truz e.le~'me~.tus
Os humanos apressam-se em declarar que algo é bom ou ruim sem saber de fato.	uz u~'ma~.nuz a'prE.sa~w~ si e~j~ de.kla'raX ki 'aw.gu E 'bo~ ow Ru'i~ se~j~ sa'beR Di 'fa.tu
Sarayu estendeu uma pá pequena para Mack e pegou o ancinho.	sa.ra'ju es.te~'dew u~.ma 'pa pe'ke~.na 'pa.ra 'mE.ki i pe'gow u a~'si~.Ju
É trabalho duro, mas vale a pena.	E tra'ba.Lu 'du.ru, majs 'va.li a 'pe~.na
Certo, grunhiu Mack, enquanto os dois se ajoelhavam no terreno recém-limpo.	'sEX.tu, gru~'Jiw 'mE.ki, e~'kwa~.tu us 'dojs si a.Zo.e'La.va~w~ nu te'Re~.nu Re'se~j~ 'li~.pu
De algum modo Sarayu conseguia enfiar as mãos mais fundo no chão e encontrar as pontas das raízes, trazendo-as sem esforço à superfície.	Di aw'gu~ 'mO.du sa.ra'ju ko~.se'gi.a e~.fi'ar as 'ma~w~s 'majs 'fu~.du nu 'Sa~w~ i e~.ko~'trar as 'po~.tas das Ra'i.zis, tra'ze~.du as se~j~ es'foX.su a su.peX'fi.si
Deixou as mais curtas para Mack, que usava a pazinha para arrancá-las.	dej'Sow as 'majs 'kuX.tas 'pa.ra 'mE.ki, ki u'za.va a pa'zi~.Ja 'pa.ra a.Ra~'ka las
Depois jogavam as raízes numa das pilhas que Mack havia juntado antes.	de'poj.Zo'ga.va~w~ as Ra'i.zis 'nu~.ma das 'pi.Las ki 'mE.ki a'vi.a Zu~'ta.du 'a~.Tis
Mais tarde vou queimar isso, disse ela.	'majs 'taR.Di 'vow kej~'mar 'i.su, 'Di.si 'E.la
Antes você estava falando que os humanos declaram que as coisas são boas ou ruins sem conhecer? perguntou Mack, sacudindo a terra de uma raiz.	'a~.Tis vo'se es'ta.va fa'la~.du ki uz u~'ma~.nus de'kla.ra~w~ ki as 'koj.zas 'sa~w~ 'bo.az ow Ru'i~s se~j~ ko~.Je'seX, peR.gu~'tow 'mE.ki, sa.ku'Di~.du a 'tE.Ra Di u~.ma Ra'is
É. Estava falando especificamente da árvore do conhecimento do bem e do mal.	E, es'ta.va fa'la~.du es.pe.si.fi.ka~'me~.Ti da 'aR.vo.ri du ko~.Je.si~'me~.tu du 'be~j~ i du 'maw
A árvore do conhecimento do bem e do mal?	a 'aR.vo.ri du ko~.Je.si~'me~.tu du 'be~j~ i du 'maw
Exato! declarou ela.	e'za.tu, de.kla'row 'E.la
E agora, Mackenzie, você está começando a entender por que comer o fruto mortal daquela árvore foi tão devastador para a sua raça.	i a'gO.ra, ma'ke~.zi, vo'se es'ta ko~.me'sa~.du a e~.te~'deX puX 'ke ko~'mer u 'fru.tu moX'taw da'kE.la 'aR.vo.ri 'foj 'ta~w~ de.vas.ta'doX 'pa.ra a 'su.a 'Ra.sa
Na verdade eu nunca havia pensado muito nisso, disse Mack, intrigado.	na veR'da.Di ew 'nu~.ka a'vi.a pe~'sa.du 'mu~j~.tu 'ni.su, 'Di.si 'mE.ki, i~.tri'ga.du
Então houve um jardim de verdade? Quer dizer, o Éden?	e~'ta~w~ 'ow.vi u~ ZaR'Di~ Di veR'da.Di, 'kER Di'zeX, u 'E.de~
Claro. Eu lhe disse que tenho uma queda por jardins.	'kla.ru, ew Li 'Di.si ki 'te~.Ju u~.ma 'kE.da puR ZaR'Di~s
Isso vai incomodar algumas pessoas.	'i.su 'vaj i~.ko~.mo'dar aw'gu~.mas pe'so.as
Tenho alguns amigos que não vão gostar disso, observou Mack, enquanto lutava com uma raiz teimosa.	'te~.Ju aw'gu~z a~'mi.gus ki 'na~w~ 'va~w~ gos'taR 'Di.su, ob.seR'vow 'mE.ki, e~'kwa~.tu lu'ta.va ko~ u~.ma Ra'is tej~'mO.za
Não faz mal.	'na~w~ 'fajz 'maw
Eu gosto muito deles.	ew 'gOs.tu 'mu~j~.tu 'de.lis
Estou surpreso, disse Mack com um certo sarcasmo e sorriu para ela.	es'tow suX'pre.zu, 'Di.si 'mE.ki ko~ u~ 'sEX.tu saX'kaz.mu i so'Riw 'pa.ra 'E.la
Cravou a pá na terra, pegando com a mão a raiz que estava por cima.	kra'vow a 'pa na 'tE.Ra, pe'ga~.du ko~ a 'ma~w~ a Ra'is ki es'ta.va puX 'si~.ma
Então fale da árvore do conhecimento do bem e do mal.	e~'ta~w~ 'fa.li da 'aR.vo.ri du ko~.Je.si~'me~.tu du 'be~j~ i du 'maw
É disso que estávamos falando no café da manhã.	E 'Di.su ki es'ta.va~.mus fa'la~.du nu ka'fE da ma~'Ja~
Primeiro quero fazer uma pergunta a você.	pri~'mej.ru 'kE.ru fa'zer u~.ma peR'gu~.ta a vo'se
Quando algo lhe acontece, como você determina se é uma coisa boa ou ruim?	'kwa~.du 'aw.gu Li a.ko~'tE.si, 'ko~.mu vo'se de.teR'mi~.na si E u~.ma 'koj.za 'bo.a ow Ru'i~
Mack pensou um momento antes de responder.	'mE.ki pe~'sow u~ mo~'me~.tu 'a~.Tis Di Res.po~'deX
Bom, na verdade nunca pensei nisso.	'bo~, na veR'da.Di 'nu~.ka pe~'sej 'ni.su
Acho que eu diria que algo é bom quando eu gosto, quando faz com que eu me sinta bem ou me dá um sentimento de segurança.	'a.Su ki ew Di'ri.a ki 'aw.gu E 'bo~ 'kwa~.du ew 'gOs.tu, 'kwa~.du 'fajs ko~ ki ew mi 'si~.ta 'be~j~ ow mi 'da u~ se~.Ti~'me~.tu Di se.gu'ra~.sa
Por outro lado, eu diria que uma coisa é ruim se me causa dor ou custa algo que eu quero.	pur 'ow.tru 'la.du, ew Di'ri.a ki u~.ma 'koj.za E Ru'i~ si mi 'kaw.za 'dor ow 'kus.ta 'aw.gu ki ew 'kE.ru
Então é bastante subjetivo?	e~'ta~w~ E bas'ta~.Ti sub.Ze'Ti.vu
E até que ponto você confia em sua capacidade de discernir o que é bom ou o que é ruim para você?	i a'tE ki 'po~.tu vo'se ko~'fi.a e~j~ 'su.a ka.pa.si'da.Di Di Di.seR'nir u ki E 'bo~ ow u ki E Ru'i~ 'pa.ra vo'se
Para ser honesto, acho que tenho razão de ficar com raiva quando alguém ameaça o que eu considero bom, o que eu acho que mereço.	'pa.ra 'ser o~'nEs.tu, 'a.Su ki 'te~.Ju Ra'za~w~ Di fi'kaX ko~ 'Raj.va 'kwa~.du aw'ge~j~ a~.me'a.sa u ki ew ko~.si'dE.ru 'bo~, u ki ew 'a.Su ki me're.su
Mas não sei realmente se existe algum fundamento lógico para decidir o que é bom ou ruim, a não ser o modo como algo ou alguém me afeta.	majs 'na~w~ 'sej Re.aw'me~.Ti si e'zis.Ti aw'gu~ fu~.da~'me~.tu 'lO.Zi.ku 'pa.ra de.si'Dir u ki E 'bo~ ow Ru'i~, a 'na~w~ 'ser u 'mO.du 'ko~.mu 'aw.gu ow aw'ge~j~ mi a'fE.ta
Ele parou para descansar e recuperar o fôlego.	'e.li pa'row 'pa.ra des.ka~'sar i Re.ku.pe'rar u 'fo.le.gu
Tudo parece relacionado comigo e com meus interesses, acho.	'tu.du pa'rE.si Re.la.si.o~'na.du ko~'mi.gu i ko~ 'mewz i~.te're.sis, 'a.Su
E minha ficha também não é das melhores.	i 'mi~.Ja 'fi.Sa ta~'be~j~ 'na~w~ E das me'LO.ris
Algumas coisas que eu inicialmente achava boas acabaram sendo terrivelmente destrutivas, e outras que eu achava ruins, bem, acabaram sendo...	aw'gu~.mas 'koj.zas ki ew i~.ni.si.aw'me~.Ti a'Sa.va 'bo.az a.ka'ba.ra~w~ 'se~.du te.Ri.vew'me~.Ti des.tru'Ti.vas, i 'ow.tras ki ew a'Sa.va Ru'i~s, 'be~j~, a.ka'ba.ra~w~ 'se~.du
Ele hesitou antes de finalizar o pensamento, mas Sarayu o interrompeu.	'e.li e.zi'tow 'a~.Tis Di fi~.na.li'zar u pe~.sa~'me~.tu, majs sa.ra'ju u i~.te.Ro~'pew
Então é você que determina o que é bom e o que é ruim.	e~'ta~w~ E vo'se ki de.teR'mi~.na u ki E 'bo~ i u ki E Ru'i~
Você se torna o juiz.	vo'se si 'tOR.na u Zu'is
E, para tornar as coisas ainda mais confusas, aquilo que você determina que é bom acaba mudando com o tempo e as circunstâncias.	i, 'pa.ra toR'nar as 'koj.zaz a'i~.da 'majs ko~'fu.zas, a'ki.lu ki vo'se de.teR'mi~.na ki E 'bo~ a'ka.ba mu'da~.du ko~ u 'te~.pu i as siX.ku~s'ta~.sjas
E, pior ainda, há bilhões de vocês, cada um determinando o que é bom e o que é ruim.	i, pi'Or a'i~.da, 'a bi'Lo~j~s Di vo'sejs, 'ka.da 'u~ de.teR.mi~'na~.du u ki E 'bo~ i u ki E Ru'i~
Assim, quando o seu bom e o seu ruim se chocam com os do vizinho, seguem-se brigas, discussões e até guerras.	a'si~, 'kwa~.du u 'sew 'bo~ i u 'sew Ru'i~ si 'SO.ka~w~ ko~ us du vi'zi~.Ju, 'sE.ge~j~ si 'bri.gas, Dis.ku'so~j~z i a'tE 'gE.Ras
As cores que se moviam dentro de Sarayu estavam escurecendo enquanto ela falava, pretos e cinzas se misturando e sombreando os tons de arco-íris.	as 'ko.ris ki si mo'vi.a~w~ 'de~.tru Di sa.ra'ju es'ta.va~w~ es.ku.re'se~.du e~'kwa~.tu 'E.la fa'la.va, 'pre.tuz i 'si~.zas si mis.tu'ra~.du i so~.bre'a~.du us 'to~s Di 'aX.ku 'i.ris
E, se não há uma realidade do bem que seja absoluta, você perde qualquer base para avaliar.	i, si 'na~w~ 'a u~.ma Re.a.li'da.Di du 'be~j~ ki 'se.Za ab.so'lu.ta, vo'se 'pER.Di kwaw'kER 'ba.zi 'pa.ra a.va.li'aX
É apenas linguagem e podemos muito bem trocar a palavra bem pela palavra mal.	E a'pe~.nas li~'gwa.Ze~j~ i po'de~.mus 'mu~j~.tu 'be~j~ tro'kar a pa'la.vra 'be~j~ 'pe.la pa'la.vra 'maw
Dá para perceber que isso pode ser um problema, concordou Mack.	'da 'pa.ra peX.se'beX ki 'i.su 'pO.Di 'ser u~ pro'ble~.ma, ko~.koR'dow 'mE.ki
Um problema? disse Sarayu, quase com rispidez, enquanto se levantava e o encarava.	u~ pro'ble~.ma, 'Di.si sa.ra'ju, 'kwa.zi ko~ Ris.pi'dejs, e~'kwa~.tu si le.va~'ta.va i u e~.ka'ra.va
Ela estava perturbada, mas Mack sabia que isso não era contra ele.	'E.la es'ta.va peX.tuR'ba.da, majs 'mE.ki sa'bi.a ki 'i.su 'na~w~ 'E.ra 'ko~.tra 'e.li
De fato!	Di 'fa.tu
A escolha de comer daquela árvore rasgou o universo, divorciando o espiritual do físico.	a es'ko.La Di ko~'meR da'kE.la 'aR.vo.ri Raz'gow u u~.ni'vEX.su, Di.voX.si'a~.du u es.pi.ri.tu'aw du 'fi.zi.ku
Eles morreram expelindo no hálito de sua escolha o próprio hálito de Deus.	'e.lis mo'Re.ra~w~ es.pe'li~.du nu 'a.li.tu Di 'su.a es'ko.La u 'prO.prju 'a.li.tu Di 'dews
Eu diria que isso é um problema!	ew Di'ri.a ki 'i.su E u~ pro'ble~.ma
Na intensidade de sua fala, Sarayu havia se alçado lentamente do chão.	na i~.te~.si'da.Di Di 'su.a 'fa.la, sa.ra'ju a'vi.a si aw'sa.du le~.ta~'me~.Ti du 'Sa~w~
Mas agora, enquanto baixava ao solo, sua voz chegou mais nítida.	majz a'gO.ra, e~'kwa~.tu baj'Sa.va aw 'sO.lu, 'su.a 'vOj.Se'gow 'majs 'ni.Ti.da
Aquele foi um dia de grande tristeza.	a'ke.li 'foj u~ 'Di.a Di 'gra~.Di tris'te.za
Nenhum dos dois falou durante quase 10 minutos enquanto trabalhavam.	ne~'Ju~ dus 'dojs fa'low du'ra~.Ti 'kwa.zi 'dEjz mi~'nu.tuz e~'kwa~.tu tra.ba'La.va~w~
À medida que continuava arrancando raízes e jogando-as na pilha, a mente de Mack trabalhava para entender as implicações do que Sarayu havia dito.	a me'Di.da ki ko~.Ti~.nu'a.va a.Ra~'ka~.du Ra'i.ziz i Zo'ga~.du as na 'pi.La, a 'me~.Ti Di 'mE.ki tra.ba'La.va 'pa.ra e~.te~'der az i~.pli.ka'so~j~s du ki sa.ra'ju a'vi.a 'Di.tu
Por fim ele rompeu o silêncio.	puX 'fi~ 'e.li Ro~'pew u si'le~.sju
Agora posso ver, confessou, que gastei a maior parte do meu tempo e da minha energia tentando adquirir o que eu achava que era bom, como a segurança financeira, a saúde, a aposentadoria, ou sei lá o quê.	a'gO.ra 'pO.su 'veX, ko~.fe'sow, ki gas'tej a maj'OX 'paX.Ti du 'mew 'te~.pu i da 'mi~.Ja e~.neR'Zi.a te~'ta~.du a.Di.ki'rir u ki ew a'Sa.va ki 'E.ra 'bo~, 'ko~.mu a se.gu'ra~.sa fi~.na~'sej.ra, a sa'u.Di, a a.po.ze~.ta.do'ri.a, ow 'sej 'la u 'ke
E gastei uma quantidade gigantesca de energia e preocupação temendo o que determinei que era mau. Mack deu um suspiro fundo.	i gas'tej u~.ma kwa~.Ti'da.Di Zi.ga~'tes.ka Di e~.neR'Zi.a i prew.ku.pa'sa~w~ te~'me~.du u ki de.teR.mi~'nej ki 'E.ra 'maw, 'mE.ki 'dew u~ sus'pi.ru 'fu~.du
Quanta verdade há nisso! disse Sarayu com gentileza.	'kwa~.ta veR'da.Di 'a 'ni.su, 'Di.si sa.ra'ju ko~ Ze~.Ti'le.za
Lembre-se. Isso permite que vocês brinquem de Deus em sua independência.	'le~.bri si, 'i.su peR'mi.Ti ki vo'sejs 'bri~.ke~j~ Di 'dewz e~j~ 'su.a i~.de.pe~'de~.sja
Por essa razão, uma parte de vocês prefere não me ver.	pur 'E.sa Ra'za~w~, u~.ma 'paX.Ti Di vo'sejs pre'fE.ri 'na~w~ mi 'veX
E vocês não precisam de mim para criar sua lista do que é bom e ruim.	i vo'sejs 'na~w~ pre'si.za~w~ Di 'mi~ 'pa.ra kri'aX 'su.a 'lis.ta du ki E 'bo~ i Ru'i~
Então há algum modo de consertar?	e~'ta~w~ 'a aw'gu~ 'mO.du Di ko~.seX'taX
Você deve desistir de seu direito de decidir o que é bom e ruim e escolher viver apenas em mim.	vo'se 'dE.vi de.zis'TiR Di 'sew Di'rej.tu Di de.si'Dir u ki E 'bo~ i Ru'i~ i es.ko'LeR vi'ver a'pe~.naz e~j~ 'mi~
É um comprimido difícil de engolir.	E u~ ko~.pri~'mi.du Di'fi.siw Di e~.go'liX
Para isso você deve me conhecer o bastante, a ponto de confiar em mim e aprender a se entregar à minha bondade inerente.	'pa.ra 'i.su vo'se 'dE.vi mi ko~.Je'ser u bas'ta~.Ti, a 'po~.tu Di ko~.fi'ar e~j~ 'mi~ i a.pre~'der a si e~.tre'gar a 'mi~.Ja bo~'da.Di i~.ne're~.Ti
