abat-jour	a'ba.T ZuX
arrière-pensée	a.Ri'E.ri pe~'se
attaché	a.ta'Se
atelier	a.te.li'eX
avant-garde	a'va~.T 'gaR.Di
avant-première	a'va~.T pre~.mi'E.ri
ballet	ba'lE
ballotage	ba.lo'ta.Zi
bibelot	bi.be'lo
bijou	bi'Zu
boîte	bo'a.Ti
bordeaux	boR'do
boulevard	bu.le'vaX
bouquet	bu'ke
boutique	bu'Ti.ki
boxeur	'bok.seX
brevet	bre've
buffet	bu'fe
bureau	'biw.row
cabaret	ka.ba'rE
cabriolet	ka.bri.o'lE
cachet	'ka.Se
capot	ka'po
carnet	kaR'ne
champagne	Sa~'pa~.Ji
champignon	Sa~.pi~.Jo~
Chateaubriand	Sa.to.bri.a~
chauffeur	So.fEX
chéri	Se'Ri
collants	ko'la~s
complot	ko~'plo
cordon-bleu	'kOR.do~ 'blew
coulomb	'ku.lo~.b
coupé	ku'pe
coupon	ku'po~
couvert	ku'vEX
croissant	kro.a'sa~
croupier	kru.pi'eX
décor	de.kOX
degradé	de.gra'de
déjà-vu	de.Za'vu
démodé	de~.mo'de
derrière	de.Ri'E.ri
Descartes	de'kaX.Ti
Didier	Di.Di'eX
dessert	de'seX.T
élan	'E.la~
expertis	Eks.peX'Tis
finesse	fi~'nE.si
foie gras	'fwa 'gra
fondue	fo~'di
Foucalt	fu'ko
gauche	'go.Si
gourmet	guR'me
Jean	Ze'a~
kitchenette	ki.Ti~'nE.Ti
Ledoux	le'du
lingerie	la~.Ze'Xi
Louvre	'lu.vri
maillot	maj'o
maison	maj'zo~
maître	'mE.tri
marchand	maX'Sa~
matinée	ma.Ti~'ne
Maurice	maw'ri.si
menu	me~'nu
mon	'mo~
mouche	'mu.Si
mousse	'mu.si
Nadine	na'Di~.ni
necessaire	ne.se'sEX
noir	no'aX
partenaire	paX.te~'nEX
patê	pa'te
petit-suisse	pe'Ti su'i.si
pivot	pi'vo
plateau (platô)	pla'to
pot-pourri	'po.Ti pu'Ri
rendez-vous	Re~'dejs 'vus
René	Re~'ne
rétro	'RE.tru
réveillon	Re.vej.jo~
rosé	Ro'ze
Rousseau	Ru'so
rouge	'Ru.Zi
saison	saj'zo~
sauté	saw'te
savoir-faire	sa.vo'aX 'fEX
soutien	su.Ti'a~
souvenir	su.ve~'niX
tarot	ta'ro
terrier	te.Ri'eX
Thierry	ti.e'Ri
toilette	toa'lE.Ti
tournée	tuR'ne
tourette	tu'rE.TTi
tricot	tri'ko
vernissage	veR.ni'sa.Zi
voyeur	vo'jEX
Zidane	zi'da~.ni